"CD_MUNICIPIO_BENEFICIARIO","ano","ans_30_a_39","ans_40_a_49","ans_menor_30","ans_total"
110000,2017,1,0,0,1
110000,2021,0,1,0,1
110001,2015,4,0,1,5
110001,2016,2,0,1,3
110001,2017,5,2,4,11
110001,2018,4,2,0,6
110001,2019,3,0,2,5
110001,2020,4,3,0,7
110001,2021,2,2,0,4
110001,2022,5,0,0,5
110002,2015,2,2,0,4
110002,2016,5,0,4,9
110002,2017,6,0,5,11
110002,2018,3,1,2,6
110002,2019,5,5,0,10
110002,2020,6,2,3,11
110002,2021,3,0,0,3
110002,2022,3,0,3,6
110003,2016,0,0,1,1
110004,2015,13,3,6,22
110004,2016,6,2,6,14
110004,2017,9,2,7,18
110004,2018,11,2,10,23
110004,2019,10,0,5,15
110004,2020,9,1,2,12
110004,2021,10,0,2,12
110004,2022,10,2,1,13
110005,2015,1,0,2,3
110005,2017,1,0,0,1
110005,2022,0,1,0,1
110006,2015,1,0,1,2
110006,2019,1,0,0,1
110006,2022,0,1,1,2
110008,2017,0,0,1,1
110008,2019,1,0,0,1
110009,2015,0,0,3,3
110009,2016,0,0,1,1
110009,2017,1,0,0,1
110009,2018,0,0,2,2
110009,2019,2,3,0,5
110009,2020,1,0,3,4
110009,2021,1,0,1,2
110009,2022,2,0,1,3
110010,2015,3,0,0,3
110010,2016,0,0,1,1
110010,2017,4,0,0,4
110010,2018,1,1,0,2
110010,2019,1,2,0,3
110010,2020,1,0,0,1
110010,2022,0,0,1,1
110011,2015,3,1,1,5
110011,2016,2,1,4,7
110011,2017,1,0,4,5
110011,2018,2,0,1,3
110011,2019,1,0,0,1
110011,2020,2,1,0,3
110011,2021,2,0,1,3
110012,2015,5,0,5,10
110012,2016,1,0,1,2
110012,2017,4,0,3,7
110012,2018,7,0,0,7
110012,2019,10,4,1,15
110012,2020,3,0,8,11
110012,2021,6,2,5,13
110012,2022,4,2,4,10
110013,2019,0,0,3,3
110013,2021,1,0,0,1
110014,2015,2,0,0,2
110014,2016,1,0,0,1
110014,2018,1,0,0,1
110014,2021,1,0,1,2
110015,2015,1,1,4,6
110015,2016,3,0,0,3
110015,2017,2,0,0,2
110015,2018,1,0,2,3
110015,2019,3,1,0,4
110015,2020,1,0,0,1
110015,2021,0,1,0,1
110018,2015,2,0,0,2
110018,2016,2,0,4,6
110018,2017,4,0,2,6
110018,2018,0,1,5,6
110018,2019,5,0,0,5
110018,2020,3,0,1,4
110018,2021,2,0,1,3
110018,2022,3,0,1,4
110020,2015,53,7,45,105
110020,2016,76,2,38,116
110020,2017,64,8,33,105
110020,2018,71,11,37,119
110020,2019,62,8,37,107
110020,2020,81,7,27,115
110020,2021,65,7,24,96
110020,2022,71,28,27,126
110025,2015,1,0,0,1
110025,2016,0,1,0,1
110025,2017,1,0,0,1
110025,2020,1,0,0,1
110025,2021,0,0,1,1
110025,2022,1,0,1,2
110028,2015,3,1,1,5
110028,2016,2,0,2,4
110028,2017,2,0,0,2
110028,2019,1,0,0,1
110028,2020,2,0,2,4
110028,2022,1,1,0,2
110029,2018,1,0,1,2
110030,2015,5,0,0,5
110030,2016,3,1,7,11
110030,2017,5,0,0,5
110030,2018,2,0,6,8
110030,2019,0,0,2,2
110030,2020,2,0,7,9
110030,2021,1,0,4,5
110030,2022,8,1,4,13
110032,2019,1,0,1,2
110032,2020,0,0,1,1
110032,2022,0,0,1,1
110033,2019,1,0,1,2
110034,2021,1,0,0,1
110040,2015,1,0,0,1
110045,2017,0,0,1,1
110045,2018,1,0,0,1
110045,2020,1,0,0,1
110050,2015,0,0,1,1
110050,2019,0,1,0,1
110080,2019,1,0,1,2
110080,2022,1,0,1,2
110092,2020,1,1,0,2
110092,2022,1,0,0,1
110094,2017,1,0,0,1
110110,2016,1,0,0,1
110110,2019,1,0,0,1
110110,2021,1,0,0,1
110120,2019,0,0,1,1
110130,2019,0,0,1,1
110140,2015,0,0,1,1
110140,2019,0,0,1,1
110143,2021,1,0,0,1
110145,2017,0,0,1,1
110145,2020,0,0,1,1
110148,2017,1,0,0,1
110148,2022,1,0,0,1
110149,2021,1,0,0,1
110149,2022,0,0,1,1
110150,2018,1,0,0,1
110155,2019,1,0,0,1
110170,2022,1,1,0,2
110180,2015,0,0,1,1
110180,2020,1,0,0,1
120001,2019,1,0,0,1
120001,2020,1,0,1,2
120001,2022,0,0,2,2
120010,2019,1,0,0,1
120010,2020,1,0,0,1
120013,2020,0,0,1,1
120013,2021,0,0,1,1
120020,2017,0,0,1,1
120025,2017,1,0,0,1
120030,2022,1,0,0,1
120038,2017,2,0,0,2
120038,2020,1,0,0,1
120040,2015,8,4,8,20
120040,2016,6,1,4,11
120040,2017,12,2,11,25
120040,2018,19,8,9,36
120040,2019,23,2,8,33
120040,2020,25,6,6,37
120040,2021,29,5,2,36
120040,2022,5,4,6,15
120045,2017,0,1,0,1
120045,2019,1,0,0,1
120070,2015,0,0,2,2
130000,2015,1,0,0,1
130000,2017,0,1,0,1
130002,2022,1,0,1,2
130010,2018,1,0,0,1
130014,2018,1,0,0,1
130070,2022,1,0,0,1
130100,2020,0,0,1,1
130110,2018,1,0,0,1
130140,2022,1,0,0,1
130170,2019,0,0,1,1
130185,2018,1,0,0,1
130185,2022,0,1,0,1
130190,2016,0,0,1,1
130190,2017,0,0,1,1
130190,2018,0,0,1,1
130190,2019,1,0,0,1
130190,2020,2,0,0,2
130190,2022,1,0,0,1
130240,2019,1,0,0,1
130250,2015,1,0,0,1
130250,2020,0,2,0,2
130260,2015,79,16,67,162
130260,2016,156,34,124,314
130260,2017,83,13,36,132
130260,2018,65,14,26,105
130260,2019,109,26,71,206
130260,2020,125,26,75,226
130260,2021,69,15,22,106
130260,2022,53,23,25,101
130290,2019,0,0,1,1
130290,2020,1,0,0,1
130353,2015,1,1,0,2
130353,2022,0,1,0,1
130356,2016,1,0,0,1
130390,2017,1,0,0,1
130406,2018,0,0,1,1
130426,2017,0,0,1,1
140010,2015,11,1,8,20
140010,2016,7,1,0,8
140010,2017,10,2,6,18
140010,2018,9,3,4,16
140010,2019,8,0,2,10
140010,2020,4,0,3,7
140010,2021,8,1,0,9
140010,2022,5,1,1,7
140020,2017,1,0,0,1
140023,2018,0,1,0,1
140047,2019,1,0,0,1
140060,2019,1,0,0,1
150000,2018,0,0,1,1
150000,2020,3,0,0,3
150000,2021,1,1,0,2
150010,2015,1,0,0,1
150010,2016,3,0,1,4
150010,2017,1,0,2,3
150010,2019,0,0,2,2
150010,2020,2,1,1,4
150010,2021,4,0,2,6
150010,2022,1,3,2,6
150020,2020,0,0,1,1
150034,2020,0,1,0,1
150040,2020,1,0,0,1
150050,2017,1,0,0,1
150050,2019,3,0,1,4
150050,2020,1,0,0,1
150050,2022,0,1,0,1
150060,2015,1,0,1,2
150060,2016,0,0,4,4
150060,2017,1,1,1,3
150060,2018,2,0,4,6
150060,2019,0,1,5,6
150060,2020,1,0,1,2
150060,2021,0,2,2,4
150060,2022,4,2,2,8
150080,2015,16,3,15,34
150080,2016,13,4,11,28
150080,2017,17,6,10,33
150080,2018,27,8,9,44
150080,2019,22,6,10,38
150080,2020,36,9,15,60
150080,2021,36,9,18,63
150080,2022,27,13,19,59
150090,2018,0,0,2,2
150090,2020,1,0,0,1
150120,2020,0,1,0,1
150130,2015,4,1,2,7
150130,2016,7,0,5,12
150130,2017,5,1,2,8
150130,2018,12,0,1,13
150130,2019,2,0,2,4
150130,2020,5,1,2,8
150130,2021,2,0,5,7
150130,2022,2,1,3,6
150140,2015,64,5,46,115
150140,2016,58,11,45,114
150140,2017,70,15,35,120
150140,2018,85,24,38,147
150140,2019,94,13,55,162
150140,2020,142,36,61,239
150140,2021,148,35,59,242
150140,2022,131,45,61,237
150145,2018,1,0,0,1
150145,2022,1,0,0,1
150150,2016,1,0,0,1
150150,2017,2,0,1,3
150150,2020,1,0,2,3
150150,2021,0,0,1,1
150150,2022,0,0,1,1
150157,2017,0,1,0,1
150157,2018,2,0,0,2
150157,2020,1,0,0,1
150160,2017,1,0,0,1
150160,2019,0,0,2,2
150170,2015,1,0,0,1
150170,2017,1,0,0,1
150170,2018,1,0,0,1
150170,2019,1,0,0,1
150170,2021,2,0,0,2
150172,2019,1,0,1,2
150175,2015,0,0,1,1
150175,2018,1,0,0,1
150178,2015,2,0,0,2
150178,2016,2,0,0,2
150178,2018,1,0,0,1
150178,2022,1,0,0,1
150210,2015,0,0,1,1
150210,2022,1,0,0,1
150215,2015,11,1,17,29
150215,2016,6,1,17,24
150215,2017,4,1,17,22
150215,2018,4,1,13,18
150215,2019,10,0,9,19
150215,2020,13,1,6,20
150215,2021,9,2,7,18
150215,2022,7,0,8,15
150220,2016,0,1,0,1
150220,2017,1,0,0,1
150220,2018,0,0,1,1
150220,2019,0,0,1,1
150220,2020,0,1,1,2
150220,2021,2,0,0,2
150220,2022,1,0,0,1
150230,2019,2,0,0,2
150230,2020,1,0,0,1
150240,2015,7,0,2,9
150240,2016,0,0,2,2
150240,2017,4,0,2,6
150240,2018,4,0,3,7
150240,2019,7,0,2,9
150240,2020,4,3,2,9
150240,2021,3,0,2,5
150240,2022,1,1,4,6
150270,2020,1,0,0,1
150270,2021,1,0,0,1
150275,2015,0,0,1,1
150277,2015,2,0,2,4
150277,2016,2,0,1,3
150277,2017,0,0,1,1
150277,2018,0,0,1,1
150277,2019,1,0,1,2
150277,2020,0,0,1,1
150277,2021,2,0,2,4
150277,2022,0,0,3,3
150293,2018,1,0,0,1
150293,2020,1,0,0,1
150293,2021,3,0,1,4
150304,2020,1,0,0,1
150304,2022,1,0,0,1
150320,2015,1,0,0,1
150320,2016,1,0,0,1
150350,2019,0,0,1,1
150360,2015,2,1,0,3
150360,2016,1,0,1,2
150360,2017,0,1,0,1
150360,2018,2,0,1,3
150360,2019,2,0,1,3
150360,2021,4,0,1,5
150360,2022,3,0,0,3
150370,2017,0,0,1,1
150380,2019,1,0,0,1
150380,2020,1,0,0,1
150390,2015,0,0,1,1
150390,2017,1,1,1,3
150390,2019,1,0,3,4
150390,2020,1,0,0,1
150390,2021,0,0,2,2
150405,2016,2,0,0,2
150405,2017,0,1,0,1
150420,2015,34,7,21,62
150420,2016,16,1,13,30
150420,2017,24,3,22,49
150420,2018,9,0,11,20
150420,2019,4,5,8,17
150420,2020,3,2,4,9
150420,2021,7,2,10,19
150420,2022,8,2,3,13
150442,2015,1,0,2,3
150442,2018,2,0,0,2
150442,2020,0,0,1,1
150442,2021,0,1,1,2
150442,2022,1,0,2,3
150460,2022,1,0,0,1
150470,2017,1,0,0,1
150470,2019,0,1,0,1
150475,2015,0,0,1,1
150480,2016,1,0,0,1
150490,2018,1,0,0,1
150503,2021,1,0,0,1
150503,2022,1,0,0,1
150506,2015,0,0,1,1
150510,2022,1,0,0,1
150530,2015,1,1,0,2
150530,2016,1,0,0,1
150530,2017,0,0,1,1
150530,2021,1,0,0,1
150543,2015,4,0,2,6
150543,2016,0,0,5,5
150543,2017,2,0,1,3
150543,2018,0,0,3,3
150543,2019,0,0,1,1
150543,2020,0,0,2,2
150543,2021,1,1,0,2
150543,2022,1,0,1,2
150548,2022,1,0,0,1
150550,2015,3,0,8,11
150550,2016,5,0,10,15
150550,2017,2,0,5,7
150550,2018,2,1,0,3
150550,2019,1,0,2,3
150550,2020,5,0,2,7
150550,2021,5,0,1,6
150550,2022,3,0,1,4
150553,2015,26,4,35,65
150553,2016,31,8,41,80
150553,2017,29,1,39,69
150553,2018,16,1,21,38
150553,2019,36,6,32,74
150553,2020,24,5,18,47
150553,2021,19,5,18,42
150553,2022,19,5,11,35
150563,2021,1,0,0,1
150590,2018,1,0,0,1
150613,2015,3,1,0,4
150613,2016,2,0,2,4
150613,2017,0,0,1,1
150613,2018,2,0,5,7
150613,2019,0,0,3,3
150613,2020,1,0,0,1
150613,2021,5,0,0,5
150613,2022,3,1,1,5
150616,2017,1,0,0,1
150618,2015,0,0,1,1
150618,2017,1,0,0,1
150618,2018,0,0,1,1
150618,2020,2,0,0,2
150618,2021,1,0,0,1
150619,2018,1,0,0,1
150620,2020,1,0,0,1
150650,2019,1,0,0,1
150650,2020,0,0,1,1
150650,2021,1,0,1,2
150660,2016,0,0,1,1
150670,2019,1,0,0,1
150680,2015,7,5,7,19
150680,2016,8,2,9,19
150680,2017,17,3,10,30
150680,2018,10,2,9,21
150680,2019,14,1,12,27
150680,2020,18,3,4,25
150680,2021,13,3,9,25
150680,2022,10,2,2,14
150715,2018,0,0,1,1
150730,2015,1,0,0,1
150740,2019,0,0,1,1
150760,2015,0,0,1,1
150760,2018,0,0,1,1
150760,2019,0,0,1,1
150760,2022,1,0,0,1
150775,2019,1,0,0,1
150790,2020,1,0,0,1
150795,2015,0,0,1,1
150795,2019,1,0,0,1
150795,2021,1,0,0,1
150795,2022,0,0,1,1
150800,2015,1,0,0,1
150800,2018,1,0,0,1
150800,2020,0,0,2,2
150808,2015,0,0,3,3
150808,2016,1,0,0,1
150808,2017,0,0,1,1
150808,2018,0,0,1,1
150808,2019,0,0,2,2
150808,2020,0,0,3,3
150808,2021,1,0,0,1
150810,2015,1,0,2,3
150810,2016,2,0,1,3
150810,2017,1,0,2,3
150810,2018,1,1,1,3
150810,2019,0,0,1,1
150810,2020,1,0,0,1
150810,2021,1,2,0,3
150810,2022,3,2,0,5
150812,2019,0,0,1,1
150815,2022,1,0,0,1
150820,2020,0,0,1,1
150820,2021,1,0,0,1
150835,2021,1,0,0,1
150840,2015,1,0,2,3
150840,2016,0,1,2,3
150840,2017,0,0,1,1
150840,2018,0,0,1,1
150840,2019,2,0,0,2
150840,2022,1,0,1,2
160005,2015,0,0,2,2
160005,2016,0,0,1,1
160005,2018,1,0,1,2
160005,2021,2,0,0,2
160005,2022,1,0,0,1
160010,2016,1,0,0,1
160010,2017,0,0,3,3
160010,2018,1,0,0,1
160010,2019,3,0,0,3
160010,2020,5,1,0,6
160010,2021,0,0,2,2
160015,2015,1,0,0,1
160015,2021,0,1,0,1
160023,2019,1,0,0,1
160023,2020,1,0,0,1
160023,2021,0,1,0,1
160027,2015,1,1,0,2
160027,2017,1,0,0,1
160027,2020,1,0,0,1
160030,2015,10,8,16,34
160030,2016,28,8,20,56
160030,2017,39,8,16,63
160030,2018,41,10,20,71
160030,2019,26,7,12,45
160030,2020,8,12,14,34
160030,2021,20,2,20,42
160030,2022,12,4,5,21
160050,2018,0,0,1,1
160050,2020,1,0,0,1
160050,2021,0,1,0,1
160053,2015,1,0,0,1
160053,2016,1,2,0,3
160053,2017,0,0,1,1
160053,2018,2,0,3,5
160053,2021,0,0,1,1
160053,2022,1,0,0,1
160060,2015,3,1,5,9
160060,2016,0,0,1,1
160060,2017,3,0,0,3
160060,2018,2,0,1,3
160060,2020,1,0,0,1
160060,2021,2,0,2,4
160060,2022,1,0,0,1
160070,2018,1,0,1,2
170000,2016,1,0,0,1
170000,2020,1,0,0,1
170000,2022,0,1,0,1
170035,2021,1,0,0,1
170040,2017,1,0,1,2
170070,2015,1,0,1,2
170070,2017,1,0,0,1
170070,2018,0,0,1,1
170070,2019,0,1,1,2
170070,2020,0,0,2,2
170070,2022,2,0,0,2
170190,2018,1,0,0,1
170200,2017,1,0,0,1
170210,2015,2,1,5,8
170210,2016,10,2,5,17
170210,2017,11,5,8,24
170210,2018,13,1,6,20
170210,2019,14,3,10,27
170210,2020,7,1,3,11
170210,2021,13,4,3,20
170210,2022,12,5,3,20
170220,2015,0,0,1,1
170220,2016,1,0,1,2
170220,2017,1,0,0,1
170220,2018,3,0,0,3
170220,2019,1,0,0,1
170220,2020,2,1,0,3
170230,2015,1,0,0,1
170230,2021,2,0,0,2
170240,2018,0,1,0,1
170255,2020,1,0,0,1
170305,2017,0,0,1,1
170330,2021,1,0,0,1
170382,2019,1,0,0,1
170384,2016,1,0,0,1
170390,2019,1,0,0,1
170550,2015,0,0,1,1
170550,2016,2,0,0,2
170550,2017,1,1,0,2
170550,2018,1,0,0,1
170550,2019,3,0,0,3
170550,2020,0,1,0,1
170550,2021,0,1,0,1
170550,2022,1,1,0,2
170555,2016,0,1,0,1
170555,2021,1,0,0,1
170610,2015,1,0,0,1
170700,2017,1,0,0,1
170700,2019,2,0,0,2
170700,2020,1,1,0,2
170700,2022,0,0,1,1
170710,2019,0,0,1,1
170755,2016,1,0,0,1
170765,2020,0,1,0,1
170765,2022,0,0,1,1
170770,2015,1,0,0,1
170770,2016,1,0,0,1
170820,2019,1,1,0,2
170820,2020,1,0,1,2
170825,2021,0,0,1,1
170900,2017,0,0,2,2
170900,2018,2,0,0,2
170930,2017,0,0,1,1
170930,2018,1,0,1,2
170930,2019,0,0,1,1
170930,2020,1,0,0,1
170930,2021,2,1,0,3
170930,2022,1,0,0,1
170950,2015,1,0,0,1
170950,2016,7,1,5,13
170950,2017,3,1,1,5
170950,2018,1,1,1,3
170950,2019,2,1,0,3
170950,2020,6,1,6,13
170950,2021,5,1,2,8
170950,2022,5,0,0,5
171200,2015,1,0,0,1
171200,2021,3,0,0,3
171245,2021,0,0,1,1
171250,2020,0,0,1,1
171320,2020,2,1,0,3
171320,2022,0,1,0,1
171330,2021,0,0,1,1
171420,2021,0,0,1,1
171420,2022,0,2,0,2
171430,2019,1,0,0,1
171488,2019,0,0,1,1
171500,2019,1,0,0,1
171500,2021,1,0,0,1
171510,2019,1,0,0,1
171610,2015,0,0,1,1
171610,2017,1,0,0,1
171610,2018,2,0,1,3
171610,2019,2,0,3,5
171610,2020,5,0,4,9
171610,2021,2,0,3,5
171610,2022,2,0,1,3
171620,2022,0,0,1,1
171650,2019,2,0,0,2
171650,2021,0,0,1,1
171650,2022,5,0,1,6
171660,2022,1,0,0,1
171670,2016,0,0,1,1
171670,2018,0,0,1,1
171670,2019,0,0,1,1
171790,2020,1,0,0,1
171820,2015,0,1,0,1
171820,2016,1,0,0,1
171820,2018,2,1,1,4
171820,2019,2,1,2,5
171820,2020,1,1,1,3
171820,2021,2,1,0,3
171820,2022,4,1,0,5
171855,2019,1,0,0,1
171875,2017,0,0,1,1
171886,2018,1,0,0,1
171886,2019,0,0,1,1
172015,2021,1,0,0,1
172020,2022,0,0,1,1
172049,2020,1,0,0,1
172065,2021,1,0,1,2
172085,2022,1,0,0,1
172090,2016,0,1,0,1
172090,2018,2,0,0,2
172090,2019,1,2,0,3
172090,2020,0,0,1,1
172090,2021,1,0,0,1
172090,2022,2,0,1,3
172100,2015,8,1,4,13
172100,2016,3,0,7,10
172100,2017,17,3,8,28
172100,2018,25,3,20,48
172100,2019,28,8,11,47
172100,2020,25,10,17,52
172100,2021,38,11,17,66
172100,2022,29,11,10,50
172120,2016,0,0,1,1
172120,2018,0,1,0,1
172125,2021,1,0,0,1
172210,2017,1,0,1,2
172210,2020,1,0,0,1
210000,2015,1,1,0,2
210000,2016,2,0,0,2
210000,2017,1,1,0,2
210000,2019,2,0,0,2
210005,2015,3,0,0,3
210005,2016,1,0,2,3
210005,2017,2,2,1,5
210005,2018,1,1,3,5
210005,2019,2,0,4,6
210005,2020,2,0,4,6
210005,2021,4,0,7,11
210005,2022,2,1,2,5
210015,2018,0,0,1,1
210015,2021,1,0,0,1
210047,2018,0,0,1,1
210047,2020,1,0,0,1
210060,2015,1,0,0,1
210087,2018,0,0,1,1
210100,2022,0,1,0,1
210120,2015,2,0,1,3
210120,2017,0,0,2,2
210120,2020,0,1,1,2
210120,2021,1,0,0,1
210120,2022,0,0,2,2
210125,2017,1,0,0,1
210125,2019,0,0,1,1
210125,2020,0,2,1,3
210125,2021,0,0,1,1
210125,2022,2,0,0,2
210130,2017,0,0,1,1
210140,2015,2,0,1,3
210140,2017,5,0,2,7
210140,2018,2,0,2,4
210140,2019,2,0,2,4
210140,2020,5,0,1,6
210140,2021,3,0,1,4
210140,2022,2,2,0,4
210150,2017,1,0,0,1
210150,2018,1,0,0,1
210150,2021,1,0,0,1
210160,2017,1,0,0,1
210160,2019,0,1,0,1
210160,2021,2,0,0,2
210160,2022,1,0,0,1
210170,2015,0,1,0,1
210170,2017,0,0,1,1
210170,2019,0,0,1,1
210170,2021,1,0,0,1
210170,2022,0,0,1,1
210203,2018,1,0,0,1
210203,2020,1,0,0,1
210203,2021,0,0,1,1
210210,2016,0,0,1,1
210210,2019,1,0,0,1
210220,2018,2,0,0,2
210220,2019,1,0,0,1
210220,2021,0,0,1,1
210230,2017,0,1,0,1
210232,2016,1,0,0,1
210232,2017,1,0,0,1
210232,2021,2,0,0,2
210237,2021,1,0,0,1
210255,2016,0,0,2,2
210255,2019,1,0,0,1
210255,2022,2,0,0,2
210260,2021,0,0,1,1
210275,2020,0,0,1,1
210280,2020,1,0,0,1
210280,2022,0,0,1,1
210300,2015,3,1,2,6
210300,2016,4,0,2,6
210300,2017,5,2,4,11
210300,2018,4,0,3,7
210300,2019,8,1,0,9
210300,2020,7,0,1,8
210300,2021,9,0,3,12
210300,2022,8,1,6,15
210310,2017,0,0,1,1
210317,2019,0,1,0,1
210320,2016,0,0,2,2
210320,2017,0,1,0,1
210320,2018,0,0,1,1
210320,2021,2,0,3,5
210330,2016,1,0,0,1
210330,2017,2,0,0,2
210330,2019,0,0,1,1
210330,2020,1,0,0,1
210330,2021,2,0,3,5
210330,2022,1,1,0,2
210340,2016,1,0,0,1
210340,2017,2,1,1,4
210340,2018,5,2,1,8
210340,2019,5,2,1,8
210340,2020,1,2,2,5
210340,2021,2,2,0,4
210340,2022,3,0,2,5
210350,2017,0,0,1,1
210350,2018,0,0,1,1
210350,2021,1,0,0,1
210360,2020,1,0,0,1
210360,2022,1,0,0,1
210375,2021,0,0,1,1
210375,2022,0,0,1,1
210380,2021,0,1,0,1
210390,2020,0,0,1,1
210400,2020,0,1,1,2
210405,2015,2,0,0,2
210405,2021,1,0,0,1
210409,2021,1,0,0,1
210430,2015,1,0,0,1
210430,2018,0,0,1,1
210440,2020,1,0,0,1
210440,2022,1,0,0,1
210450,2017,0,0,1,1
210455,2015,1,0,0,1
210455,2022,1,0,1,2
210460,2018,0,1,0,1
210467,2016,0,0,1,1
210480,2022,0,0,1,1
210510,2018,0,0,1,1
210520,2017,0,0,1,1
210530,2015,28,7,15,50
210530,2016,18,3,18,39
210530,2017,35,6,27,68
210530,2018,30,5,10,45
210530,2019,28,3,13,44
210530,2020,11,1,9,21
210530,2021,20,5,12,37
210530,2022,29,4,14,47
210540,2015,0,0,1,1
210540,2016,1,0,0,1
210540,2017,0,0,1,1
210540,2020,1,1,0,2
210540,2022,1,0,0,1
210550,2015,2,0,0,2
210550,2016,1,0,0,1
210550,2018,1,0,0,1
210550,2020,0,0,1,1
210550,2022,1,0,0,1
210560,2015,0,1,0,1
210560,2016,1,1,0,2
210560,2017,5,0,0,5
210560,2018,0,1,1,2
210560,2019,2,0,0,2
210570,2019,0,0,2,2
210570,2020,2,0,0,2
210570,2021,1,0,0,1
210600,2016,1,0,0,1
210610,2020,2,0,0,2
210630,2016,1,0,0,1
210632,2017,0,0,1,1
210632,2021,0,0,1,1
210650,2017,1,0,0,1
210650,2019,0,0,1,1
210650,2021,1,0,0,1
210660,2017,0,0,1,1
210660,2018,0,1,1,2
210660,2019,1,0,1,2
210660,2021,0,1,0,1
210660,2022,1,0,0,1
210663,2015,0,0,1,1
210680,2018,1,0,0,1
210690,2016,0,0,1,1
210700,2015,0,1,0,1
210720,2019,1,0,0,1
210740,2016,0,0,2,2
210740,2019,1,0,0,1
210745,2015,0,1,0,1
210745,2017,0,0,1,1
210750,2015,2,1,4,7
210750,2016,5,0,6,11
210750,2017,5,1,3,9
210750,2018,9,2,5,16
210750,2019,12,2,7,21
210750,2020,24,2,2,28
210750,2021,17,5,4,26
210750,2022,33,9,10,52
210770,2020,1,0,0,1
210780,2017,3,0,0,3
210780,2019,1,0,1,2
210780,2020,1,0,0,1
210780,2022,1,0,0,1
210790,2017,2,0,0,2
210800,2016,0,0,1,1
210800,2017,0,0,1,1
210800,2021,1,0,0,1
210820,2017,1,0,0,1
210820,2018,3,0,0,3
210820,2019,1,0,0,1
210820,2020,2,0,1,3
210820,2021,1,0,0,1
210840,2021,1,0,0,1
210845,2019,1,0,0,1
210850,2015,0,1,0,1
210850,2021,1,0,0,1
210860,2015,0,0,1,1
210860,2018,1,0,0,1
210860,2021,2,0,0,2
210890,2022,2,0,0,2
210900,2015,1,0,0,1
210900,2016,1,0,1,2
210900,2019,1,0,0,1
210900,2020,1,0,0,1
210900,2022,1,0,0,1
210910,2020,0,1,0,1
210910,2021,1,0,1,2
210910,2022,0,1,0,1
210945,2016,1,0,0,1
210945,2018,1,0,0,1
210945,2019,2,0,1,3
210945,2020,2,4,0,6
210945,2021,1,0,0,1
210945,2022,3,0,0,3
210960,2016,0,0,2,2
210960,2019,1,0,0,1
210960,2022,2,0,1,3
210980,2016,0,0,1,1
210990,2015,1,0,0,1
210990,2016,1,0,2,3
210990,2017,0,0,1,1
210990,2018,0,0,3,3
210990,2019,1,0,0,1
210990,2020,1,0,0,1
210990,2021,4,0,2,6
210990,2022,3,0,1,4
211000,2015,1,0,0,1
211000,2018,1,0,1,2
211000,2020,1,0,0,1
211003,2018,0,0,1,1
211010,2021,1,0,0,1
211010,2022,0,0,1,1
211020,2016,1,0,1,2
211020,2017,3,0,1,4
211020,2019,2,0,1,3
211020,2020,2,0,0,2
211030,2020,0,0,1,1
211060,2019,1,0,0,1
211060,2020,1,0,0,1
211060,2021,1,0,0,1
211060,2022,0,0,1,1
211065,2022,1,0,0,1
211070,2019,1,0,0,1
211090,2019,0,1,0,1
211100,2017,1,0,0,1
211100,2019,0,1,0,1
211107,2017,1,0,0,1
211110,2018,0,0,1,1
211110,2019,1,0,1,2
211110,2020,0,1,0,1
211110,2022,0,2,0,2
211120,2015,11,2,4,17
211120,2016,7,3,5,15
211120,2017,9,1,5,15
211120,2018,11,0,3,14
211120,2019,16,2,9,27
211120,2020,24,4,10,38
211120,2021,28,5,20,53
211120,2022,25,14,38,77
211130,2015,89,23,67,179
211130,2016,80,14,61,155
211130,2017,97,16,54,167
211130,2018,92,7,43,142
211130,2019,144,30,85,259
211130,2020,176,42,93,311
211130,2021,193,42,117,352
211130,2022,214,62,100,376
211150,2017,1,0,0,1
211150,2019,0,0,1,1
211153,2018,1,0,0,1
211172,2019,1,0,0,1
211176,2015,0,0,2,2
211195,2022,1,0,0,1
211200,2017,0,0,1,1
211200,2021,0,0,1,1
211210,2020,1,0,0,1
211220,2015,4,1,7,12
211220,2016,8,2,11,21
211220,2017,18,1,8,27
211220,2018,8,0,10,18
211220,2019,13,1,7,21
211220,2020,17,8,10,35
211220,2021,10,5,15,30
211220,2022,16,3,8,27
211230,2019,1,0,0,1
211250,2017,0,0,1,1
211250,2018,0,0,1,1
211250,2019,0,0,1,1
211270,2019,2,0,0,2
211280,2016,1,0,0,1
211280,2017,3,0,0,3
211280,2018,2,0,0,2
211280,2019,1,0,0,1
211280,2020,1,0,1,2
211280,2022,1,0,2,3
211285,2021,0,0,1,1
211290,2016,0,1,0,1
211300,2020,1,0,0,1
220005,2017,1,0,0,1
220010,2017,0,0,1,1
220020,2018,1,0,0,1
220020,2020,3,0,0,3
220020,2021,2,0,0,2
220020,2022,0,1,0,1
220030,2020,1,0,0,1
220040,2016,0,0,2,2
220040,2017,1,1,3,5
220040,2018,0,0,2,2
220040,2019,4,0,0,4
220040,2020,2,2,0,4
220040,2021,1,0,2,3
220040,2022,1,1,0,2
220050,2017,0,1,0,1
220050,2018,1,0,0,1
220050,2020,0,2,0,2
220050,2021,0,1,1,2
220050,2022,0,2,0,2
220060,2015,1,0,0,1
220090,2019,0,0,1,1
220090,2020,0,0,1,1
220105,2016,0,0,1,1
220115,2021,1,0,0,1
220120,2015,1,0,1,2
220120,2016,0,0,1,1
220120,2018,1,0,0,1
220120,2019,1,0,0,1
220120,2020,2,0,0,2
220120,2021,1,0,0,1
220120,2022,1,0,0,1
220140,2016,0,1,0,1
220140,2019,0,0,1,1
220140,2021,0,0,1,1
220150,2020,2,0,0,2
220150,2022,1,0,1,2
220160,2022,1,0,0,1
220177,2019,0,1,0,1
220180,2017,0,0,1,1
220190,2016,1,0,1,2
220190,2018,0,0,1,1
220190,2022,1,0,1,2
220196,2019,0,0,1,1
220200,2018,1,0,0,1
220200,2019,1,0,0,1
220200,2021,0,0,1,1
220200,2022,0,1,0,1
220210,2020,2,0,0,2
220220,2015,1,0,0,1
220220,2016,0,0,1,1
220220,2017,2,3,2,7
220220,2018,0,2,4,6
220220,2019,1,0,4,5
220220,2020,0,0,2,2
220220,2021,1,0,1,2
220220,2022,4,0,0,4
220230,2017,0,0,1,1
220230,2018,0,0,1,1
220230,2021,0,0,1,1
220230,2022,2,0,0,2
220240,2020,1,0,0,1
220250,2021,1,0,0,1
220255,2022,1,0,0,1
220270,2019,1,0,0,1
220270,2020,2,0,0,2
220270,2022,1,0,0,1
220275,2015,1,0,0,1
220275,2022,0,0,1,1
220290,2018,1,0,0,1
220290,2022,0,1,0,1
220320,2018,1,0,0,1
220320,2022,0,0,1,1
220325,2016,1,0,2,3
220325,2021,1,0,2,3
220325,2022,2,0,0,2
220327,2022,1,0,0,1
220330,2018,0,0,1,1
220330,2019,3,0,0,3
220330,2021,2,0,0,2
220350,2015,0,0,1,1
220350,2019,0,0,1,1
220350,2020,1,0,0,1
220350,2021,1,0,0,1
220350,2022,1,0,0,1
220360,2021,0,0,1,1
220370,2015,2,0,0,2
220370,2019,1,0,0,1
220370,2021,2,0,0,2
220370,2022,2,1,2,5
220380,2021,0,0,1,1
220390,2015,2,2,3,7
220390,2016,2,0,0,2
220390,2017,3,0,1,4
220390,2018,1,1,2,4
220390,2019,6,1,3,10
220390,2020,9,0,11,20
220390,2021,5,3,0,8
220390,2022,5,2,3,10
220420,2017,1,0,0,1
220430,2020,1,0,0,1
220440,2016,1,0,0,1
220440,2017,1,0,0,1
220440,2020,1,0,0,1
220440,2021,0,0,2,2
220450,2016,1,0,0,1
220455,2021,1,0,0,1
220460,2020,0,0,1,1
220470,2022,1,0,0,1
220480,2020,0,0,1,1
220510,2021,0,0,1,1
220520,2019,1,0,0,1
220540,2022,0,0,1,1
220550,2017,2,0,0,2
220550,2018,0,0,1,1
220550,2019,0,0,2,2
220550,2020,4,2,1,7
220550,2021,1,0,1,2
220556,2021,0,0,1,1
220558,2021,1,0,0,1
220558,2022,1,0,0,1
220570,2016,1,0,0,1
220570,2020,2,0,0,2
220570,2022,1,1,0,2
220580,2018,2,0,0,2
220580,2019,1,0,0,1
220580,2021,1,0,0,1
220610,2019,1,0,0,1
220620,2015,1,0,0,1
220620,2017,1,0,0,1
220620,2018,0,1,0,1
220620,2019,0,1,1,2
220620,2020,2,0,1,3
220620,2021,0,0,1,1
220620,2022,0,0,1,1
220630,2016,0,0,1,1
220640,2018,0,0,1,1
220640,2021,0,0,1,1
220640,2022,1,0,0,1
220669,2017,1,0,0,1
220672,2017,0,1,0,1
220675,2022,1,0,0,1
220695,2022,0,0,1,1
220700,2015,1,1,0,2
220700,2017,0,0,1,1
220700,2019,3,0,0,3
220700,2020,0,0,1,1
220700,2021,1,0,0,1
220720,2017,0,1,0,1
220730,2020,0,0,1,1
220730,2022,0,0,2,2
220750,2017,0,0,1,1
220750,2018,1,0,1,2
220750,2021,1,0,0,1
220770,2015,3,0,2,5
220770,2016,3,0,4,7
220770,2017,8,3,0,11
220770,2018,6,4,5,15
220770,2019,15,2,11,28
220770,2020,5,1,3,9
220770,2021,12,3,4,19
220770,2022,14,3,5,22
220780,2015,1,0,0,1
220780,2017,0,0,1,1
220780,2022,1,0,0,1
220790,2018,0,1,1,2
220790,2020,0,0,1,1
220790,2021,1,0,1,2
220790,2022,0,0,1,1
220800,2016,0,0,1,1
220800,2017,3,0,3,6
220800,2018,3,0,1,4
220800,2019,5,0,3,8
220800,2020,5,0,1,6
220800,2021,3,1,5,9
220800,2022,4,1,2,7
220820,2015,1,0,0,1
220820,2021,1,0,1,2
220830,2017,1,2,0,3
220830,2019,1,0,0,1
220830,2022,0,0,1,1
220840,2015,1,0,1,2
220840,2017,4,0,0,4
220840,2019,1,2,2,5
220840,2022,2,1,1,4
220850,2020,1,0,0,1
220850,2021,2,0,0,2
220880,2017,1,0,1,2
220880,2018,0,0,1,1
220880,2019,0,1,0,1
220880,2020,0,0,1,1
220880,2021,0,0,1,1
220900,2022,0,0,1,1
220915,2021,2,0,0,2
220920,2021,0,0,1,1
220940,2017,1,0,0,1
220980,2020,1,0,0,1
220980,2021,0,0,1,1
221000,2015,0,0,1,1
221000,2018,1,0,0,1
221000,2019,1,0,0,1
221000,2020,1,0,0,1
221005,2022,1,0,0,1
221010,2017,0,0,1,1
221040,2016,0,0,1,1
221040,2017,1,0,0,1
221040,2019,1,0,0,1
221040,2020,0,0,1,1
221050,2021,1,0,0,1
221060,2017,1,1,0,2
221060,2018,0,0,1,1
221060,2019,1,1,1,3
221060,2021,0,1,0,1
221093,2016,1,0,0,1
221100,2015,70,10,54,134
221100,2016,74,9,59,142
221100,2017,161,26,93,280
221100,2018,110,17,61,188
221100,2019,114,26,76,216
221100,2020,146,33,97,276
221100,2021,111,31,68,210
221100,2022,109,30,62,201
221110,2016,0,0,1,1
221110,2018,0,1,0,1
221110,2020,1,0,0,1
221110,2021,1,0,0,1
221110,2022,1,0,3,4
221120,2015,0,0,2,2
221120,2017,1,0,0,1
221120,2019,1,0,0,1
221120,2020,0,1,1,2
221120,2022,1,0,0,1
221130,2015,2,0,0,2
221130,2016,1,0,0,1
221130,2017,2,0,0,2
221130,2018,1,0,0,1
221130,2019,1,0,0,1
221130,2022,1,0,0,1
221140,2015,0,0,1,1
221140,2016,5,0,4,9
221140,2019,3,0,0,3
221140,2020,2,0,0,2
221140,2022,2,0,0,2
230000,2015,2,0,0,2
230000,2016,1,0,0,1
230000,2017,2,0,0,2
230000,2022,2,0,0,2
230010,2015,0,0,1,1
230010,2016,1,0,0,1
230010,2018,2,0,0,2
230010,2019,1,0,0,1
230010,2021,2,1,0,3
230010,2022,1,0,1,2
230015,2016,0,0,1,1
230015,2018,1,0,0,1
230015,2019,1,0,0,1
230015,2020,1,0,0,1
230015,2021,1,0,0,1
230015,2022,0,1,0,1
230020,2017,2,0,0,2
230020,2018,2,0,0,2
230030,2022,2,2,0,4
230050,2018,1,0,0,1
230060,2020,1,0,0,1
230070,2015,1,0,0,1
230070,2018,0,1,0,1
230070,2022,0,0,1,1
230080,2017,1,0,0,1
230090,2020,0,1,0,1
230100,2015,7,0,1,8
230100,2016,3,2,2,7
230100,2017,5,1,2,8
230100,2018,1,0,5,6
230100,2019,5,1,4,10
230100,2020,7,0,2,9
230100,2021,9,2,3,14
230100,2022,7,4,3,14
230110,2015,2,0,0,2
230110,2016,1,1,2,4
230110,2017,2,0,1,3
230110,2018,2,0,1,3
230110,2019,5,0,2,7
230110,2020,4,0,1,5
230110,2021,2,1,0,3
230110,2022,3,0,1,4
230120,2017,1,0,0,1
230120,2018,1,0,0,1
230120,2022,1,0,0,1
230130,2016,0,0,1,1
230130,2017,0,1,1,2
230130,2020,0,0,1,1
230140,2020,1,0,0,1
230160,2019,1,0,0,1
230160,2022,1,0,0,1
230170,2017,1,1,0,2
230170,2022,1,0,0,1
230185,2017,0,1,0,1
230190,2015,2,0,0,2
230190,2016,1,1,4,6
230190,2017,8,1,3,12
230190,2018,5,0,2,7
230190,2019,11,4,2,17
230190,2020,13,5,4,22
230190,2021,9,1,3,13
230190,2022,5,2,2,9
230195,2020,1,0,0,1
230195,2021,0,0,1,1
230200,2016,1,0,0,1
230200,2017,0,1,0,1
230205,2020,1,0,0,1
230210,2017,1,0,0,1
230210,2018,0,2,1,3
230210,2020,1,1,0,2
230210,2021,2,0,0,2
230210,2022,2,0,2,4
230220,2015,2,0,0,2
230220,2016,1,0,0,1
230220,2017,2,0,0,2
230220,2018,0,1,0,1
230220,2020,2,0,1,3
230220,2022,1,1,1,3
230230,2017,0,0,1,1
230230,2018,0,0,1,1
230230,2021,1,0,1,2
230230,2022,1,0,0,1
230240,2016,1,1,1,3
230240,2018,1,0,0,1
230240,2022,1,0,0,1
230250,2015,0,1,0,1
230250,2016,2,0,1,3
230250,2017,0,1,0,1
230250,2018,3,0,0,3
230250,2019,3,1,3,7
230250,2020,1,0,1,2
230250,2021,1,0,0,1
230250,2022,0,1,1,2
230260,2017,0,2,0,2
230260,2018,1,0,1,2
230260,2020,2,0,1,3
230270,2016,2,0,1,3
230270,2017,1,0,0,1
230270,2018,0,0,1,1
230270,2019,3,0,0,3
230270,2020,0,0,1,1
230270,2021,1,1,1,3
230270,2022,1,1,0,2
230280,2015,0,1,0,1
230280,2017,1,0,1,2
230280,2018,4,2,0,6
230280,2019,1,0,1,2
230280,2020,1,0,0,1
230280,2021,1,0,1,2
230280,2022,3,0,0,3
230290,2016,0,1,0,1
230300,2017,1,0,0,1
230300,2022,1,0,0,1
230320,2015,1,0,0,1
230320,2018,0,0,1,1
230320,2019,2,2,0,4
230320,2020,2,0,1,3
230320,2021,1,2,0,3
230320,2022,1,0,0,1
230340,2020,0,0,1,1
230350,2015,1,1,0,2
230350,2016,5,0,1,6
230350,2017,4,0,1,5
230350,2018,2,0,0,2
230350,2020,3,0,1,4
230350,2021,2,0,1,3
230350,2022,2,1,2,5
230360,2017,2,0,0,2
230370,2015,13,3,16,32
230370,2016,23,3,16,42
230370,2017,24,5,17,46
230370,2018,19,5,10,34
230370,2019,18,1,10,29
230370,2020,33,7,11,51
230370,2021,35,7,30,72
230370,2022,43,10,22,75
230380,2016,0,1,0,1
230380,2020,0,0,1,1
230393,2017,1,0,0,1
230395,2016,0,0,1,1
230395,2018,3,0,2,5
230395,2021,1,0,0,1
230400,2021,2,0,0,2
230410,2016,0,0,3,3
230410,2017,5,0,1,6
230410,2018,1,2,1,4
230410,2019,1,1,0,2
230410,2020,2,0,2,4
230410,2021,2,1,1,4
230410,2022,2,1,0,3
230420,2015,12,0,9,21
230420,2016,5,0,13,18
230420,2017,10,1,13,24
230420,2018,12,2,6,20
230420,2019,13,5,5,23
230420,2020,11,2,6,19
230420,2021,11,2,3,16
230420,2022,14,2,8,24
230423,2022,1,0,0,1
230425,2019,0,0,1,1
230425,2022,1,0,1,2
230428,2015,7,0,4,11
230428,2016,11,3,3,17
230428,2017,15,2,8,25
230428,2018,21,7,3,31
230428,2019,13,3,7,23
230428,2020,16,3,8,27
230428,2021,13,7,5,25
230428,2022,19,7,5,31
230430,2015,0,0,1,1
230430,2021,0,0,1,1
230435,2015,0,1,0,1
230435,2020,1,0,2,3
230435,2021,1,0,0,1
230435,2022,1,0,0,1
230440,2015,260,57,142,459
230440,2016,353,57,175,585
230440,2017,474,98,198,770
230440,2018,458,79,139,676
230440,2019,383,109,149,641
230440,2020,525,134,289,948
230440,2021,528,134,235,897
230440,2022,516,130,208,854
230450,2015,1,0,0,1
230450,2021,1,0,0,1
230490,2017,0,0,1,1
230495,2018,1,0,0,1
230495,2021,1,0,0,1
230495,2022,1,0,0,1
230500,2020,0,1,0,1
230510,2019,1,0,0,1
230520,2018,1,0,0,1
230520,2019,1,0,0,1
230523,2019,3,0,1,4
230523,2020,2,0,0,2
230523,2021,0,0,1,1
230523,2022,2,0,2,4
230530,2018,1,0,0,1
230535,2021,2,0,0,2
230535,2022,2,0,0,2
230540,2016,0,0,1,1
230540,2021,1,0,0,1
230550,2015,0,0,1,1
230550,2016,3,1,3,7
230550,2017,5,1,0,6
230550,2018,4,0,2,6
230550,2019,1,0,2,3
230550,2020,5,1,1,7
230550,2021,0,0,2,2
230550,2022,3,0,0,3
230580,2018,2,0,0,2
230580,2021,1,0,0,1
230580,2022,2,0,0,2
230590,2016,0,1,0,1
230590,2019,0,0,1,1
230590,2021,1,0,0,1
230600,2017,0,1,0,1
230625,2015,1,0,1,2
230625,2016,2,0,2,4
230625,2018,1,0,2,3
230625,2019,0,0,1,1
230625,2020,0,2,1,3
230625,2021,1,0,0,1
230625,2022,2,0,0,2
230630,2022,1,0,1,2
230640,2015,0,0,1,1
230640,2017,4,2,2,8
230640,2018,2,2,0,4
230640,2019,4,1,1,6
230640,2020,0,0,1,1
230650,2018,0,1,0,1
230650,2020,0,1,0,1
230655,2015,1,0,0,1
230680,2015,1,0,0,1
230680,2016,1,0,0,1
230680,2018,1,1,0,2
230690,2016,0,0,1,1
230690,2017,1,0,0,1
230690,2018,1,0,0,1
230690,2020,1,0,0,1
230700,2022,0,0,1,1
230710,2017,1,0,0,1
230710,2020,0,0,1,1
230710,2021,2,0,2,4
230710,2022,1,0,0,1
230720,2017,1,0,0,1
230720,2019,1,0,0,1
230720,2022,1,0,0,1
230725,2017,0,1,0,1
230725,2021,1,0,0,1
230730,2015,20,0,16,36
230730,2016,31,3,19,53
230730,2017,29,6,25,60
230730,2018,26,10,13,49
230730,2019,28,4,16,48
230730,2020,20,11,13,44
230730,2021,35,10,10,55
230730,2022,39,5,23,67
230740,2017,1,0,0,1
230740,2021,0,0,1,1
230740,2022,0,0,1,1
230760,2016,0,0,2,2
230760,2017,3,0,0,3
230760,2018,4,1,0,5
230760,2019,1,1,0,2
230760,2020,1,0,0,1
230760,2022,3,0,0,3
230763,2015,1,0,0,1
230763,2017,1,0,0,1
230765,2015,5,1,8,14
230765,2016,8,1,2,11
230765,2017,10,1,8,19
230765,2018,6,1,8,15
230765,2019,6,1,8,15
230765,2020,23,5,16,44
230765,2021,21,2,10,33
230765,2022,14,7,8,29
230770,2015,1,0,0,1
230770,2017,0,0,1,1
230770,2018,0,1,2,3
230770,2019,1,0,2,3
230770,2020,3,0,0,3
230770,2021,3,1,5,9
230770,2022,2,1,1,4
230780,2019,0,0,1,1
230800,2017,0,0,1,1
230800,2018,1,0,0,1
230810,2017,0,0,1,1
230810,2019,3,0,1,4
230810,2020,1,1,1,3
230820,2018,1,0,0,1
230820,2019,1,0,0,1
230830,2016,0,0,2,2
230830,2020,1,0,0,1
230835,2022,0,0,1,1
230840,2016,0,1,0,1
230840,2017,0,0,1,1
230840,2020,1,0,2,3
230840,2021,0,0,2,2
230850,2017,0,0,1,1
230850,2021,0,0,1,1
230850,2022,1,1,0,2
230870,2015,0,0,1,1
230870,2017,0,1,1,2
230870,2021,1,0,0,1
230890,2018,1,0,1,2
230890,2019,0,0,1,1
230890,2022,0,0,1,1
230900,2020,1,0,0,1
230920,2016,1,0,1,2
230920,2018,0,1,0,1
230920,2019,1,0,0,1
230920,2020,1,0,0,1
230930,2017,1,0,0,1
230930,2018,3,0,1,4
230930,2020,1,0,0,1
230940,2022,0,1,0,1
230945,2020,0,0,1,1
230960,2015,2,0,1,3
230960,2016,1,0,0,1
230960,2018,1,2,0,3
230960,2019,3,0,0,3
230960,2020,0,1,2,3
230960,2021,3,1,1,5
230960,2022,0,0,1,1
230970,2015,1,0,1,2
230970,2016,0,0,1,1
230970,2017,0,0,2,2
230970,2018,1,0,0,1
230970,2019,1,0,0,1
230970,2020,1,0,0,1
230970,2021,0,0,1,1
230970,2022,2,0,1,3
230980,2021,0,0,1,1
231020,2016,1,0,0,1
231020,2020,2,0,1,3
231025,2016,1,0,0,1
231025,2018,1,0,0,1
231025,2019,1,0,0,1
231060,2016,0,0,1,1
231060,2020,0,0,1,1
231070,2015,1,0,0,1
231080,2017,1,0,0,1
231080,2020,1,0,1,2
231080,2021,1,0,1,2
231080,2022,1,0,1,2
231085,2016,0,1,0,1
231085,2017,0,0,1,1
231110,2018,0,0,1,1
231120,2016,1,0,0,1
231120,2018,1,0,0,1
231120,2019,1,0,0,1
231130,2015,1,0,0,1
231130,2016,2,1,1,4
231130,2017,0,0,1,1
231130,2018,1,1,1,3
231130,2019,1,0,0,1
231130,2020,3,1,0,4
231130,2021,2,1,0,3
231130,2022,2,0,1,3
231140,2016,0,0,1,1
231140,2017,1,0,0,1
231140,2018,1,0,0,1
231140,2019,0,1,2,3
231140,2021,1,0,2,3
231140,2022,4,0,0,4
231160,2020,0,0,1,1
231170,2017,1,0,0,1
231170,2020,1,0,0,1
231180,2015,0,0,2,2
231180,2017,1,0,0,1
231180,2018,1,0,1,2
231180,2021,1,0,0,1
231180,2022,0,0,1,1
231210,2020,1,0,0,1
231220,2016,1,0,0,1
231220,2017,1,0,0,1
231220,2018,2,0,0,2
231220,2021,0,1,0,1
231230,2016,3,0,2,5
231230,2017,1,0,0,1
231230,2019,0,1,0,1
231230,2022,0,1,0,1
231240,2015,0,0,1,1
231240,2016,2,0,2,4
231240,2017,5,1,1,7
231240,2018,1,0,1,2
231240,2019,1,0,0,1
231240,2020,5,0,0,5
231240,2021,1,0,2,3
231240,2022,2,1,1,4
231270,2020,1,0,0,1
231280,2022,0,0,1,1
231290,2015,9,2,5,16
231290,2016,11,2,6,19
231290,2017,13,6,6,25
231290,2018,24,4,6,34
231290,2019,12,0,2,14
231290,2020,18,0,4,22
231290,2021,9,4,5,18
231290,2022,16,5,5,26
231300,2018,0,0,1,1
231310,2017,1,0,1,2
231310,2018,0,1,0,1
231310,2021,0,1,0,1
231310,2022,0,0,1,1
231320,2019,1,0,0,1
231330,2016,1,0,0,1
231330,2019,0,1,0,1
231340,2015,2,0,0,2
231340,2017,1,0,0,1
231340,2018,1,0,1,2
231340,2019,1,0,0,1
231340,2020,1,0,0,1
231340,2021,2,0,1,3
231340,2022,1,1,1,3
231350,2015,0,0,1,1
231350,2021,0,1,0,1
231355,2015,0,1,0,1
231360,2015,1,1,0,2
231360,2016,0,0,1,1
231360,2017,0,0,1,1
231360,2018,2,1,0,3
231375,2019,1,0,0,1
231380,2018,1,1,0,2
231380,2022,0,0,1,1
231390,2018,1,0,0,1
231395,2021,1,0,0,1
231400,2020,0,0,1,1
240000,2016,1,0,0,1
240000,2017,1,0,0,1
240000,2019,1,0,0,1
240000,2020,1,0,0,1
240010,2017,0,0,1,1
240020,2015,0,0,1,1
240020,2016,1,0,0,1
240020,2017,1,1,0,2
240020,2019,1,0,1,2
240020,2020,1,0,1,2
240020,2021,1,0,0,1
240020,2022,2,0,0,2
240050,2021,1,0,0,1
240070,2016,2,0,0,2
240070,2017,1,0,0,1
240070,2018,0,1,0,1
240070,2019,0,1,0,1
240070,2021,2,0,0,2
240070,2022,1,1,0,2
240080,2015,0,0,1,1
240080,2016,2,0,0,2
240080,2020,0,0,1,1
240100,2016,1,0,0,1
240100,2018,1,0,0,1
240100,2019,1,0,0,1
240100,2020,0,1,0,1
240110,2015,0,0,1,1
240110,2016,1,0,1,2
240110,2017,0,1,0,1
240110,2018,3,0,1,4
240110,2019,3,0,0,3
240110,2020,1,0,1,2
240110,2021,1,1,3,5
240110,2022,1,1,1,3
240120,2016,0,0,1,1
240120,2022,0,0,1,1
240130,2022,1,0,0,1
240140,2015,1,0,0,1
240140,2016,0,1,0,1
240140,2018,1,0,0,1
240140,2022,1,0,1,2
240145,2016,1,0,0,1
240145,2021,2,1,0,3
240145,2022,1,0,0,1
240160,2015,0,0,1,1
240160,2022,0,0,1,1
240170,2021,1,0,0,1
240180,2018,0,1,0,1
240180,2019,1,0,0,1
240180,2020,1,0,0,1
240185,2018,0,0,1,1
240185,2020,1,0,0,1
240190,2020,1,0,0,1
240200,2015,2,0,1,3
240200,2016,0,1,0,1
240200,2017,2,0,1,3
240200,2018,3,2,1,6
240200,2019,1,0,0,1
240200,2020,1,0,0,1
240200,2021,3,1,1,5
240200,2022,0,1,0,1
240210,2021,1,0,0,1
240220,2015,3,0,0,3
240220,2016,1,0,0,1
240220,2017,0,0,1,1
240220,2019,1,0,0,1
240220,2020,1,1,0,2
240220,2021,1,0,0,1
240230,2015,1,0,2,3
240230,2017,1,0,0,1
240230,2018,1,0,0,1
240230,2019,1,0,0,1
240240,2019,0,1,0,1
240260,2015,6,1,1,8
240260,2016,2,1,0,3
240260,2017,2,1,0,3
240260,2018,2,0,2,4
240260,2019,2,1,1,4
240260,2020,7,0,1,8
240260,2021,3,0,0,3
240260,2022,9,2,3,14
240270,2017,1,0,0,1
240300,2017,0,1,0,1
240310,2015,3,0,0,3
240310,2017,1,1,1,3
240310,2018,1,1,3,5
240310,2019,3,1,0,4
240310,2021,1,1,0,2
240310,2022,2,0,0,2
240325,2015,40,9,25,74
240325,2016,64,11,25,100
240325,2017,65,13,17,95
240325,2018,43,16,27,86
240325,2019,53,11,15,79
240325,2020,37,14,25,76
240325,2021,59,15,31,105
240325,2022,47,14,26,87
240350,2019,1,0,1,2
240350,2022,1,0,0,1
240360,2015,0,0,2,2
240360,2016,6,0,0,6
240360,2017,1,0,1,2
240360,2018,4,0,0,4
240360,2019,1,0,2,3
240360,2020,0,0,6,6
240360,2021,4,0,3,7
240360,2022,5,0,2,7
240370,2018,0,1,0,1
240420,2015,1,1,2,4
240420,2016,4,0,5,9
240420,2017,1,0,1,2
240420,2018,2,0,2,4
240420,2019,2,0,2,4
240420,2021,2,0,0,2
240420,2022,1,0,0,1
240440,2022,2,0,1,3
240450,2016,1,0,0,1
240450,2017,1,0,0,1
240450,2019,0,0,1,1
240450,2020,0,0,1,1
240460,2015,1,0,0,1
240460,2016,0,1,0,1
240460,2019,0,1,0,1
240460,2020,0,1,0,1
240470,2021,1,0,0,1
240500,2019,0,1,0,1
240510,2016,1,0,0,1
240560,2016,1,0,0,1
240560,2018,1,0,0,1
240580,2015,0,1,1,2
240580,2018,3,0,1,4
240580,2019,1,0,0,1
240580,2020,0,0,4,4
240580,2021,2,0,0,2
240630,2021,0,0,1,1
240640,2018,1,0,0,1
240660,2018,1,0,0,1
240670,2018,1,0,1,2
240670,2019,1,0,0,1
240670,2021,0,0,1,1
240710,2015,3,0,1,4
240710,2016,2,0,2,4
240710,2017,2,0,0,2
240710,2018,8,1,2,11
240710,2019,4,0,2,6
240710,2020,6,1,2,9
240710,2021,5,1,1,7
240710,2022,1,0,1,2
240720,2015,2,0,0,2
240720,2016,1,0,1,2
240720,2017,1,1,1,3
240720,2018,1,0,0,1
240720,2019,2,0,0,2
240720,2020,2,0,0,2
240720,2021,0,1,0,1
240720,2022,1,0,1,2
240740,2022,0,0,1,1
240750,2021,1,0,0,1
240770,2016,0,0,1,1
240770,2021,0,0,1,1
240770,2022,0,0,1,1
240780,2015,0,0,1,1
240780,2016,0,0,1,1
240780,2022,1,2,1,4
240800,2015,19,5,10,34
240800,2016,19,1,2,22
240800,2017,31,4,9,44
240800,2018,20,3,13,36
240800,2019,21,3,4,28
240800,2020,24,5,10,39
240800,2021,38,11,16,65
240800,2022,31,9,10,50
240810,2015,128,29,68,225
240810,2016,104,28,56,188
240810,2017,135,24,54,213
240810,2018,135,29,48,212
240810,2019,112,29,45,186
240810,2020,156,28,72,256
240810,2021,125,44,66,235
240810,2022,104,39,46,189
240820,2015,1,0,0,1
240830,2015,0,1,0,1
240830,2016,1,1,1,3
240830,2017,0,0,1,1
240830,2018,0,1,1,2
240850,2017,1,0,0,1
240890,2017,1,0,0,1
240890,2019,1,0,0,1
240890,2022,1,0,0,1
240895,2015,1,0,0,1
240895,2016,0,2,1,3
240895,2021,1,0,0,1
240895,2022,0,1,1,2
240910,2021,0,1,0,1
240933,2016,1,0,0,1
240933,2019,0,1,0,1
240933,2020,1,0,0,1
240933,2021,1,0,0,1
240940,2018,0,0,1,1
240980,2021,1,0,0,1
240990,2017,1,0,0,1
241000,2020,1,0,0,1
241010,2016,1,0,0,1
241010,2021,1,0,0,1
241010,2022,1,0,0,1
241070,2022,0,0,1,1
241080,2017,1,0,0,1
241090,2017,1,0,0,1
241120,2018,2,0,0,2
241120,2020,3,0,0,3
241140,2022,1,0,0,1
241150,2017,1,0,0,1
241200,2015,5,1,1,7
241200,2016,2,0,1,3
241200,2017,0,0,2,2
241200,2018,7,0,2,9
241200,2019,0,0,2,2
241200,2020,13,2,8,23
241200,2021,2,0,1,3
241200,2022,2,0,1,3
241210,2021,0,0,1,1
241220,2015,0,0,1,1
241220,2016,4,0,0,4
241220,2017,1,0,0,1
241220,2018,0,0,1,1
241220,2020,2,0,1,3
241250,2017,2,0,0,2
241250,2018,1,0,0,1
241260,2015,0,0,1,1
241260,2016,1,0,0,1
241260,2017,1,0,0,1
241260,2018,0,0,1,1
241260,2019,1,0,0,1
241260,2021,2,0,0,2
241260,2022,0,0,1,1
241270,2016,1,0,0,1
241270,2018,2,0,0,2
241270,2019,0,0,2,2
241270,2022,0,0,1,1
241300,2015,0,0,1,1
241300,2017,1,0,0,1
241300,2018,1,0,0,1
241300,2019,2,0,0,2
241300,2020,1,0,0,1
241300,2021,1,0,0,1
241300,2022,1,0,0,1
241340,2017,1,0,0,1
241340,2018,1,0,0,1
241340,2022,0,0,1,1
241350,2016,2,0,0,2
241350,2020,0,1,0,1
241350,2021,1,0,0,1
241370,2016,0,1,0,1
241400,2022,1,0,0,1
241410,2019,1,0,0,1
241410,2022,1,0,0,1
241415,2017,1,0,0,1
241420,2015,2,1,1,4
241420,2018,3,1,0,4
241420,2020,1,0,0,1
241440,2020,1,0,0,1
241450,2021,0,0,1,1
241460,2016,0,1,0,1
241460,2017,1,0,0,1
241470,2017,1,0,0,1
241470,2019,0,0,1,1
250000,2016,0,0,1,1
250000,2018,0,1,0,1
250030,2018,1,0,0,1
250030,2020,2,0,0,2
250030,2021,0,0,1,1
250040,2015,1,1,0,2
250040,2016,2,0,0,2
250040,2018,1,0,0,1
250040,2020,0,1,0,1
250040,2021,1,0,0,1
250050,2017,0,0,1,1
250050,2022,1,0,0,1
250060,2015,0,0,1,1
250060,2017,1,0,0,1
250060,2018,0,0,3,3
250060,2019,1,0,1,2
250060,2020,1,0,0,1
250060,2021,0,0,1,1
250060,2022,0,1,0,1
250073,2019,1,0,0,1
250073,2020,1,0,0,1
250073,2021,0,1,0,1
250077,2021,1,0,0,1
250080,2017,0,0,1,1
250080,2022,1,0,0,1
250100,2016,1,0,0,1
250100,2018,1,0,0,1
250110,2019,0,1,0,1
250110,2020,1,0,0,1
250110,2021,2,0,0,2
250120,2017,1,0,0,1
250120,2018,1,0,0,1
250130,2021,1,0,0,1
250130,2022,1,0,0,1
250150,2017,0,1,0,1
250150,2018,1,0,0,1
250150,2021,1,0,0,1
250150,2022,0,0,1,1
250157,2019,0,2,0,2
250160,2015,0,1,0,1
250170,2018,1,0,0,1
250180,2015,5,0,1,6
250180,2016,2,1,3,6
250180,2017,1,2,7,10
250180,2018,3,0,2,5
250180,2019,4,3,4,11
250180,2020,0,0,2,2
250180,2021,5,0,3,8
250180,2022,3,0,3,6
250190,2017,2,0,0,2
250190,2019,1,0,0,1
250190,2021,1,0,0,1
250215,2015,1,0,0,1
250215,2017,3,0,1,4
250215,2018,1,0,0,1
250215,2019,1,0,0,1
250215,2021,1,0,0,1
250215,2022,1,0,0,1
250230,2017,1,0,0,1
250230,2021,0,0,1,1
250230,2022,2,0,0,2
250240,2017,1,0,0,1
250250,2015,0,0,1,1
250250,2016,0,0,1,1
250250,2017,0,0,1,1
250250,2019,1,0,0,1
250250,2022,1,0,0,1
250280,2018,1,0,0,1
250300,2017,1,0,1,2
250300,2018,0,0,2,2
250300,2019,1,0,1,2
250300,2020,1,0,0,1
250300,2021,3,0,0,3
250300,2022,1,0,0,1
250310,2017,2,0,0,2
250320,2015,1,0,0,1
250320,2016,7,0,2,9
250320,2017,11,1,6,18
250320,2018,10,0,6,16
250320,2019,7,1,3,11
250320,2020,4,2,8,14
250320,2021,11,0,2,13
250320,2022,7,3,5,15
250370,2015,0,0,1,1
250370,2016,0,1,2,3
250370,2017,0,0,2,2
250370,2018,1,1,0,2
250370,2020,2,0,1,3
250370,2021,2,1,1,4
250370,2022,1,0,0,1
250400,2015,32,6,19,57
250400,2016,38,7,14,59
250400,2017,53,12,30,95
250400,2018,50,14,18,82
250400,2019,48,19,21,88
250400,2020,51,21,33,105
250400,2021,46,9,36,91
250400,2022,49,13,23,85
250430,2015,1,0,0,1
250430,2016,0,0,1,1
250430,2019,0,0,1,1
250435,2015,0,0,1,1
250435,2020,1,0,0,1
250440,2016,0,0,1,1
250440,2017,0,0,1,1
250450,2018,0,0,1,1
250450,2022,0,0,1,1
250460,2016,1,0,0,1
250460,2017,0,0,1,1
250460,2018,1,0,2,3
250460,2022,0,0,1,1
250480,2015,1,0,0,1
250490,2015,0,0,1,1
250490,2018,1,0,0,1
250490,2020,0,0,1,1
250490,2021,0,0,1,1
250500,2021,0,0,1,1
250510,2020,2,0,0,2
250580,2022,0,0,1,1
250600,2016,0,0,1,1
250600,2017,0,0,1,1
250600,2018,0,1,0,1
250600,2019,1,0,0,1
250600,2020,1,1,0,2
250600,2022,1,1,2,4
250610,2019,0,2,0,2
250610,2022,1,0,0,1
250630,2016,1,0,0,1
250630,2017,2,0,1,3
250630,2018,2,0,0,2
250630,2019,1,0,0,1
250630,2020,1,0,0,1
250630,2022,3,0,1,4
250640,2017,0,0,1,1
250640,2022,0,0,1,1
250680,2016,0,0,1,1
250680,2018,0,0,1,1
250680,2019,0,0,1,1
250690,2015,1,0,0,1
250690,2017,1,1,0,2
250690,2019,2,0,1,3
250690,2021,1,0,0,1
250690,2022,1,0,0,1
250700,2017,0,0,1,1
250720,2018,0,1,0,1
250730,2017,0,1,0,1
250730,2018,0,0,1,1
250730,2020,2,0,0,2
250750,2015,46,13,29,88
250750,2016,53,19,37,109
250750,2017,150,22,71,243
250750,2018,109,25,41,175
250750,2019,87,25,35,147
250750,2020,78,20,37,135
250750,2021,81,22,21,124
250750,2022,103,34,43,180
250790,2017,0,0,1,1
250790,2018,2,0,0,2
250800,2019,0,0,1,1
250820,2017,0,0,1,1
250830,2015,1,0,1,2
250830,2017,1,1,2,4
250830,2019,1,0,0,1
250830,2021,1,0,0,1
250830,2022,0,0,1,1
250860,2017,1,0,1,2
250860,2018,0,0,1,1
250860,2019,2,0,0,2
250870,2021,0,0,1,1
250890,2017,0,1,1,2
250890,2018,1,0,0,1
250890,2019,0,0,1,1
250890,2020,1,0,0,1
250890,2022,4,0,0,4
250905,2022,0,0,1,1
250910,2017,1,0,0,1
250910,2019,1,0,0,1
250920,2017,1,0,0,1
250930,2022,0,0,1,1
250950,2015,1,0,0,1
250950,2016,1,0,0,1
250970,2015,1,0,0,1
250970,2020,1,0,1,2
250970,2021,1,0,0,1
251050,2015,0,1,0,1
251050,2017,0,0,1,1
251080,2015,0,1,3,4
251080,2016,1,1,0,2
251080,2017,1,1,0,2
251080,2018,3,1,0,4
251080,2019,1,1,2,4
251080,2020,1,1,1,3
251080,2021,1,0,1,2
251080,2022,1,0,2,3
251090,2016,1,0,0,1
251090,2017,0,0,2,2
251090,2018,1,0,2,3
251090,2019,2,0,0,2
251090,2020,1,0,0,1
251090,2021,2,0,0,2
251090,2022,2,1,1,4
251120,2015,0,0,1,1
251120,2017,1,0,0,1
251120,2018,0,0,1,1
251120,2019,0,0,1,1
251120,2022,0,1,2,3
251130,2017,0,1,0,1
251130,2018,1,0,0,1
251140,2019,0,0,1,1
251150,2021,1,0,0,1
251160,2017,0,0,1,1
251190,2015,0,0,2,2
251190,2016,0,0,4,4
251190,2017,0,0,1,1
251190,2021,1,0,0,1
251200,2022,1,0,0,1
251210,2020,1,0,0,1
251210,2021,1,0,0,1
251250,2017,2,0,1,3
251250,2018,1,0,1,2
251250,2019,0,0,1,1
251250,2020,0,0,1,1
251250,2021,1,0,0,1
251250,2022,3,0,1,4
251270,2015,0,0,1,1
251270,2016,1,1,0,2
251270,2017,2,0,0,2
251290,2018,1,0,2,3
251290,2019,0,0,1,1
251290,2021,1,0,0,1
251340,2015,1,0,0,1
251370,2015,3,0,2,5
251370,2016,4,1,1,6
251370,2017,6,0,3,9
251370,2018,8,1,3,12
251370,2019,8,0,2,10
251370,2020,3,1,4,8
251370,2021,1,1,0,2
251370,2022,0,2,1,3
251385,2015,1,0,1,2
251385,2016,1,0,1,2
251385,2017,2,0,1,3
251385,2018,1,0,1,2
251385,2019,2,2,0,4
251385,2020,4,1,1,6
251385,2021,1,2,0,3
251385,2022,5,0,0,5
251390,2015,1,0,0,1
251390,2018,0,0,1,1
251398,2017,0,0,1,1
251420,2017,1,0,0,1
251420,2018,1,0,0,1
251420,2021,1,0,0,1
251450,2018,0,0,1,1
251450,2019,1,0,0,1
251450,2021,0,2,0,2
251530,2015,0,0,1,1
251530,2016,1,0,0,1
251530,2017,3,1,1,5
251530,2018,1,0,1,2
251530,2019,1,0,1,2
251530,2020,1,0,0,1
251550,2017,0,1,0,1
251593,2021,0,0,2,2
251593,2022,1,0,0,1
251597,2018,2,0,0,2
251600,2015,1,0,0,1
251600,2016,1,0,0,1
251600,2017,0,0,1,1
251600,2018,0,0,1,1
251600,2020,1,0,0,1
251600,2021,1,0,0,1
251610,2020,1,0,0,1
251620,2015,0,0,1,1
251620,2017,1,0,5,6
251620,2018,1,0,1,2
251620,2019,1,0,1,2
251620,2020,3,0,0,3
251620,2021,1,0,2,3
251620,2022,3,0,0,3
251630,2015,2,0,0,2
251640,2017,0,1,0,1
251670,2017,0,1,0,1
251675,2019,0,1,0,1
251690,2015,1,0,1,2
251690,2017,0,0,2,2
251690,2018,1,0,0,1
251690,2019,0,1,0,1
251700,2016,1,0,0,1
251700,2019,2,0,0,2
251710,2017,1,0,0,1
260000,2015,0,1,0,1
260000,2016,2,1,0,3
260000,2017,6,1,0,7
260000,2018,1,0,0,1
260000,2019,1,0,0,1
260000,2020,2,0,0,2
260000,2021,0,1,0,1
260000,2022,1,1,0,2
260005,2015,2,0,0,2
260005,2016,5,0,1,6
260005,2017,5,2,3,10
260005,2018,3,1,1,5
260005,2019,2,0,3,5
260005,2020,1,1,0,2
260005,2021,5,0,7,12
260005,2022,5,1,3,9
260010,2016,1,0,0,1
260010,2017,0,1,0,1
260010,2018,1,1,1,3
260010,2019,0,0,2,2
260010,2020,1,0,2,3
260010,2021,0,1,0,1
260020,2015,0,1,0,1
260020,2017,1,0,2,3
260020,2019,1,0,0,1
260020,2020,0,1,0,1
260020,2022,1,0,0,1
260030,2018,2,0,2,4
260030,2019,0,1,0,1
260030,2022,1,0,0,1
260040,2015,1,0,0,1
260050,2015,0,1,0,1
260050,2017,2,0,0,2
260050,2018,1,0,0,1
260050,2019,1,0,0,1
260080,2016,0,0,1,1
260080,2017,0,0,1,1
260080,2020,0,1,0,1
260090,2019,0,1,0,1
260090,2022,0,0,1,1
260100,2015,3,0,0,3
260100,2017,1,0,0,1
260100,2018,0,0,1,1
260100,2021,0,2,0,2
260105,2021,1,0,0,1
260110,2015,3,0,0,3
260110,2016,2,0,0,2
260110,2019,4,0,0,4
260110,2020,1,0,0,1
260110,2021,1,0,0,1
260120,2015,3,0,2,5
260120,2016,0,1,1,2
260120,2017,0,0,1,1
260120,2018,5,2,1,8
260120,2019,4,0,2,6
260120,2020,1,2,1,4
260120,2021,5,0,0,5
260120,2022,2,3,0,5
260140,2016,0,0,1,1
260140,2017,1,1,0,2
260140,2018,2,0,1,3
260140,2019,1,0,0,1
260150,2019,0,0,1,1
260150,2021,1,0,0,1
260150,2022,1,0,0,1
260160,2019,1,0,0,1
260170,2015,2,0,3,5
260170,2017,3,3,1,7
260170,2018,1,2,3,6
260170,2019,5,2,2,9
260170,2020,7,0,0,7
260170,2021,9,0,1,10
260170,2022,2,0,1,3
260190,2016,1,0,0,1
260190,2017,1,0,3,4
260190,2018,2,1,2,5
260190,2019,0,0,2,2
260190,2020,1,0,0,1
260190,2021,3,0,0,3
260190,2022,1,0,0,1
260200,2015,2,0,0,2
260200,2018,1,0,0,1
260200,2020,1,0,0,1
260210,2015,3,0,0,3
260210,2016,2,0,1,3
260210,2017,1,0,0,1
260210,2018,2,0,0,2
260210,2019,4,0,0,4
260210,2020,3,0,0,3
260210,2021,1,0,0,1
260210,2022,2,0,0,2
260220,2022,1,0,0,1
260230,2015,2,0,1,3
260230,2016,0,0,2,2
260230,2017,1,0,0,1
260230,2018,0,0,1,1
260230,2019,1,0,0,1
260230,2020,1,0,0,1
260230,2021,0,0,1,1
260240,2018,1,0,0,1
260240,2019,1,0,0,1
260260,2015,1,1,2,4
260260,2016,3,0,0,3
260260,2017,0,1,2,3
260260,2018,1,1,0,2
260260,2019,1,1,0,2
260260,2020,2,0,0,2
260260,2021,1,0,0,1
260260,2022,0,0,1,1
260270,2019,0,0,2,2
260280,2015,2,0,0,2
260280,2017,1,0,0,1
260280,2018,1,0,0,1
260280,2020,1,1,0,2
260280,2022,1,0,0,1
260290,2015,4,1,8,13
260290,2016,3,1,13,17
260290,2017,12,2,9,23
260290,2018,13,3,6,22
260290,2019,4,1,6,11
260290,2020,1,0,2,3
260290,2021,8,4,9,21
260290,2022,4,3,6,13
260300,2015,0,0,1,1
260300,2016,1,0,0,1
260300,2018,1,1,0,2
260300,2020,1,0,0,1
260300,2022,4,0,0,4
260310,2016,0,0,2,2
260310,2019,0,0,1,1
260310,2020,0,0,1,1
260310,2021,0,1,0,1
260310,2022,1,0,0,1
260320,2015,0,0,1,1
260320,2020,1,0,0,1
260320,2021,2,0,0,2
260340,2018,0,0,1,1
260345,2015,3,1,0,4
260345,2016,3,1,4,8
260345,2017,6,1,2,9
260345,2018,3,1,1,5
260345,2019,6,1,8,15
260345,2020,3,0,2,5
260345,2021,5,1,6,12
260345,2022,5,2,5,12
260350,2017,1,0,1,2
260350,2018,0,0,1,1
260350,2019,1,0,0,1
260350,2020,1,0,0,1
260370,2015,1,0,0,1
260380,2018,2,0,0,2
260390,2018,1,0,0,1
260400,2015,1,0,0,1
260400,2016,0,0,3,3
260400,2017,1,1,1,3
260400,2018,0,3,0,3
260400,2019,2,0,0,2
260400,2020,1,0,1,2
260400,2022,2,0,1,3
260410,2015,49,7,33,89
260410,2016,31,6,24,61
260410,2017,64,7,42,113
260410,2018,56,14,29,99
260410,2019,28,6,17,51
260410,2020,23,2,14,39
260410,2021,26,10,15,51
260410,2022,24,6,15,45
260420,2019,0,0,1,1
260420,2022,1,0,0,1
260440,2015,1,0,0,1
260460,2016,1,0,0,1
260460,2017,0,0,1,1
260460,2019,1,0,0,1
260460,2022,1,0,0,1
260470,2017,0,1,0,1
260470,2018,2,0,1,3
260470,2021,0,1,0,1
260490,2016,0,0,1,1
260500,2015,1,0,0,1
260500,2017,0,0,2,2
260500,2018,1,0,0,1
260500,2019,2,0,1,3
260500,2022,3,0,0,3
260510,2018,1,0,0,1
260510,2020,1,0,0,1
260510,2021,1,0,1,2
260515,2015,0,0,1,1
260515,2016,0,0,2,2
260515,2017,2,0,0,2
260515,2019,1,0,0,1
260515,2022,1,0,0,1
260520,2016,1,0,1,2
260520,2017,1,0,0,1
260520,2018,0,0,1,1
260520,2020,2,0,0,2
260520,2021,1,0,2,3
260520,2022,1,0,1,2
260530,2016,1,0,0,1
260530,2017,2,0,0,2
260530,2018,0,0,1,1
260540,2018,0,0,2,2
260545,2016,0,0,1,1
260570,2017,1,0,0,1
260570,2018,1,0,0,1
260570,2019,1,0,0,1
260570,2022,0,0,1,1
260580,2018,0,0,3,3
260590,2017,0,0,1,1
260600,2015,16,1,7,24
260600,2016,10,0,12,22
260600,2017,14,6,5,25
260600,2018,12,3,3,18
260600,2019,10,4,4,18
260600,2020,6,4,4,14
260600,2021,5,2,3,10
260600,2022,8,1,7,16
260610,2015,0,0,1,1
260610,2016,1,1,0,2
260610,2017,1,0,1,2
260610,2018,0,0,1,1
260610,2019,1,0,2,3
260610,2020,0,0,1,1
260610,2021,0,1,1,2
260610,2022,1,0,1,2
260620,2015,3,0,2,5
260620,2016,6,0,4,10
260620,2017,6,1,12,19
260620,2018,14,0,9,23
260620,2019,9,1,6,16
260620,2020,7,0,8,15
260620,2021,7,1,3,11
260620,2022,5,1,8,14
260630,2022,0,1,0,1
260640,2015,3,0,0,3
260640,2016,1,0,0,1
260640,2017,1,0,2,3
260640,2018,0,0,3,3
260640,2019,1,0,1,2
260640,2020,1,0,0,1
260640,2021,1,0,0,1
260640,2022,0,1,1,2
260660,2015,1,0,0,1
260660,2022,2,0,0,2
260680,2015,4,0,4,8
260680,2016,0,0,1,1
260680,2018,1,0,1,2
260680,2019,2,0,2,4
260680,2020,2,0,2,4
260680,2021,1,2,1,4
260680,2022,1,1,3,5
260700,2015,1,0,0,1
260700,2020,1,0,0,1
260720,2015,4,0,5,9
260720,2016,5,2,12,19
260720,2017,4,1,7,12
260720,2018,6,0,4,10
260720,2019,1,1,3,5
260720,2020,4,0,2,6
260720,2021,4,0,0,4
260720,2022,2,1,4,7
260730,2015,1,0,0,1
260730,2018,1,0,0,1
260750,2018,0,0,1,1
260750,2019,0,0,1,1
260760,2018,1,0,0,1
260760,2021,2,1,0,3
260765,2015,1,0,0,1
260765,2017,0,0,3,3
260765,2020,0,0,1,1
260765,2021,1,0,1,2
260765,2022,0,0,1,1
260775,2015,0,0,2,2
260775,2016,0,0,1,1
260775,2017,1,0,0,1
260775,2020,1,0,0,1
260775,2021,1,0,1,2
260790,2015,23,6,16,45
260790,2016,27,8,21,56
260790,2017,48,7,24,79
260790,2018,39,12,10,61
260790,2019,36,7,13,56
260790,2020,20,0,2,22
260790,2021,33,10,34,77
260790,2022,23,11,21,55
260805,2019,0,1,0,1
260825,2018,1,0,0,1
260830,2017,3,0,0,3
260830,2020,1,0,0,1
260840,2017,1,0,0,1
260840,2018,1,0,0,1
260840,2020,1,0,0,1
260845,2017,0,1,0,1
260850,2017,0,0,1,1
260850,2019,0,0,1,1
260875,2017,1,0,0,1
260875,2018,1,0,1,2
260875,2020,1,1,0,2
260875,2021,2,1,3,6
260880,2015,0,0,1,1
260880,2016,2,0,0,2
260880,2017,1,0,1,2
260880,2018,1,1,0,2
260880,2019,1,0,1,2
260880,2020,1,0,0,1
260880,2021,2,0,0,2
260880,2022,2,0,0,2
260890,2015,1,0,0,1
260890,2016,2,0,1,3
260890,2017,1,0,1,2
260890,2019,2,1,0,3
260890,2021,1,0,1,2
260890,2022,1,0,0,1
260910,2021,1,0,0,1
260930,2018,1,0,0,1
260930,2019,2,0,0,2
260940,2016,0,1,0,1
260940,2017,1,0,1,2
260940,2018,2,0,1,3
260940,2021,1,1,1,3
260940,2022,1,1,0,2
260950,2015,1,0,0,1
260950,2017,1,0,0,1
260950,2018,1,0,1,2
260950,2021,1,0,0,1
260960,2015,4,0,4,8
260960,2016,17,2,10,29
260960,2017,24,3,8,35
260960,2018,23,4,4,31
260960,2019,23,2,10,35
260960,2020,12,3,12,27
260960,2021,22,6,11,39
260960,2022,17,7,10,34
260980,2017,1,0,0,1
260980,2021,0,0,1,1
260990,2015,0,1,0,1
260990,2016,1,0,0,1
260990,2018,0,1,0,1
260990,2019,1,1,0,2
260990,2020,1,0,0,1
260990,2022,0,0,1,1
261000,2016,0,0,1,1
261000,2017,1,0,0,1
261000,2021,1,0,0,1
261000,2022,1,0,0,1
261020,2019,1,1,0,2
261040,2015,2,0,0,2
261040,2016,0,1,0,1
261040,2018,0,1,1,2
261040,2021,0,1,0,1
261050,2022,0,0,1,1
261070,2015,7,1,8,16
261070,2016,9,4,6,19
261070,2017,18,4,4,26
261070,2018,8,1,2,11
261070,2019,17,6,3,26
261070,2020,4,0,4,8
261070,2021,12,3,4,19
261070,2022,19,5,9,33
261080,2018,1,0,0,1
261090,2015,1,0,2,3
261090,2017,2,0,0,2
261090,2018,2,1,1,4
261090,2019,2,0,0,2
261090,2020,2,0,0,2
261090,2022,0,0,2,2
261110,2015,26,5,14,45
261110,2016,26,8,23,57
261110,2017,47,6,39,92
261110,2018,37,5,32,74
261110,2019,33,4,29,66
261110,2020,25,12,12,49
261110,2021,23,7,11,41
261110,2022,22,6,15,43
261130,2017,1,0,0,1
261130,2019,1,0,0,1
261130,2021,0,0,1,1
261140,2016,0,0,1,1
261140,2019,0,0,1,1
261153,2021,1,0,0,1
261160,2015,72,16,25,113
261160,2016,72,23,28,123
261160,2017,172,29,67,268
261160,2018,135,30,33,198
261160,2019,111,32,38,181
261160,2020,75,17,32,124
261160,2021,81,28,47,156
261160,2022,112,20,38,170
261170,2015,1,0,2,3
261170,2016,0,1,1,2
261170,2019,1,0,0,1
261170,2020,1,0,0,1
261170,2022,0,1,0,1
261180,2015,0,0,1,1
261180,2019,1,0,0,1
261190,2020,1,0,0,1
261220,2016,3,0,1,4
261220,2018,4,0,2,6
261220,2019,6,0,0,6
261220,2021,2,0,1,3
261240,2018,0,0,1,1
261245,2015,0,1,0,1
261247,2021,1,0,0,1
261250,2015,9,1,6,16
261250,2016,1,0,6,7
261250,2017,7,0,2,9
261250,2018,7,2,3,12
261250,2019,3,1,0,4
261250,2020,2,1,3,6
261250,2021,1,2,0,3
261250,2022,3,0,0,3
261260,2015,1,0,0,1
261260,2017,0,1,0,1
261260,2020,1,1,2,4
261260,2021,0,1,0,1
261270,2018,0,0,1,1
261280,2022,1,0,0,1
261290,2020,1,0,0,1
261290,2022,1,0,0,1
261300,2015,2,0,2,4
261300,2016,1,0,0,1
261300,2017,1,0,2,3
261300,2019,1,0,0,1
261300,2020,1,0,0,1
261300,2021,1,0,0,1
261310,2015,1,0,2,3
261310,2016,0,1,1,2
261310,2017,0,0,3,3
261310,2020,1,0,0,1
261310,2022,1,0,0,1
261320,2021,0,0,1,1
261320,2022,0,0,1,1
261330,2021,1,0,0,1
261330,2022,1,0,1,2
261340,2017,0,1,0,1
261370,2015,1,0,1,2
261370,2016,0,0,1,1
261370,2017,1,0,1,2
261370,2019,0,1,0,1
261370,2020,0,1,1,2
261370,2021,2,0,0,2
261370,2022,1,0,1,2
261390,2015,1,0,2,3
261390,2016,2,1,1,4
261390,2017,3,4,0,7
261390,2018,1,0,1,2
261390,2019,3,0,0,3
261390,2020,1,1,0,2
261390,2021,3,1,0,4
261390,2022,1,0,3,4
261410,2018,0,0,1,1
261430,2020,1,0,0,1
261450,2015,1,0,0,1
261450,2016,2,0,1,3
261450,2017,1,1,0,2
261450,2018,4,0,1,5
261450,2019,1,0,0,1
261450,2020,1,0,0,1
261450,2021,1,0,0,1
261450,2022,1,0,0,1
261460,2018,1,0,0,1
261470,2017,0,1,0,1
261470,2019,1,0,1,2
261500,2017,0,0,1,1
261500,2018,0,0,2,2
261500,2021,0,1,0,1
261510,2017,1,0,0,1
261530,2015,0,0,1,1
261530,2017,1,0,0,1
261530,2018,0,0,1,1
261530,2019,0,0,1,1
261530,2022,1,0,0,1
261540,2015,1,0,3,4
261540,2016,1,0,3,4
261540,2017,1,0,3,4
261540,2018,0,0,5,5
261540,2019,0,0,1,1
261540,2020,2,0,2,4
261540,2021,2,0,1,3
261540,2022,1,0,1,2
261560,2018,1,0,0,1
261560,2021,0,0,1,1
261570,2018,1,0,0,1
261580,2017,1,0,0,1
261580,2019,1,0,0,1
261580,2022,1,0,0,1
261600,2022,1,0,0,1
261610,2020,0,0,1,1
261630,2016,1,1,0,2
261630,2017,0,0,1,1
261630,2018,1,0,0,1
261630,2019,0,0,1,1
261630,2020,1,0,0,1
261640,2015,1,1,4,6
261640,2016,2,0,3,5
261640,2017,2,1,1,4
261640,2018,4,0,2,6
261640,2019,2,1,0,3
261640,2020,2,0,2,4
261640,2021,2,1,1,4
261640,2022,3,1,3,7
270010,2015,1,0,0,1
270010,2020,1,0,0,1
270010,2022,0,0,1,1
270020,2016,0,1,0,1
270020,2018,1,0,1,2
270020,2019,0,0,1,1
270020,2021,1,0,0,1
270030,2015,7,1,9,17
270030,2016,12,1,2,15
270030,2017,15,4,13,32
270030,2018,15,0,9,24
270030,2019,10,0,5,15
270030,2020,10,0,7,17
270030,2021,11,4,13,28
270030,2022,8,3,6,17
270040,2015,1,0,1,2
270040,2016,1,0,1,2
270040,2017,4,0,1,5
270040,2018,2,1,4,7
270040,2019,4,1,0,5
270040,2020,1,2,0,3
270040,2021,1,0,0,1
270040,2022,1,0,0,1
270050,2016,0,1,0,1
270050,2018,1,0,0,1
270050,2020,0,1,1,2
270050,2022,1,0,0,1
270060,2020,0,0,1,1
270060,2022,1,1,2,4
270070,2017,2,0,0,2
270070,2020,1,0,0,1
270070,2022,0,0,2,2
270080,2017,0,0,2,2
270080,2019,1,0,0,1
270080,2021,0,0,1,1
270100,2016,2,0,0,2
270100,2017,0,1,2,3
270100,2019,2,1,0,3
270100,2020,1,0,0,1
270100,2021,1,0,0,1
270100,2022,0,1,3,4
270130,2019,0,0,1,1
270140,2016,0,1,0,1
270140,2018,1,0,0,1
270140,2020,0,0,1,1
270140,2022,0,0,1,1
270150,2015,0,0,1,1
270150,2016,3,0,1,4
270150,2017,2,2,2,6
270150,2018,1,0,2,3
270150,2019,2,1,1,4
270150,2020,17,7,8,32
270150,2021,25,9,12,46
270150,2022,19,6,4,29
270170,2017,0,1,3,4
270170,2018,0,0,1,1
270170,2020,1,0,0,1
270170,2022,0,1,1,2
270200,2017,1,0,0,1
270220,2017,0,0,1,1
270220,2018,1,0,1,2
270220,2019,0,1,0,1
270230,2015,0,0,1,1
270230,2016,1,0,0,1
270230,2018,1,1,1,3
270230,2019,1,0,3,4
270230,2020,0,0,2,2
270230,2021,2,1,0,3
270230,2022,1,0,2,3
270235,2016,1,0,1,2
270235,2017,0,0,1,1
270235,2021,0,1,0,1
270255,2016,1,0,0,1
270260,2015,1,0,1,2
270260,2017,1,0,0,1
270260,2018,2,0,0,2
270260,2021,2,0,0,2
270260,2022,1,0,0,1
270280,2019,0,0,1,1
270290,2016,2,0,1,3
270290,2017,1,0,0,1
270290,2020,1,0,0,1
270310,2017,1,0,0,1
270310,2019,1,0,0,1
270360,2019,1,1,0,2
270360,2021,1,0,0,1
270360,2022,1,0,0,1
270370,2015,1,0,0,1
270380,2020,1,0,0,1
270390,2021,0,0,1,1
270400,2017,1,0,0,1
270400,2020,0,1,0,1
270400,2021,0,0,1,1
270410,2015,1,0,0,1
270410,2022,1,0,0,1
270430,2015,57,12,39,108
270430,2016,64,16,47,127
270430,2017,149,30,91,270
270430,2018,140,33,69,242
270430,2019,123,31,63,217
270430,2020,111,34,62,207
270430,2021,102,26,57,185
270430,2022,127,28,64,219
270450,2018,2,0,0,2
270470,2016,1,0,1,2
270470,2017,1,1,2,4
270470,2018,0,1,1,2
270470,2019,4,0,1,5
270470,2020,4,1,0,5
270470,2021,2,2,0,4
270470,2022,2,1,1,4
270480,2017,1,0,0,1
270490,2020,1,0,0,1
270520,2021,1,0,1,2
270520,2022,1,0,0,1
270530,2019,0,0,1,1
270550,2017,0,0,1,1
270550,2018,2,0,2,4
270550,2019,1,0,0,1
270550,2021,1,0,0,1
270550,2022,2,0,0,2
270560,2020,1,0,0,1
270570,2021,0,0,1,1
270570,2022,1,0,0,1
270610,2020,0,0,1,1
270620,2021,0,0,1,1
270630,2015,3,0,1,4
270630,2016,4,0,0,4
270630,2017,4,0,3,7
270630,2018,5,3,1,9
270630,2019,2,1,1,4
270630,2020,5,0,1,6
270630,2021,1,0,1,2
270630,2022,1,0,0,1
270640,2015,1,0,0,1
270644,2016,0,0,1,1
270644,2019,2,0,1,3
270644,2020,0,0,1,1
270650,2017,1,0,0,1
270670,2015,0,0,1,1
270670,2017,2,0,0,2
270670,2018,1,1,1,3
270670,2019,1,1,1,3
270670,2020,0,0,1,1
270670,2021,1,0,2,3
270670,2022,0,1,0,1
270680,2021,1,0,0,1
270690,2016,2,0,2,4
270690,2017,0,0,1,1
270690,2021,1,0,1,2
270690,2022,1,1,1,3
270720,2019,1,0,0,1
270730,2017,1,0,2,3
270730,2018,0,0,1,1
270730,2020,1,0,0,1
270730,2022,0,0,1,1
270740,2019,1,0,0,1
270750,2017,0,0,1,1
270770,2015,3,0,0,3
270770,2016,0,0,1,1
270770,2017,2,0,0,2
270770,2018,1,2,1,4
270770,2019,3,0,4,7
270770,2020,2,0,1,3
270770,2021,1,0,1,2
270770,2022,1,0,2,3
270780,2015,0,0,1,1
270790,2021,0,1,0,1
270800,2015,1,0,2,3
270800,2016,3,0,0,3
270800,2017,2,1,1,4
270800,2018,1,0,0,1
270800,2020,1,1,0,2
270800,2022,1,0,0,1
270850,2021,0,1,0,1
270850,2022,1,0,0,1
270860,2015,1,0,0,1
270860,2016,0,0,1,1
270860,2017,1,0,0,1
270860,2018,1,0,0,1
270860,2019,2,0,1,3
270860,2020,1,0,0,1
270860,2021,2,0,0,2
270860,2022,0,1,2,3
270880,2015,0,0,1,1
270880,2017,1,0,0,1
270880,2022,1,0,0,1
270890,2015,1,0,0,1
270890,2017,1,0,0,1
270890,2022,1,0,0,1
270915,2019,0,1,0,1
270915,2022,2,0,0,2
270920,2018,1,0,0,1
270920,2019,0,1,0,1
270930,2016,1,0,0,1
270930,2017,1,0,2,3
270930,2018,1,0,2,3
270930,2020,1,0,0,1
270930,2021,2,0,1,3
270930,2022,1,0,0,1
270940,2016,1,0,0,1
270940,2017,1,0,0,1
270940,2021,1,0,0,1
280000,2015,0,0,1,1
280020,2017,1,0,1,2
280020,2019,0,0,1,1
280030,2015,54,8,23,85
280030,2016,44,4,16,64
280030,2017,120,32,47,199
280030,2018,66,13,20,99
280030,2019,72,16,35,123
280030,2020,76,21,40,137
280030,2021,104,25,39,168
280030,2022,83,26,32,141
280040,2021,0,0,1,1
280050,2016,0,0,1,1
280050,2022,0,1,0,1
280060,2015,0,0,1,1
280060,2016,0,0,1,1
280060,2017,0,1,1,2
280060,2018,1,0,0,1
280060,2019,1,0,0,1
280060,2021,1,1,3,5
280060,2022,2,1,0,3
280067,2017,1,0,0,1
280067,2019,1,0,0,1
280067,2020,1,0,0,1
280070,2016,1,0,0,1
280100,2017,1,0,2,3
280100,2020,0,0,1,1
280120,2015,1,0,2,3
280120,2016,1,0,0,1
280140,2016,0,0,1,1
280140,2018,0,1,0,1
280140,2021,0,0,1,1
280150,2015,0,1,0,1
280150,2017,0,0,2,2
280150,2018,2,0,0,2
280150,2019,0,0,2,2
280150,2020,2,0,0,2
280150,2021,2,0,0,2
280210,2015,1,0,1,2
280210,2016,2,0,0,2
280210,2017,3,1,1,5
280210,2019,1,0,1,2
280210,2021,1,1,3,5
280210,2022,2,0,0,2
280290,2016,1,1,1,3
280290,2017,4,1,1,6
280290,2018,1,0,1,2
280290,2019,0,1,0,1
280290,2020,3,0,0,3
280290,2021,3,0,0,3
280290,2022,2,0,3,5
280300,2018,1,0,0,1
280320,2021,0,1,0,1
280350,2015,1,0,0,1
280350,2017,1,1,0,2
280350,2018,0,1,0,1
280350,2019,1,1,0,2
280350,2021,3,1,0,4
280350,2022,2,0,1,3
280360,2015,1,0,1,2
280360,2016,0,0,1,1
280360,2017,1,0,2,3
280360,2018,2,0,1,3
280360,2020,1,0,0,1
280400,2015,0,0,1,1
280400,2018,0,0,1,1
280400,2019,0,0,1,1
280400,2020,1,0,0,1
280420,2020,1,0,0,1
280430,2018,1,0,0,1
280440,2017,0,0,1,1
280450,2018,0,1,0,1
280450,2021,0,0,1,1
280460,2015,0,0,1,1
280460,2017,1,0,0,1
280460,2018,0,1,1,2
280460,2019,1,0,0,1
280480,2015,2,1,1,4
280480,2016,4,0,1,5
280480,2017,8,1,9,18
280480,2018,6,1,6,13
280480,2019,6,1,8,15
280480,2020,5,2,12,19
280480,2021,7,0,2,9
280480,2022,2,3,0,5
280490,2020,0,0,1,1
280510,2022,1,0,0,1
280530,2021,1,0,0,1
280540,2022,1,0,0,1
280550,2021,1,0,0,1
280550,2022,1,0,0,1
280560,2017,2,0,0,2
280570,2015,0,0,1,1
280570,2017,1,0,0,1
280570,2019,0,0,1,1
280570,2021,1,1,0,2
280580,2022,0,0,1,1
280590,2019,0,0,1,1
280590,2021,0,1,0,1
280600,2020,0,0,1,1
280610,2016,0,1,0,1
280610,2021,1,0,0,1
280610,2022,0,0,1,1
280620,2018,0,1,0,1
280650,2021,0,0,1,1
280660,2020,1,0,0,1
280670,2015,3,0,0,3
280670,2016,2,0,0,2
280670,2017,5,0,3,8
280670,2018,1,0,2,3
280670,2019,0,1,1,2
280670,2020,2,0,1,3
280670,2021,1,1,1,3
280670,2022,2,1,0,3
280710,2017,1,0,0,1
280710,2018,1,0,0,1
280710,2021,2,0,0,2
280720,2018,0,0,1,1
280740,2015,1,0,0,1
280740,2017,0,0,1,1
280740,2018,1,0,0,1
280740,2020,1,0,0,1
280740,2021,1,0,0,1
280740,2022,2,0,0,2
280760,2015,1,0,0,1
280760,2018,2,0,0,2
290000,2015,2,0,1,3
290000,2016,2,2,1,5
290000,2017,1,1,0,2
290000,2018,2,0,0,2
290000,2020,3,0,1,4
290000,2022,2,1,0,3
290020,2022,0,0,1,1
290030,2017,0,0,1,1
290030,2022,0,0,1,1
290040,2016,2,0,0,2
290040,2019,2,1,0,3
290060,2018,0,0,1,1
290070,2015,8,6,8,22
290070,2016,19,2,10,31
290070,2017,23,3,18,44
290070,2018,18,4,13,35
290070,2019,25,3,11,39
290070,2020,11,7,5,23
290070,2021,14,1,6,21
290070,2022,18,3,5,26
290080,2015,0,1,0,1
290080,2017,1,0,0,1
290080,2018,1,0,0,1
290080,2019,0,0,1,1
290080,2021,1,0,1,2
290100,2018,1,0,0,1
290100,2021,1,0,0,1
290100,2022,1,0,0,1
290110,2015,0,0,2,2
290110,2016,1,0,0,1
290110,2017,8,0,1,9
290110,2018,2,0,2,4
290110,2019,1,0,2,3
290110,2020,1,0,1,2
290110,2021,0,0,1,1
290110,2022,1,1,0,2
290120,2022,0,0,1,1
290130,2021,0,1,0,1
290135,2015,0,0,3,3
290135,2016,1,0,2,3
290135,2017,2,2,1,5
290135,2019,3,0,2,5
290135,2020,1,0,2,3
290135,2021,2,1,1,4
290140,2017,1,0,0,1
290150,2016,1,0,0,1
290170,2016,0,0,1,1
290170,2017,1,0,0,1
290170,2020,0,0,1,1
290170,2021,0,1,0,1
290180,2016,0,0,1,1
290195,2015,0,0,1,1
290195,2021,0,1,0,1
290205,2015,0,1,5,6
290205,2016,0,0,1,1
290210,2015,0,0,1,1
290210,2018,1,0,1,2
290210,2019,0,0,2,2
290210,2020,1,0,0,1
290210,2022,2,0,0,2
290220,2019,2,0,0,2
290220,2020,2,0,0,2
290230,2017,1,0,0,1
290240,2016,0,0,1,1
290240,2020,0,1,0,1
290240,2021,0,1,0,1
290240,2022,1,0,0,1
290260,2017,1,0,0,1
290265,2021,1,0,0,1
290270,2022,0,1,0,1
290280,2017,2,0,0,2
290280,2022,1,1,0,2
290290,2016,1,0,0,1
290290,2020,2,0,0,2
290290,2022,2,0,0,2
290300,2015,0,0,1,1
290300,2017,1,0,0,1
290310,2019,1,0,0,1
290320,2015,0,0,2,2
290320,2016,4,1,0,5
290320,2017,6,3,3,12
290320,2018,3,0,0,3
290320,2019,1,0,5,6
290320,2020,4,2,0,6
290320,2021,7,3,2,12
290320,2022,9,0,1,10
290323,2015,0,0,1,1
290327,2019,1,0,0,1
290327,2021,1,1,1,3
290330,2017,0,0,1,1
290330,2021,2,0,0,2
290340,2016,1,0,0,1
290340,2018,0,0,1,1
290340,2022,1,1,1,3
290360,2018,1,0,0,1
290360,2020,0,1,0,1
290360,2021,1,1,0,2
290370,2021,0,1,0,1
290390,2016,2,0,0,2
290390,2017,1,0,0,1
290390,2018,1,0,0,1
290390,2019,0,1,0,1
290390,2021,2,0,0,2
290390,2022,2,1,0,3
290405,2021,0,1,0,1
290460,2015,1,0,1,2
290460,2016,1,0,3,4
290460,2017,3,1,1,5
290460,2018,6,0,1,7
290460,2019,4,2,0,6
290460,2020,4,0,0,4
290460,2021,0,1,0,1
290470,2016,0,0,2,2
290470,2017,1,0,0,1
290470,2018,0,0,2,2
290470,2019,2,0,0,2
290470,2020,0,1,0,1
290485,2021,1,0,0,1
290490,2016,0,0,1,1
290490,2018,2,0,0,2
290490,2020,1,0,0,1
290500,2016,1,0,0,1
290515,2017,0,0,1,1
290520,2015,0,1,0,1
290520,2016,3,1,0,4
290520,2017,7,3,6,16
290520,2018,0,0,1,1
290520,2019,3,0,0,3
290520,2020,2,1,3,6
290520,2021,0,1,0,1
290520,2022,3,0,2,5
290530,2021,0,0,1,1
290530,2022,2,0,0,2
290560,2016,1,1,0,2
290560,2017,0,0,1,1
290560,2018,1,1,0,2
290560,2019,0,0,1,1
290560,2021,2,1,0,3
290560,2022,0,1,0,1
290570,2015,30,4,15,49
290570,2016,29,4,23,56
290570,2017,33,6,22,61
290570,2018,26,5,19,50
290570,2019,43,9,23,75
290570,2020,27,8,19,54
290570,2021,41,6,17,64
290570,2022,28,6,20,54
290580,2016,1,0,0,1
290580,2021,1,0,0,1
290600,2015,1,1,0,2
290600,2016,1,0,0,1
290600,2017,2,0,0,2
290600,2018,2,1,0,3
290600,2019,3,1,2,6
290600,2020,3,1,0,4
290600,2021,2,0,1,3
290600,2022,1,0,1,2
290610,2022,1,0,0,1
290620,2018,1,0,0,1
290620,2020,1,0,0,1
290620,2021,0,0,1,1
290630,2017,1,0,1,2
290630,2020,0,0,1,1
290630,2021,1,0,0,1
290640,2016,0,0,2,2
290640,2017,1,0,0,1
290640,2018,1,0,0,1
290640,2022,1,0,0,1
290650,2015,5,0,3,8
290650,2016,3,3,1,7
290650,2017,0,2,2,4
290650,2018,0,1,1,2
290650,2019,2,1,2,5
290650,2020,4,2,2,8
290650,2021,2,0,0,2
290650,2022,0,1,2,3
290660,2021,1,0,0,1
290670,2015,0,0,1,1
290670,2016,1,0,0,1
290670,2019,1,0,0,1
290670,2020,0,1,0,1
290670,2021,1,0,0,1
290670,2022,1,0,1,2
290680,2015,1,0,0,1
290680,2020,0,0,1,1
290687,2016,0,0,1,1
290687,2017,0,0,2,2
290687,2018,1,0,0,1
290687,2019,1,1,0,2
290687,2020,1,0,0,1
290687,2022,0,0,1,1
290690,2016,0,1,1,2
290690,2019,1,0,0,1
290690,2020,1,0,0,1
290690,2021,0,0,1,1
290700,2019,3,0,0,3
290720,2015,1,0,0,1
290720,2017,0,0,1,1
290720,2018,3,0,0,3
290720,2019,1,2,0,3
290720,2021,1,1,2,4
290720,2022,1,0,0,1
290730,2015,1,0,0,1
290730,2016,1,0,0,1
290730,2017,0,1,0,1
290730,2020,0,0,1,1
290730,2022,1,0,0,1
290740,2018,0,0,1,1
290750,2015,11,0,10,21
290750,2016,5,1,6,12
290750,2017,3,0,3,6
290750,2018,4,2,3,9
290750,2019,4,1,1,6
290750,2020,4,0,3,7
290750,2021,5,0,2,7
290750,2022,6,0,6,12
290760,2016,0,0,1,1
290760,2019,0,2,0,2
290770,2019,1,0,0,1
290800,2015,1,1,0,2
290800,2016,1,0,0,1
290800,2017,1,0,0,1
290800,2018,0,1,0,1
290800,2019,0,1,0,1
290800,2022,1,0,1,2
290810,2015,1,0,0,1
290820,2015,1,0,0,1
290820,2017,2,0,0,2
290820,2018,2,0,0,2
290820,2020,0,0,1,1
290820,2021,2,0,0,2
290830,2018,0,0,1,1
290830,2022,0,0,2,2
290840,2016,1,1,0,2
290840,2019,0,0,1,1
290840,2020,1,0,0,1
290850,2015,3,0,0,3
290850,2016,2,0,1,3
290850,2017,1,0,1,2
290850,2018,1,0,0,1
290850,2019,1,0,0,1
290850,2020,1,0,1,2
290850,2021,2,1,0,3
290850,2022,1,2,1,4
290860,2016,0,0,1,1
290870,2015,1,0,0,1
290870,2017,0,0,1,1
290870,2019,0,2,0,2
290890,2018,1,0,2,3
290890,2020,1,0,0,1
290890,2021,1,1,0,2
290890,2022,1,0,1,2
290920,2022,1,0,0,1
290930,2021,1,0,0,1
290940,2018,2,0,0,2
290960,2017,1,0,0,1
290980,2015,2,0,0,2
290980,2016,0,2,1,3
290980,2017,5,2,2,9
290980,2018,6,2,0,8
290980,2019,4,2,0,6
290980,2021,3,0,2,5
290980,2022,2,4,0,6
290990,2016,0,0,1,1
290990,2017,1,0,1,2
290990,2018,3,0,0,3
290990,2021,0,0,1,1
290990,2022,1,0,0,1
291005,2015,1,0,6,7
291005,2016,4,0,2,6
291005,2017,3,1,7,11
291005,2018,3,1,1,5
291005,2019,5,4,3,12
291005,2020,3,0,2,5
291005,2021,3,0,2,5
291005,2022,4,0,0,4
291010,2022,0,0,1,1
291030,2015,1,0,0,1
291030,2017,1,0,0,1
291030,2019,0,1,0,1
291030,2020,1,1,0,2
291030,2022,1,0,0,1
291050,2015,1,0,1,2
291050,2016,1,0,1,2
291050,2018,1,1,2,4
291050,2019,1,0,2,3
291050,2020,1,0,0,1
291050,2021,0,1,0,1
291050,2022,0,1,0,1
291060,2015,1,0,0,1
291060,2022,0,1,0,1
291070,2016,1,0,0,1
291070,2017,1,0,0,1
291070,2018,1,0,2,3
291070,2019,1,0,0,1
291072,2015,1,1,8,10
291072,2016,11,1,10,22
291072,2017,20,0,8,28
291072,2018,16,2,12,30
291072,2019,19,8,13,40
291072,2020,21,1,4,26
291072,2021,8,4,4,16
291072,2022,17,1,16,34
291080,2015,49,12,43,104
291080,2016,61,16,45,122
291080,2017,97,25,55,177
291080,2018,73,17,39,129
291080,2019,54,16,33,103
291080,2020,68,21,30,119
291080,2021,72,20,38,130
291080,2022,62,28,40,130
291100,2021,0,0,1,1
291120,2016,1,0,0,1
291120,2018,1,0,2,3
291120,2019,1,0,0,1
291120,2021,1,1,0,2
291120,2022,1,1,0,2
291170,2015,2,0,0,2
291170,2016,0,1,0,1
291170,2017,0,0,1,1
291170,2018,3,0,2,5
291170,2019,3,0,1,4
291170,2021,0,1,0,1
291170,2022,2,0,0,2
291180,2015,1,0,0,1
291180,2017,1,0,0,1
291180,2020,1,0,0,1
291190,2017,1,0,0,1
291190,2019,0,0,1,1
291190,2020,1,0,0,1
291200,2020,1,0,0,1
291210,2015,1,0,0,1
291210,2016,1,0,1,2
291210,2018,0,0,1,1
291210,2019,2,0,0,2
291210,2021,0,0,1,1
291210,2022,1,0,0,1
291220,2020,1,0,0,1
291230,2021,0,0,1,1
291230,2022,1,0,0,1
291240,2017,1,0,0,1
291280,2015,1,0,0,1
291280,2016,2,0,0,2
291280,2018,2,0,0,2
291280,2019,0,0,1,1
291280,2020,1,0,1,2
291280,2022,2,0,0,2
291290,2015,0,0,1,1
291310,2020,0,1,0,1
291320,2019,0,0,1,1
291350,2017,0,0,1,1
291360,2015,8,2,3,13
291360,2016,9,1,6,16
291360,2017,15,1,6,22
291360,2018,8,1,8,17
291360,2019,17,1,7,25
291360,2020,14,1,7,22
291360,2021,13,4,5,22
291360,2022,8,2,6,16
291370,2016,0,0,1,1
291370,2017,1,0,0,1
291370,2019,2,0,1,3
291370,2020,0,0,1,1
291380,2018,1,0,0,1
291390,2015,2,0,1,3
291390,2016,2,2,2,6
291390,2018,2,1,0,3
291390,2019,1,0,0,1
291390,2020,0,1,2,3
291390,2021,1,0,1,2
291400,2015,1,1,1,3
291400,2016,0,2,1,3
291450,2015,0,1,0,1
291450,2017,0,0,1,1
291450,2019,0,0,1,1
291450,2020,0,1,0,1
291450,2021,1,0,1,2
291450,2022,0,1,0,1
291460,2015,3,2,4,9
291460,2016,3,3,2,8
291460,2017,2,0,1,3
291460,2018,5,0,1,6
291460,2019,6,3,0,9
291460,2020,1,1,0,2
291460,2021,3,1,0,4
291460,2022,3,0,0,3
291465,2017,0,0,1,1
291465,2018,0,0,1,1
291465,2019,1,0,1,2
291465,2020,2,0,0,2
291465,2022,1,0,1,2
291470,2015,2,0,1,3
291470,2017,1,0,0,1
291470,2018,1,0,2,3
291470,2019,1,0,0,1
291470,2020,1,0,1,2
291470,2022,4,0,0,4
291480,2015,10,2,5,17
291480,2016,10,5,8,23
291480,2017,25,4,13,42
291480,2018,17,3,13,33
291480,2019,14,6,11,31
291480,2020,24,5,11,40
291480,2021,16,8,6,30
291480,2022,12,6,6,24
291490,2015,0,0,1,1
291490,2018,1,0,0,1
291490,2022,0,0,1,1
291500,2017,0,1,0,1
291520,2016,1,0,1,2
291520,2018,1,1,0,2
291520,2019,1,0,0,1
291520,2020,0,1,0,1
291530,2018,1,0,0,1
291530,2019,2,0,0,2
291530,2020,0,0,2,2
291550,2015,0,1,0,1
291550,2017,0,0,1,1
291550,2018,2,0,0,2
291550,2019,0,1,1,2
291550,2020,1,0,0,1
291550,2022,1,0,0,1
291560,2015,3,0,0,3
291560,2016,2,2,0,4
291560,2017,1,0,1,2
291560,2018,2,1,1,4
291560,2019,2,1,0,3
291560,2020,1,1,0,2
291560,2021,1,0,1,2
291560,2022,3,2,0,5
291580,2017,0,0,1,1
291590,2021,0,0,1,1
291600,2018,2,0,0,2
291600,2019,1,0,0,1
291600,2021,1,0,0,1
291610,2016,1,0,0,1
291610,2018,1,1,0,2
291610,2020,0,1,0,1
291610,2021,2,0,0,2
291620,2016,0,1,0,1
291620,2019,0,1,0,1
291630,2016,1,0,0,1
291630,2020,0,0,1,1
291640,2015,4,0,1,5
291640,2016,2,1,1,4
291640,2017,0,2,1,3
291640,2018,3,1,0,4
291640,2019,1,2,0,3
291640,2020,0,1,0,1
291640,2021,4,1,1,6
291640,2022,1,1,1,3
291660,2017,1,0,1,2
291680,2019,1,0,1,2
291685,2022,1,0,0,1
291700,2017,0,0,2,2
291700,2019,2,0,0,2
291710,2015,1,0,0,1
291710,2017,1,0,0,1
291710,2021,1,1,0,2
291710,2022,1,0,0,1
291730,2018,0,1,0,1
291730,2021,1,0,0,1
291735,2019,1,0,0,1
291740,2022,1,0,0,1
291750,2015,7,0,3,10
291750,2016,6,0,2,8
291750,2017,3,0,2,5
291750,2018,3,1,2,6
291750,2019,8,0,2,10
291750,2020,1,0,3,4
291750,2021,7,2,6,15
291750,2022,5,2,5,12
291760,2016,0,0,1,1
291770,2016,1,0,0,1
291770,2018,1,0,0,1
291770,2019,1,0,1,2
291770,2020,1,1,0,2
291770,2021,1,0,1,2
291770,2022,1,0,1,2
291780,2017,1,0,0,1
291800,2015,5,2,2,9
291800,2016,6,1,1,8
291800,2017,2,0,1,3
291800,2018,3,4,5,12
291800,2019,1,0,2,3
291800,2020,1,0,0,1
291800,2021,1,0,2,3
291800,2022,1,0,0,1
291820,2019,0,1,0,1
291820,2022,1,0,0,1
291830,2018,0,0,1,1
291835,2015,0,1,0,1
291835,2016,1,0,0,1
291835,2022,1,0,0,1
291840,2015,9,2,5,16
291840,2016,5,3,5,13
291840,2017,20,9,15,44
291840,2018,21,1,11,33
291840,2019,14,7,14,35
291840,2020,7,1,7,15
291840,2021,15,4,5,24
291840,2022,4,2,10,16
291880,2015,1,0,0,1
291880,2016,1,0,0,1
291880,2022,1,0,0,1
291890,2022,0,1,0,1
291920,2015,30,5,21,56
291920,2016,26,5,17,48
291920,2017,51,9,25,85
291920,2018,30,8,10,48
291920,2019,33,9,15,57
291920,2020,37,8,11,56
291920,2021,27,12,6,45
291920,2022,28,7,16,51
291940,2022,2,0,0,2
291950,2015,0,0,1,1
291950,2018,0,1,0,1
291955,2015,1,0,3,4
291955,2016,4,0,3,7
291955,2017,5,0,5,10
291955,2018,3,0,2,5
291955,2019,5,0,0,5
291955,2020,2,0,3,5
291955,2021,3,0,1,4
291955,2022,2,1,0,3
291960,2016,1,0,0,1
291980,2015,0,0,1,1
291992,2015,1,0,1,2
291992,2016,1,0,0,1
291992,2017,2,0,1,3
291992,2019,2,0,0,2
291992,2020,2,0,1,3
291992,2022,0,1,0,1
291995,2022,0,0,1,1
292050,2015,0,1,0,1
292050,2017,1,0,0,1
292050,2021,0,0,1,1
292050,2022,1,0,0,1
292060,2016,0,0,1,1
292060,2021,1,0,0,1
292070,2017,0,0,1,1
292070,2018,0,0,1,1
292070,2022,1,0,0,1
292100,2015,1,0,2,3
292100,2016,2,0,0,2
292100,2017,2,0,0,2
292100,2018,0,0,1,1
292100,2019,1,2,0,3
292100,2020,3,0,4,7
292100,2021,5,0,1,6
292100,2022,3,1,1,5
292105,2022,0,1,0,1
292110,2015,0,0,1,1
292110,2017,0,0,1,1
292110,2019,2,0,0,2
292110,2021,0,0,2,2
292120,2015,0,1,0,1
292120,2017,0,0,1,1
292120,2022,1,0,0,1
292130,2016,0,0,1,1
292150,2015,2,0,0,2
292150,2016,1,1,0,2
292170,2018,1,0,0,1
292170,2019,1,0,0,1
292190,2015,1,0,0,1
292190,2022,0,2,0,2
292200,2015,1,0,3,4
292200,2016,3,0,1,4
292200,2017,1,0,7,8
292200,2018,11,1,7,19
292200,2019,3,0,4,7
292200,2020,4,1,1,6
292200,2021,3,1,6,10
292200,2022,8,1,6,15
292205,2022,0,0,1,1
292210,2017,1,0,0,1
292220,2017,1,0,1,2
292220,2021,1,0,0,1
292230,2018,1,1,0,2
292230,2019,1,0,0,1
292240,2015,0,0,1,1
292240,2017,0,1,0,1
292240,2021,1,0,0,1
292240,2022,1,1,0,2
292250,2016,1,0,0,1
292250,2017,1,0,0,1
292250,2020,1,0,0,1
292250,2021,1,0,0,1
292250,2022,1,0,0,1
292265,2019,1,0,0,1
292300,2015,1,0,1,2
292300,2016,2,0,1,3
292300,2017,1,0,1,2
292300,2018,4,0,2,6
292300,2019,2,0,1,3
292300,2020,2,0,2,4
292300,2021,2,0,2,4
292300,2022,2,0,0,2
292330,2018,1,0,0,1
292350,2015,1,0,0,1
292350,2016,0,0,1,1
292380,2018,0,0,1,1
292380,2020,1,0,0,1
292400,2015,1,1,0,2
292400,2016,1,1,0,2
292400,2017,1,0,3,4
292400,2018,0,0,2,2
292400,2019,0,4,1,5
292400,2020,4,0,0,4
292400,2021,2,1,2,5
292400,2022,2,0,0,2
292405,2015,1,0,0,1
292405,2016,1,0,0,1
292405,2018,1,0,0,1
292430,2019,0,0,1,1
292460,2019,0,0,1,1
292470,2020,0,1,0,1
292470,2021,1,0,0,1
292480,2019,1,0,0,1
292500,2017,1,0,0,1
292510,2015,1,0,0,1
292510,2016,1,1,0,2
292510,2022,1,0,0,1
292520,2015,0,1,3,4
292520,2016,1,2,8,11
292520,2017,3,1,2,6
292520,2018,2,1,1,4
292520,2019,0,1,3,4
292520,2020,3,2,2,7
292520,2021,1,1,0,2
292520,2022,2,0,1,3
292525,2018,1,0,0,1
292530,2015,5,1,2,8
292530,2016,6,3,4,13
292530,2017,4,1,1,6
292530,2018,1,1,5,7
292530,2019,5,1,2,8
292530,2020,8,3,0,11
292530,2021,6,0,1,7
292530,2022,3,1,3,7
292540,2015,1,0,0,1
292550,2015,1,0,1,2
292550,2016,1,0,0,1
292550,2019,0,1,0,1
292550,2021,0,1,0,1
292550,2022,1,0,0,1
292560,2021,0,0,1,1
292580,2015,1,0,0,1
292595,2018,1,0,0,1
292595,2019,1,1,0,2
292595,2021,1,0,0,1
292600,2015,2,0,0,2
292600,2016,2,0,0,2
292600,2017,3,0,1,4
292600,2019,0,0,1,1
292600,2020,2,0,0,2
292600,2021,1,0,0,1
292620,2019,1,1,0,2
292630,2016,0,0,1,1
292630,2017,2,0,0,2
292640,2022,1,0,0,1
292660,2015,0,0,1,1
292660,2016,0,0,1,1
292660,2019,3,0,1,4
292660,2020,3,0,0,3
292660,2021,6,0,0,6
292660,2022,1,0,0,1
292665,2021,0,0,1,1
292670,2015,1,0,0,1
292690,2017,1,0,0,1
292700,2015,1,0,1,2
292720,2016,1,0,1,2
292720,2022,1,0,0,1
292740,2015,274,69,177,520
292740,2016,277,58,132,467
292740,2017,418,103,238,759
292740,2018,254,56,117,427
292740,2019,254,63,137,454
292740,2020,229,71,102,402
292740,2021,211,75,115,401
292740,2022,212,71,108,391
292750,2016,1,0,0,1
292750,2018,0,0,1,1
292750,2020,0,1,0,1
292750,2021,3,0,0,3
292770,2015,2,0,1,3
292770,2019,2,0,0,2
292770,2020,1,0,0,1
292780,2019,1,0,0,1
292790,2018,0,1,0,1
292790,2020,0,1,0,1
292790,2021,1,0,0,1
292800,2017,1,0,0,1
292805,2015,1,0,0,1
292805,2020,0,0,1,1
292805,2022,0,0,1,1
292810,2016,0,0,2,2
292810,2022,1,0,0,1
292820,2018,1,0,0,1
292820,2019,0,0,1,1
292820,2020,1,0,0,1
292820,2022,1,0,0,1
292830,2016,1,0,0,1
292860,2017,0,1,0,1
292860,2018,1,0,0,1
292860,2022,1,0,0,1
292870,2015,4,0,1,5
292870,2016,6,2,4,12
292870,2017,7,0,3,10
292870,2018,3,0,0,3
292870,2019,5,1,0,6
292870,2020,5,0,0,5
292870,2021,6,1,1,8
292870,2022,4,2,0,6
292880,2015,1,0,0,1
292880,2016,0,1,0,1
292880,2017,2,1,0,3
292880,2018,1,0,0,1
292880,2019,1,0,1,2
292880,2020,2,1,0,3
292880,2022,0,0,1,1
292890,2019,0,0,1,1
292910,2015,0,0,1,1
292910,2018,0,1,0,1
292925,2015,1,0,0,1
292930,2016,0,0,2,2
292930,2017,3,0,0,3
292930,2021,2,2,0,4
292930,2022,1,0,1,2
292935,2016,0,1,0,1
292935,2018,0,1,0,1
292937,2018,0,0,1,1
292940,2021,0,1,0,1
292950,2017,2,1,0,3
292950,2018,2,0,0,2
292950,2019,2,0,0,2
292950,2020,0,0,2,2
292950,2021,1,0,0,1
292960,2022,0,1,0,1
292990,2015,1,0,0,1
292990,2017,0,0,1,1
292990,2019,1,0,0,1
293010,2015,3,0,0,3
293010,2017,0,1,3,4
293010,2018,2,0,0,2
293010,2019,0,0,1,1
293010,2020,0,1,2,3
293010,2021,1,0,2,3
293010,2022,0,1,1,2
293020,2015,0,1,0,1
293020,2016,1,0,0,1
293020,2017,1,0,0,1
293020,2018,1,0,0,1
293020,2019,0,0,1,1
293020,2020,2,0,0,2
293020,2022,1,1,0,2
293050,2015,1,0,2,3
293050,2017,4,0,2,6
293050,2018,1,0,0,1
293050,2019,0,0,1,1
293050,2020,4,0,1,5
293050,2021,2,0,0,2
293050,2022,1,2,1,4
293060,2018,0,0,1,1
293060,2021,2,0,0,2
293070,2015,4,1,8,13
293070,2016,4,1,3,8
293070,2017,8,2,5,15
293070,2018,3,0,2,5
293070,2019,5,0,0,5
293070,2020,6,1,0,7
293070,2021,1,1,0,2
293070,2022,4,0,3,7
293076,2021,0,0,1,1
293077,2015,1,0,0,1
293077,2017,3,1,0,4
293077,2018,3,1,0,4
293077,2019,1,0,1,2
293077,2020,0,1,0,1
293077,2021,0,0,2,2
293110,2017,0,0,1,1
293135,2015,4,1,7,12
293135,2016,8,1,8,17
293135,2017,13,1,4,18
293135,2018,9,1,8,18
293135,2019,4,3,5,12
293135,2020,7,0,5,12
293135,2021,4,0,3,7
293135,2022,8,2,1,11
293140,2022,0,1,0,1
293150,2015,0,1,0,1
293150,2016,0,1,0,1
293150,2017,3,0,0,3
293150,2019,1,0,1,2
293150,2022,0,0,1,1
293190,2020,0,0,1,1
293200,2017,2,0,0,2
293200,2018,2,0,0,2
293200,2021,1,0,0,1
293220,2017,1,0,0,1
293220,2018,0,0,1,1
293230,2018,1,0,0,1
293230,2020,1,0,0,1
293245,2022,0,0,1,1
293250,2015,0,0,1,1
293250,2016,1,0,0,1
293250,2019,0,0,4,4
293250,2022,0,1,0,1
293270,2015,1,0,0,1
293270,2017,0,0,1,1
293290,2015,0,0,3,3
293290,2016,1,1,0,2
293290,2017,0,0,1,1
293290,2018,2,1,2,5
293290,2019,1,0,0,1
293290,2022,2,0,0,2
293320,2015,0,0,1,1
293320,2016,1,0,0,1
293320,2017,1,0,1,2
293325,2021,0,1,0,1
293330,2015,22,3,10,35
293330,2016,14,4,10,28
293330,2017,22,9,17,48
293330,2018,18,1,9,28
293330,2019,9,6,11,26
293330,2020,4,2,2,8
293330,2021,12,4,4,20
293330,2022,16,5,14,35
293360,2015,3,0,0,3
293360,2016,1,0,0,1
293360,2019,1,0,0,1
293360,2021,1,0,0,1
310000,2015,2,0,0,2
310000,2016,3,1,1,5
310000,2017,6,3,1,10
310000,2018,1,1,0,2
310000,2019,3,3,0,6
310000,2020,5,0,0,5
310000,2021,3,1,0,4
310000,2022,2,3,0,5
310010,2016,0,0,1,1
310010,2017,0,0,1,1
310010,2020,0,0,2,2
310010,2021,0,0,2,2
310010,2022,3,0,0,3
310020,2015,1,0,0,1
310020,2016,1,0,0,1
310020,2017,2,1,3,6
310020,2018,4,2,0,6
310020,2019,0,1,0,1
310020,2020,2,0,1,3
310020,2021,2,1,0,3
310020,2022,3,0,1,4
310030,2016,2,0,0,2
310030,2017,1,0,0,1
310030,2018,2,0,1,3
310030,2019,1,0,3,4
310030,2021,2,0,0,2
310030,2022,1,0,0,1
310050,2016,1,0,0,1
310050,2018,1,0,3,4
310050,2022,1,0,0,1
310060,2021,1,0,1,2
310070,2016,1,0,0,1
310070,2017,0,0,1,1
310070,2022,1,0,0,1
310080,2020,0,1,0,1
310090,2018,1,0,1,2
310090,2019,1,0,0,1
310090,2021,0,0,1,1
310110,2015,1,0,0,1
310110,2016,1,0,0,1
310110,2018,1,0,0,1
310110,2019,1,0,0,1
310110,2020,0,1,0,1
310110,2022,0,2,0,2
310120,2022,1,0,0,1
310130,2017,1,0,0,1
310130,2021,1,0,0,1
310140,2016,1,0,1,2
310150,2017,0,0,3,3
310150,2018,1,0,0,1
310150,2019,1,1,1,3
310150,2020,1,0,0,1
310150,2021,2,0,1,3
310150,2022,1,0,0,1
310160,2015,6,0,4,10
310160,2016,6,2,2,10
310160,2017,11,2,7,20
310160,2018,9,0,2,11
310160,2019,7,3,4,14
310160,2020,16,1,4,21
310160,2021,8,3,2,13
310160,2022,7,1,5,13
310163,2017,1,0,0,1
310163,2018,1,0,0,1
310170,2016,1,0,2,3
310170,2017,1,1,3,5
310170,2018,0,0,1,1
310170,2019,1,1,1,3
310170,2020,2,1,0,3
310170,2021,3,0,2,5
310170,2022,2,1,1,4
310180,2019,2,0,0,2
310190,2015,0,0,2,2
310190,2017,1,1,3,5
310190,2018,1,1,1,3
310190,2021,1,0,1,2
310190,2022,1,0,0,1
310200,2016,1,0,0,1
310200,2018,1,0,0,1
310200,2021,1,1,0,2
310205,2019,0,0,1,1
310205,2020,1,0,0,1
310205,2022,1,0,0,1
310210,2016,1,0,0,1
310210,2020,0,0,1,1
310210,2021,1,0,0,1
310230,2015,1,0,1,2
310230,2016,1,0,0,1
310230,2017,2,0,0,2
310230,2018,0,0,2,2
310230,2019,1,0,0,1
310230,2022,1,0,1,2
310240,2019,0,0,1,1
310250,2017,0,0,1,1
310250,2020,1,0,0,1
310250,2021,0,0,2,2
310260,2015,2,0,2,4
310260,2016,4,0,0,4
310260,2017,5,1,2,8
310260,2018,5,0,3,8
310260,2019,3,0,1,4
310260,2020,2,0,1,3
310260,2021,2,0,1,3
310260,2022,1,1,2,4
310280,2017,0,0,1,1
310280,2019,0,1,0,1
310280,2021,0,1,0,1
310290,2017,2,0,0,2
310290,2019,2,1,0,3
310290,2022,0,0,1,1
310300,2015,0,0,1,1
310300,2016,1,1,0,2
310300,2017,0,0,2,2
310300,2018,1,0,0,1
310320,2015,1,0,0,1
310340,2015,1,0,1,2
310340,2016,1,0,1,2
310340,2017,2,0,1,3
310340,2018,1,0,0,1
310340,2019,1,1,0,2
310340,2020,1,2,0,3
310340,2022,1,0,0,1
310350,2015,3,0,10,13
310350,2016,15,3,5,23
310350,2017,6,0,9,15
310350,2018,13,0,3,16
310350,2019,10,3,6,19
310350,2020,10,5,3,18
310350,2021,6,0,6,12
310350,2022,6,3,1,10
310360,2021,1,0,0,1
310375,2016,1,0,0,1
310375,2017,1,0,1,2
310375,2018,1,0,1,2
310375,2019,1,0,0,1
310375,2021,1,0,0,1
310375,2022,1,0,0,1
310380,2019,0,0,1,1
310380,2020,1,0,1,2
310380,2022,0,0,2,2
310390,2015,3,0,0,3
310390,2016,1,0,1,2
310390,2017,7,0,4,11
310390,2018,2,0,3,5
310390,2019,6,1,6,13
310390,2020,3,1,1,5
310390,2021,4,1,1,6
310390,2022,10,0,0,10
310400,2015,5,0,5,10
310400,2016,6,1,1,8
310400,2017,9,2,7,18
310400,2018,13,2,5,20
310400,2019,9,0,11,20
310400,2020,9,6,6,21
310400,2021,6,2,2,10
310400,2022,15,1,6,22
310410,2015,1,0,1,2
310410,2018,0,0,1,1
310410,2019,0,0,2,2
310410,2022,0,2,1,3
310420,2015,5,0,3,8
310420,2016,10,3,5,18
310420,2017,10,0,4,14
310420,2018,5,4,2,11
310420,2019,6,2,4,12
310420,2020,7,1,6,14
310420,2021,2,0,3,5
310420,2022,4,1,1,6
310430,2015,3,0,0,3
310430,2016,0,0,1,1
310430,2018,1,1,0,2
310430,2019,2,0,0,2
310430,2020,0,0,1,1
310430,2022,3,0,1,4
310450,2017,0,0,1,1
310450,2018,1,0,0,1
310450,2019,3,0,0,3
310450,2021,0,1,1,2
310450,2022,1,0,1,2
310460,2015,0,0,1,1
310460,2016,1,0,0,1
310460,2017,1,0,0,1
310460,2018,1,0,0,1
310460,2021,1,0,0,1
310460,2022,1,0,0,1
310470,2021,1,0,0,1
310480,2015,0,0,1,1
310480,2016,1,0,0,1
310490,2022,1,0,0,1
310500,2018,0,0,1,1
310500,2019,1,0,0,1
310500,2021,1,0,0,1
310510,2015,1,0,0,1
310510,2016,1,0,1,2
310510,2017,0,0,1,1
310510,2018,1,1,0,2
310510,2019,1,0,0,1
310510,2020,2,0,0,2
310510,2022,4,0,0,4
310520,2016,1,0,0,1
310530,2015,1,0,0,1
310530,2016,0,1,0,1
310530,2017,2,0,1,3
310530,2018,3,0,0,3
310530,2019,0,1,1,2
310530,2021,1,0,0,1
310530,2022,0,0,1,1
310540,2015,0,1,1,2
310540,2016,5,0,2,7
310540,2017,3,1,2,6
310540,2018,5,0,2,7
310540,2019,1,2,3,6
310540,2020,5,2,1,8
310540,2021,6,0,4,10
310540,2022,5,4,1,10
310550,2021,0,0,1,1
310560,2015,2,2,2,6
310560,2016,12,2,2,16
310560,2017,15,3,3,21
310560,2018,11,3,0,14
310560,2019,6,1,3,10
310560,2020,9,3,2,14
310560,2021,12,1,2,15
310560,2022,7,1,1,9
310570,2018,1,0,0,1
310570,2019,0,0,1,1
310590,2016,0,0,1,1
310590,2017,1,0,0,1
310590,2019,2,1,1,4
310590,2020,1,0,0,1
310590,2021,0,1,0,1
310590,2022,1,0,0,1
310600,2015,1,0,1,2
310600,2017,4,0,0,4
310600,2018,1,0,0,1
310600,2019,3,0,1,4
310600,2020,0,1,2,3
310600,2021,3,0,0,3
310600,2022,1,1,0,2
310610,2017,0,1,0,1
310620,2015,330,73,147,550
310620,2016,389,96,162,647
310620,2017,494,98,172,764
310620,2018,497,119,176,792
310620,2019,451,121,139,711
310620,2020,465,131,168,764
310620,2021,454,148,165,767
310620,2022,474,159,145,778
310630,2015,1,0,1,2
310630,2017,2,1,1,4
310630,2018,0,0,1,1
310630,2019,1,3,1,5
310630,2020,1,0,1,2
310630,2021,2,0,0,2
310640,2015,0,0,1,1
310640,2020,0,1,0,1
310640,2021,0,0,1,1
310650,2020,1,0,0,1
310660,2022,0,1,0,1
310670,2015,36,4,32,72
310670,2016,29,6,20,55
310670,2017,27,7,30,64
310670,2018,55,8,21,84
310670,2019,46,15,18,79
310670,2020,41,15,27,83
310670,2021,40,10,24,74
310670,2022,38,14,21,73
310690,2015,2,0,0,2
310690,2016,0,1,0,1
310690,2017,2,0,1,3
310690,2018,1,0,1,2
310690,2019,2,0,1,3
310710,2017,2,0,0,2
310710,2018,5,0,0,5
310710,2019,5,0,1,6
310710,2021,4,1,0,5
310710,2022,4,0,1,5
310720,2015,1,0,0,1
310730,2016,1,0,1,2
310730,2018,1,0,0,1
310730,2019,2,0,0,2
310730,2020,2,0,0,2
310730,2022,1,0,0,1
310740,2015,5,2,0,7
310740,2016,3,4,2,9
310740,2017,9,2,2,13
310740,2018,7,0,1,8
310740,2019,8,2,3,13
310740,2020,8,2,2,12
310740,2021,7,1,2,10
310740,2022,6,1,1,8
310750,2017,1,0,0,1
310750,2019,0,0,1,1
310750,2021,0,0,1,1
310770,2016,0,0,1,1
310770,2022,0,0,1,1
310780,2015,1,0,0,1
310780,2016,1,0,1,2
310780,2018,1,0,0,1
310780,2019,0,0,1,1
310780,2022,0,1,0,1
310800,2017,0,0,2,2
310800,2018,1,0,0,1
310800,2020,0,0,1,1
310800,2022,0,0,1,1
310810,2015,1,0,0,1
310820,2021,0,1,0,1
310830,2015,2,0,0,2
310830,2016,2,0,0,2
310830,2017,2,1,1,4
310830,2018,2,2,2,6
310830,2019,0,1,1,2
310830,2020,1,0,1,2
310830,2021,1,1,1,3
310830,2022,0,0,1,1
310840,2015,0,0,1,1
310840,2016,1,0,1,2
310840,2017,1,0,2,3
310840,2018,0,0,2,2
310840,2019,3,0,1,4
310840,2020,3,0,0,3
310840,2021,1,0,0,1
310840,2022,0,1,1,2
310855,2015,1,0,0,1
310855,2016,1,1,1,3
310855,2017,1,0,1,2
310855,2018,1,0,4,5
310855,2019,4,0,3,7
310855,2020,4,0,3,7
310855,2021,0,0,2,2
310855,2022,0,0,1,1
310860,2017,1,0,0,1
310860,2018,1,0,0,1
310860,2021,0,0,1,1
310880,2021,1,0,0,1
310890,2016,1,0,0,1
310890,2020,3,0,1,4
310890,2021,1,0,1,2
310890,2022,0,1,0,1
310900,2015,3,0,0,3
310900,2016,3,0,2,5
310900,2017,2,0,0,2
310900,2018,1,0,1,2
310900,2019,2,1,1,4
310900,2020,1,0,1,2
310900,2021,3,0,3,6
310900,2022,2,0,3,5
310910,2016,1,0,0,1
310920,2018,0,1,0,1
310920,2020,0,0,1,1
310930,2015,0,0,1,1
310930,2016,3,0,0,3
310930,2017,1,0,0,1
310930,2018,0,0,1,1
310930,2020,1,0,0,1
310930,2021,1,0,1,2
310940,2017,1,0,0,1
310940,2018,1,0,0,1
310940,2020,1,0,1,2
310940,2021,0,0,1,1
310940,2022,1,0,1,2
310950,2018,3,0,0,3
310950,2021,0,0,1,1
310960,2015,1,0,1,2
310960,2017,2,0,0,2
310960,2019,0,0,1,1
310960,2020,1,0,0,1
310970,2015,0,1,1,2
310970,2016,2,0,1,3
310970,2017,1,0,0,1
310970,2018,0,1,0,1
310970,2019,1,0,1,2
310970,2020,0,0,1,1
310970,2021,1,1,0,2
310970,2022,1,0,1,2
310980,2017,0,0,1,1
310980,2018,1,0,0,1
310990,2015,1,0,1,2
310990,2016,2,0,0,2
310990,2017,1,0,0,1
310990,2018,1,0,0,1
310990,2019,0,1,0,1
310990,2020,0,0,2,2
310990,2022,0,2,0,2
311000,2015,1,0,3,4
311000,2016,1,0,3,4
311000,2017,5,0,5,10
311000,2018,1,1,0,2
311000,2019,1,0,5,6
311000,2020,3,1,1,5
311000,2021,2,0,1,3
311000,2022,7,2,0,9
311020,2015,0,0,1,1
311030,2015,0,0,1,1
311030,2017,0,1,0,1
311030,2018,1,0,0,1
311030,2019,0,0,1,1
311030,2020,0,0,2,2
311050,2015,0,0,3,3
311050,2016,0,0,1,1
311050,2017,1,0,1,2
311050,2018,3,0,1,4
311050,2019,6,0,4,10
311050,2020,1,0,3,4
311050,2021,2,1,3,6
311050,2022,2,1,1,4
311060,2015,7,1,1,9
311060,2016,3,1,0,4
311060,2017,5,0,2,7
311060,2018,5,0,5,10
311060,2019,0,0,1,1
311060,2020,2,0,1,3
311060,2021,1,0,1,2
311060,2022,3,0,2,5
311070,2016,2,0,0,2
311070,2017,2,0,0,2
311070,2018,2,0,0,2
311070,2019,1,2,1,4
311070,2020,0,0,1,1
311070,2021,1,1,0,2
311080,2020,1,0,0,1
311090,2016,2,0,0,2
311090,2017,2,0,0,2
311090,2019,1,0,0,1
311090,2021,1,0,0,1
311090,2022,1,0,0,1
311100,2017,1,0,0,1
311100,2019,1,0,1,2
311100,2020,0,0,1,1
311100,2022,1,1,0,2
311110,2015,0,0,1,1
311110,2016,0,0,1,1
311110,2017,1,0,0,1
311110,2018,0,2,2,4
311110,2019,0,0,1,1
311110,2020,1,1,2,4
311110,2021,1,1,0,2
311110,2022,1,0,0,1
311120,2015,0,1,1,2
311120,2016,1,0,1,2
311120,2017,0,0,1,1
311120,2018,4,0,0,4
311120,2019,3,0,2,5
311120,2020,2,0,0,2
311120,2021,3,0,0,3
311120,2022,1,0,0,1
311130,2020,0,0,1,1
311130,2021,1,0,0,1
311130,2022,1,0,0,1
311140,2015,1,0,2,3
311140,2016,0,0,1,1
311140,2017,2,0,2,4
311140,2018,2,0,1,3
311140,2019,1,0,0,1
311140,2020,1,1,0,2
311140,2021,2,1,1,4
311140,2022,0,0,1,1
311150,2016,0,1,0,1
311150,2018,1,0,0,1
311150,2019,0,0,1,1
311160,2016,1,0,0,1
311160,2017,0,0,2,2
311160,2021,1,0,0,1
311160,2022,0,0,1,1
311180,2015,0,0,1,1
311180,2016,0,0,1,1
311180,2017,2,0,0,2
311180,2018,1,0,0,1
311180,2019,1,0,0,1
311200,2016,1,0,1,2
311200,2020,0,1,0,1
311200,2022,2,0,0,2
311205,2018,1,0,0,1
311210,2018,0,0,1,1
311230,2015,2,0,1,3
311230,2016,2,0,1,3
311230,2017,1,0,0,1
311230,2018,2,1,0,3
311230,2019,2,0,0,2
311230,2020,1,0,1,2
311230,2021,2,0,0,2
311230,2022,1,1,2,4
311240,2015,2,0,0,2
311250,2016,1,0,1,2
311250,2017,1,0,0,1
311250,2018,0,0,1,1
311250,2019,1,0,0,1
311250,2020,0,2,1,3
311250,2021,1,0,0,1
311250,2022,1,0,0,1
311260,2016,0,0,1,1
311260,2018,0,0,1,1
311260,2019,1,0,0,1
311260,2021,0,1,0,1
311265,2019,1,0,0,1
311270,2018,1,0,1,2
311280,2016,1,0,0,1
311280,2017,1,0,0,1
311280,2019,1,0,0,1
311280,2020,1,0,0,1
311280,2022,1,0,0,1
311290,2016,1,0,0,1
311290,2018,3,0,1,4
311290,2019,0,0,1,1
311290,2020,1,0,0,1
311290,2022,0,1,0,1
311300,2019,1,0,0,1
311320,2015,1,0,1,2
311320,2016,1,0,0,1
311320,2017,2,0,0,2
311320,2018,2,0,1,3
311320,2019,0,1,2,3
311320,2020,2,0,0,2
311320,2021,2,0,2,4
311320,2022,1,0,1,2
311330,2015,1,0,0,1
311330,2016,2,1,0,3
311330,2017,3,0,0,3
311330,2018,2,0,1,3
311330,2019,2,1,0,3
311330,2020,2,0,0,2
311330,2021,3,0,1,4
311330,2022,3,0,2,5
311340,2015,2,0,1,3
311340,2016,8,1,2,11
311340,2017,8,1,6,15
311340,2018,8,1,4,13
311340,2019,10,3,5,18
311340,2020,13,0,8,21
311340,2021,6,1,3,10
311340,2022,4,0,1,5
311350,2016,2,1,0,3
311350,2018,1,0,1,2
311350,2019,0,1,0,1
311350,2020,1,0,0,1
311350,2021,0,1,0,1
311350,2022,2,0,0,2
311360,2015,0,0,1,1
311360,2016,0,1,0,1
311360,2021,1,0,0,1
311360,2022,2,0,0,2
311370,2018,1,0,0,1
311370,2021,0,1,1,2
311390,2022,1,0,0,1
311400,2015,2,0,0,2
311400,2016,2,1,1,4
311400,2017,4,1,0,5
311400,2018,2,0,2,4
311400,2019,3,1,0,4
311400,2021,0,0,1,1
311400,2022,2,0,0,2
311410,2015,0,0,2,2
311410,2018,1,0,0,1
311410,2019,1,0,2,3
311420,2015,7,0,1,8
311420,2016,6,2,4,12
311420,2017,10,0,2,12
311420,2018,8,0,4,12
311420,2019,3,3,1,7
311420,2020,5,0,5,10
311420,2021,11,0,6,17
311420,2022,6,0,2,8
311430,2016,0,0,1,1
311430,2019,1,0,0,1
311430,2020,3,0,1,4
311430,2021,2,0,2,4
311430,2022,4,0,1,5
311440,2017,2,0,0,2
311440,2018,0,0,1,1
311440,2019,1,0,0,1
311440,2021,0,1,0,1
311450,2015,1,0,0,1
311450,2016,1,0,0,1
311450,2017,2,1,1,4
311450,2018,0,1,3,4
311450,2019,1,0,1,2
311450,2020,1,0,0,1
311450,2021,1,0,0,1
311450,2022,1,0,0,1
311455,2015,0,0,1,1
311455,2017,2,0,0,2
311455,2018,5,0,1,6
311455,2019,3,0,0,3
311455,2020,1,0,1,2
311455,2021,0,1,2,3
311455,2022,1,0,1,2
311460,2016,1,0,0,1
311460,2020,0,0,1,1
311460,2021,1,0,0,1
311470,2021,1,0,0,1
311480,2022,1,0,0,1
311510,2017,3,0,0,3
311510,2018,0,1,1,2
311510,2019,2,1,0,3
311510,2020,1,0,1,2
311510,2021,0,0,1,1
311510,2022,2,0,2,4
311520,2017,0,0,1,1
311520,2021,0,0,1,1
311530,2015,2,0,1,3
311530,2016,6,1,2,9
311530,2017,4,0,1,5
311530,2018,6,0,1,7
311530,2019,6,1,6,13
311530,2020,5,2,2,9
311530,2021,6,1,2,9
311530,2022,9,1,3,13
311535,2016,1,0,0,1
311535,2017,0,0,1,1
311535,2019,1,0,0,1
311535,2020,1,0,1,2
311535,2021,1,0,1,2
311535,2022,0,0,1,1
311545,2016,0,0,1,1
311545,2018,1,0,0,1
311545,2021,0,0,1,1
311550,2016,3,0,0,3
311550,2017,1,0,0,1
311550,2018,3,0,0,3
311550,2021,0,0,1,1
311550,2022,1,0,0,1
311570,2019,2,0,0,2
311570,2020,0,1,0,1
311580,2015,0,0,1,1
311580,2018,0,0,1,1
311580,2020,1,0,0,1
311580,2022,1,0,0,1
311590,2015,0,1,0,1
311600,2018,1,0,0,1
311600,2020,0,0,1,1
311615,2022,1,0,0,1
311640,2019,0,0,1,1
311650,2022,1,0,0,1
311660,2015,2,1,2,5
311660,2016,4,1,0,5
311660,2017,5,0,0,5
311660,2018,7,0,3,10
311660,2019,7,1,2,10
311660,2020,2,0,1,3
311660,2021,3,0,1,4
311660,2022,7,1,0,8
311670,2017,1,0,0,1
311670,2021,1,0,0,1
311690,2022,0,1,0,1
311710,2016,1,0,0,1
311710,2018,0,1,0,1
311710,2019,1,0,0,1
311730,2015,1,0,2,3
311730,2016,5,0,2,7
311730,2017,3,0,3,6
311730,2018,3,1,2,6
311730,2019,3,1,1,5
311730,2020,5,1,0,6
311730,2021,2,1,2,5
311730,2022,1,0,2,3
311740,2017,0,0,1,1
311750,2016,3,0,1,4
311750,2017,1,0,1,2
311750,2018,2,0,2,4
311750,2019,1,0,2,3
311750,2020,1,0,1,2
311750,2021,1,1,0,2
311760,2016,1,0,0,1
311760,2020,0,0,1,1
311760,2021,1,0,0,1
311770,2016,1,0,0,1
311770,2019,1,0,0,1
311770,2020,0,2,0,2
311770,2021,0,0,1,1
311780,2015,1,0,1,2
311780,2016,1,0,0,1
311780,2018,1,0,5,6
311780,2019,2,0,0,2
311780,2020,1,0,0,1
311780,2021,0,0,2,2
311780,2022,2,0,0,2
311787,2015,0,0,1,1
311787,2016,1,0,3,4
311787,2017,0,0,2,2
311787,2018,3,0,0,3
311787,2019,0,3,0,3
311787,2020,1,0,1,2
311787,2021,1,0,1,2
311787,2022,3,0,1,4
311790,2015,2,0,0,2
311790,2017,1,0,0,1
311790,2018,1,0,1,2
311790,2019,0,0,1,1
311790,2020,1,0,0,1
311800,2015,9,2,6,17
311800,2016,8,2,5,15
311800,2017,6,0,7,13
311800,2018,7,1,4,12
311800,2019,7,1,4,12
311800,2020,6,0,4,10
311800,2021,15,3,4,22
311800,2022,8,2,3,13
311810,2022,1,0,0,1
311820,2015,0,0,1,1
311820,2016,0,0,1,1
311820,2017,1,0,0,1
311820,2019,1,0,1,2
311820,2020,2,0,0,2
311820,2021,2,0,0,2
311820,2022,0,1,1,2
311830,2015,13,2,8,23
311830,2016,15,2,10,27
311830,2017,22,4,8,34
311830,2018,16,0,6,22
311830,2019,10,2,4,16
311830,2020,13,5,9,27
311830,2021,9,2,6,17
311830,2022,11,8,8,27
311840,2017,1,0,0,1
311840,2018,0,0,1,1
311840,2019,1,1,0,2
311840,2020,3,0,0,3
311840,2021,2,0,0,2
311840,2022,0,0,1,1
311850,2022,0,1,0,1
311860,2015,63,12,36,111
311860,2016,55,9,23,87
311860,2017,62,13,31,106
311860,2018,74,14,35,123
311860,2019,67,10,37,114
311860,2020,59,11,18,88
311860,2021,64,15,21,100
311860,2022,51,17,33,101
311880,2017,1,0,0,1
311890,2017,1,0,0,1
311890,2020,1,0,0,1
311910,2015,0,0,1,1
311910,2017,2,0,0,2
311910,2019,1,0,0,1
311910,2020,0,0,1,1
311910,2021,1,1,0,2
311930,2017,1,0,0,1
311930,2019,1,0,1,2
311930,2020,1,0,1,2
311930,2021,2,0,0,2
311940,2015,5,2,5,12
311940,2016,11,3,7,21
311940,2017,13,1,8,22
311940,2018,18,11,9,38
311940,2019,17,3,6,26
311940,2020,10,4,5,19
311940,2021,10,2,8,20
311940,2022,13,5,4,22
311950,2021,1,0,0,1
311980,2016,2,0,0,2
311980,2017,1,0,0,1
311980,2019,1,0,0,1
311980,2021,0,0,1,1
311990,2018,0,1,0,1
311990,2020,0,1,0,1
311995,2016,0,0,1,1
311995,2019,1,0,1,2
311995,2020,1,2,1,4
312020,2020,1,0,0,1
312040,2022,0,1,0,1
312050,2017,0,0,1,1
312050,2020,0,1,1,2
312050,2021,0,0,2,2
312070,2015,1,0,0,1
312070,2016,1,0,0,1
312070,2018,1,0,0,1
312080,2022,1,0,0,1
312087,2017,1,0,0,1
312087,2020,1,0,0,1
312090,2015,1,0,0,1
312090,2016,1,0,2,3
312090,2017,3,0,0,3
312090,2018,5,0,2,7
312090,2019,2,2,0,4
312090,2020,6,1,1,8
312090,2021,4,1,3,8
312090,2022,6,1,0,7
312110,2017,1,0,0,1
312110,2018,1,0,1,2
312120,2021,0,0,1,1
312120,2022,0,0,1,1
312125,2016,0,0,1,1
312125,2017,1,1,1,3
312125,2019,0,1,2,3
312125,2020,0,1,0,1
312125,2021,2,0,0,2
312125,2022,1,1,0,2
312130,2021,0,0,1,1
312130,2022,0,1,1,2
312140,2018,0,0,3,3
312140,2021,1,0,0,1
312160,2015,2,3,1,6
312160,2016,5,0,0,5
312160,2017,4,1,1,6
312160,2018,2,0,2,4
312160,2019,1,1,0,2
312160,2020,4,0,1,5
312160,2021,2,0,0,2
312160,2022,8,3,1,12
312170,2018,0,0,1,1
312180,2016,1,0,0,1
312180,2018,0,0,1,1
312200,2016,1,0,0,1
312200,2017,0,1,1,2
312200,2019,1,0,0,1
312200,2022,1,0,0,1
312220,2017,0,0,1,1
312220,2020,0,0,1,1
312220,2021,0,0,1,1
312230,2015,67,12,26,105
312230,2016,66,15,29,110
312230,2017,80,12,52,144
312230,2018,69,11,34,114
312230,2019,101,19,23,143
312230,2020,81,22,25,128
312230,2021,68,29,23,120
312230,2022,58,25,16,99
312240,2020,0,0,1,1
312260,2019,1,0,0,1
312270,2015,1,0,0,1
312270,2017,0,0,1,1
312280,2018,1,0,0,1
312290,2022,0,0,1,1
312300,2021,0,0,1,1
312300,2022,1,0,0,1
312320,2015,0,0,1,1
312320,2016,1,0,1,2
312320,2017,0,1,0,1
312320,2018,1,1,0,2
312320,2019,1,2,0,3
312320,2021,1,0,0,1
312352,2017,1,0,1,2
312352,2018,0,0,1,1
312352,2019,0,0,1,1
312352,2022,0,0,1,1
312360,2016,0,0,1,1
312360,2017,2,1,0,3
312360,2018,3,2,3,8
312360,2019,3,1,0,4
312360,2021,0,1,0,1
312360,2022,2,0,1,3
312370,2017,1,1,0,2
312370,2018,0,0,1,1
312370,2021,1,0,0,1
312380,2015,0,0,1,1
312380,2017,0,0,1,1
312385,2020,0,0,1,1
312385,2022,1,0,0,1
312390,2015,1,0,0,1
312390,2017,3,2,1,6
312390,2019,1,0,0,1
312390,2020,0,0,1,1
312390,2021,1,0,0,1
312390,2022,3,0,1,4
312400,2019,2,0,0,2
312400,2020,1,1,0,2
312410,2016,2,0,3,5
312410,2017,2,1,3,6
312410,2018,0,0,2,2
312410,2019,3,0,1,4
312410,2020,0,1,3,4
312410,2021,1,1,1,3
312410,2022,1,2,2,5
312420,2017,2,0,5,7
312420,2018,1,0,1,2
312420,2019,0,2,1,3
312420,2020,1,0,1,2
312420,2021,0,0,1,1
312420,2022,1,0,0,1
312430,2019,0,0,1,1
312430,2020,1,0,0,1
312440,2018,1,0,0,1
312440,2019,1,0,0,1
312450,2015,2,0,1,3
312450,2016,0,0,1,1
312450,2017,1,0,1,2
312450,2019,0,0,1,1
312450,2020,0,0,1,1
312450,2022,0,0,2,2
312480,2015,0,0,1,1
312480,2017,1,0,0,1
312480,2019,0,1,0,1
312480,2021,0,0,1,1
312490,2016,1,0,0,1
312490,2017,0,1,0,1
312490,2020,0,1,0,1
312490,2021,0,1,0,1
312500,2020,1,0,0,1
312510,2015,12,3,10,25
312510,2016,8,1,10,19
312510,2017,9,1,5,15
312510,2018,18,6,5,29
312510,2019,6,0,6,12
312510,2020,3,2,4,9
312510,2021,7,1,8,16
312510,2022,7,2,6,15
312530,2017,1,0,0,1
312570,2019,1,0,0,1
312570,2022,1,0,0,1
312590,2015,1,0,0,1
312600,2016,0,1,0,1
312600,2017,1,0,1,2
312600,2018,1,0,1,2
312600,2019,0,0,2,2
312600,2022,0,0,2,2
312610,2015,1,0,1,2
312610,2016,4,1,1,6
312610,2017,5,0,0,5
312610,2018,5,0,1,6
312610,2019,10,2,1,13
312610,2020,5,1,1,7
312610,2021,1,1,0,2
312610,2022,7,2,0,9
312620,2015,0,0,1,1
312640,2016,1,0,0,1
312640,2022,1,0,0,1
312650,2022,1,0,0,1
312660,2020,0,0,1,1
312670,2021,2,0,0,2
312690,2017,0,0,1,1
312700,2015,1,0,0,1
312700,2017,0,1,0,1
312700,2018,3,0,2,5
312700,2019,2,0,1,3
312700,2021,1,0,1,2
312700,2022,1,0,0,1
312710,2015,4,0,5,9
312710,2016,1,1,1,3
312710,2017,0,0,1,1
312710,2018,5,0,5,10
312710,2019,4,0,2,6
312710,2020,3,1,5,9
312710,2021,4,0,3,7
312710,2022,6,0,4,10
312730,2020,1,0,0,1
312737,2021,1,0,0,1
312740,2021,0,0,1,1
312760,2019,1,0,0,1
312770,2015,7,0,1,8
312770,2016,4,2,1,7
312770,2017,17,4,5,26
312770,2018,32,8,11,51
312770,2019,14,2,10,26
312770,2020,7,3,6,16
312770,2021,18,2,4,24
312770,2022,11,5,5,21
312800,2015,0,2,0,2
312800,2016,0,0,1,1
312800,2017,0,1,0,1
312800,2018,2,1,1,4
312800,2019,3,1,0,4
312800,2020,1,2,0,3
312800,2021,1,3,1,5
312800,2022,6,1,0,7
312810,2018,1,0,0,1
312810,2019,0,0,1,1
312820,2016,1,0,0,1
312820,2018,0,0,1,1
312820,2020,0,0,1,1
312825,2015,0,0,1,1
312830,2015,4,0,0,4
312830,2016,3,0,0,3
312830,2017,3,0,3,6
312830,2018,2,0,1,3
312830,2019,0,0,2,2
312830,2020,1,0,1,2
312830,2021,2,0,1,3
312830,2022,2,0,1,3
312840,2021,0,0,1,1
312860,2021,1,0,0,1
312870,2015,6,0,3,9
312870,2016,6,0,4,10
312870,2017,8,1,9,18
312870,2018,8,0,0,8
312870,2019,4,1,1,6
312870,2020,4,0,1,5
312870,2021,4,1,3,8
312870,2022,3,1,2,6
312880,2020,1,0,0,1
312880,2022,1,0,0,1
312890,2015,1,0,0,1
312890,2019,1,0,0,1
312890,2020,1,0,0,1
312890,2022,1,0,0,1
312900,2018,1,0,0,1
312900,2020,0,0,1,1
312910,2016,1,0,0,1
312910,2018,1,0,0,1
312920,2017,0,1,0,1
312930,2015,1,0,0,1
312930,2016,1,0,0,1
312930,2017,0,0,1,1
312930,2018,3,0,1,4
312930,2019,1,0,0,1
312930,2022,1,0,0,1
312950,2015,0,1,0,1
312950,2016,0,0,1,1
312950,2017,1,1,1,3
312950,2018,1,0,3,4
312950,2019,1,0,0,1
312950,2020,2,0,0,2
312950,2021,1,0,0,1
312950,2022,0,1,2,3
312965,2018,1,0,0,1
312970,2015,0,0,2,2
312970,2018,1,0,0,1
312970,2019,1,0,1,2
312970,2021,1,0,1,2
312980,2015,2,3,9,14
312980,2016,8,0,10,18
312980,2017,12,6,8,26
312980,2018,9,2,7,18
312980,2019,11,2,7,20
312980,2020,5,6,7,18
312980,2021,9,4,10,23
312980,2022,4,5,3,12
312990,2016,0,1,0,1
313000,2019,1,0,0,1
313010,2015,1,0,2,3
313010,2016,3,1,2,6
313010,2017,2,0,3,5
313010,2018,0,1,1,2
313010,2019,3,0,1,4
313010,2020,1,1,3,5
313010,2021,1,1,3,5
313010,2022,2,0,2,4
313020,2015,0,0,1,1
313020,2017,2,0,1,3
313020,2018,0,0,1,1
313020,2019,1,0,2,3
313020,2020,1,0,0,1
313020,2021,1,1,0,2
313020,2022,0,0,3,3
313030,2016,0,1,0,1
313030,2017,0,0,1,1
313030,2018,0,0,1,1
313030,2019,1,0,0,1
313030,2020,1,0,0,1
313040,2015,1,0,0,1
313040,2017,0,0,2,2
313040,2018,1,0,0,1
313040,2020,0,0,1,1
313040,2021,1,0,0,1
313040,2022,0,0,1,1
313050,2015,0,0,1,1
313055,2021,1,0,0,1
313060,2015,1,0,0,1
313060,2017,2,0,0,2
313060,2021,0,0,1,1
313060,2022,1,0,0,1
313070,2016,1,0,0,1
313070,2019,0,0,1,1
313070,2020,1,0,0,1
313070,2021,0,0,1,1
313070,2022,1,0,0,1
313090,2018,0,0,1,1
313090,2020,1,0,0,1
313090,2021,2,0,0,2
313100,2017,0,0,1,1
313100,2019,0,0,1,1
313100,2020,1,0,0,1
313100,2021,0,0,1,1
313110,2016,1,0,0,1
313110,2019,1,0,0,1
313115,2015,0,0,1,1
313115,2016,1,0,0,1
313115,2017,0,0,2,2
313115,2018,1,0,1,2
313115,2019,0,0,1,1
313115,2020,2,0,1,3
313115,2022,1,0,0,1
313120,2016,0,1,0,1
313120,2017,2,0,1,3
313120,2018,4,0,0,4
313120,2019,1,1,0,2
313120,2021,0,0,1,1
313130,2015,38,4,14,56
313130,2016,31,5,16,52
313130,2017,31,5,15,51
313130,2018,31,2,14,47
313130,2019,44,8,19,71
313130,2020,17,2,11,30
313130,2021,23,4,11,38
313130,2022,33,10,16,59
313140,2017,0,0,1,1
313140,2021,1,0,0,1
313150,2019,1,0,0,1
313150,2020,1,0,1,2
313150,2021,1,0,0,1
313150,2022,1,0,0,1
313160,2021,1,0,0,1
313170,2015,25,6,21,52
313170,2016,17,7,7,31
313170,2017,29,9,8,46
313170,2018,11,6,9,26
313170,2019,24,6,4,34
313170,2020,14,3,12,29
313170,2021,16,5,6,27
313170,2022,12,1,5,18
313180,2018,1,0,0,1
313190,2015,4,1,6,11
313190,2016,1,2,2,5
313190,2017,5,2,1,8
313190,2018,7,0,3,10
313190,2019,7,0,2,9
313190,2020,7,5,4,16
313190,2021,9,3,4,16
313190,2022,7,1,3,11
313210,2016,0,0,1,1
313220,2019,1,2,0,3
313220,2021,0,1,1,2
313230,2017,1,0,0,1
313230,2018,1,0,0,1
313240,2015,3,0,1,4
313240,2016,1,0,5,6
313240,2017,7,4,6,17
313240,2018,6,1,10,17
313240,2019,10,0,2,12
313240,2020,11,5,2,18
313240,2021,8,2,3,13
313240,2022,5,2,4,11
313250,2015,1,0,1,2
313250,2017,0,0,1,1
313250,2018,2,2,0,4
313250,2019,1,0,1,2
313250,2020,0,0,1,1
313250,2022,2,0,0,2
313270,2016,1,0,0,1
313270,2017,0,0,1,1
313270,2019,2,1,1,4
313280,2021,0,1,0,1
313290,2018,0,1,0,1
313290,2020,2,0,0,2
313300,2015,2,0,1,3
313300,2016,3,0,0,3
313300,2017,0,0,4,4
313300,2018,2,0,1,3
313300,2019,0,1,1,2
313300,2021,2,0,0,2
313300,2022,0,0,1,1
313310,2016,1,1,0,2
313310,2017,1,0,0,1
313320,2017,0,1,0,1
313330,2018,1,0,0,1
313330,2019,0,1,0,1
313330,2021,1,0,0,1
313340,2018,0,1,0,1
313340,2019,0,0,1,1
313340,2020,0,0,2,2
313340,2022,0,0,1,1
313350,2015,5,0,1,6
313350,2016,5,1,1,7
313350,2017,4,0,2,6
313350,2018,4,1,2,7
313350,2019,4,0,5,9
313350,2020,1,0,1,2
313350,2021,3,0,2,5
313350,2022,2,0,1,3
313360,2018,1,1,0,2
313360,2019,2,1,0,3
313360,2021,1,0,1,2
313370,2016,0,0,2,2
313370,2017,1,0,0,1
313370,2018,0,0,1,1
313370,2020,0,0,1,1
313370,2021,1,0,0,1
313375,2015,1,0,0,1
313375,2017,2,1,0,3
313375,2019,0,1,0,1
313375,2020,0,1,0,1
313375,2021,0,1,0,1
313375,2022,0,0,1,1
313380,2015,3,2,1,6
313380,2016,6,3,3,12
313380,2017,16,1,7,24
313380,2018,11,0,6,17
313380,2019,11,3,9,23
313380,2020,14,4,5,23
313380,2021,2,0,7,9
313380,2022,1,1,1,3
313400,2020,1,0,0,1
313410,2016,0,1,0,1
313420,2015,5,0,5,10
313420,2016,5,1,7,13
313420,2017,13,1,12,26
313420,2018,8,2,9,19
313420,2019,14,5,5,24
313420,2020,9,1,7,17
313420,2021,6,2,1,9
313420,2022,1,0,5,6
313430,2015,1,0,1,2
313430,2016,1,0,0,1
313430,2017,2,0,0,2
313430,2018,0,0,1,1
313440,2015,3,1,4,8
313440,2016,0,0,2,2
313440,2017,4,0,1,5
313440,2018,7,0,5,12
313440,2019,2,2,0,4
313440,2020,2,2,4,8
313440,2021,5,0,3,8
313440,2022,2,0,3,5
313450,2019,1,0,0,1
313460,2015,0,1,0,1
313460,2017,1,0,0,1
313470,2022,1,0,0,1
313480,2015,1,0,0,1
313480,2018,1,0,0,1
313490,2015,1,0,0,1
313490,2018,3,0,0,3
313490,2019,3,1,0,4
313490,2020,1,1,0,2
313490,2021,1,0,0,1
313490,2022,2,0,0,2
313500,2015,1,0,0,1
313500,2016,0,0,1,1
313500,2019,1,0,0,1
313505,2015,1,0,2,3
313505,2016,0,1,1,2
313505,2017,0,0,2,2
313505,2020,0,0,1,1
313507,2019,1,0,0,1
313510,2015,0,1,0,1
313510,2016,0,0,2,2
313510,2017,2,1,1,4
313510,2018,1,0,0,1
313510,2019,1,0,0,1
313510,2020,1,2,0,3
313510,2021,1,0,0,1
313510,2022,1,0,0,1
313520,2016,1,0,0,1
313520,2017,3,0,1,4
313520,2018,1,0,0,1
313520,2019,4,0,0,4
313520,2020,1,0,0,1
313520,2021,1,0,0,1
313520,2022,1,0,0,1
313530,2015,0,0,1,1
313530,2017,2,0,0,2
313530,2018,1,0,1,2
313530,2022,1,0,0,1
313540,2015,0,1,0,1
313540,2016,1,0,0,1
313540,2017,1,0,0,1
313540,2020,0,0,1,1
313540,2021,0,0,1,1
313540,2022,0,0,1,1
313550,2015,0,0,1,1
313550,2017,0,1,1,2
313550,2021,1,0,0,1
313570,2015,1,0,0,1
313570,2019,1,1,0,2
313570,2020,1,0,0,1
313580,2021,2,0,0,2
313590,2019,1,0,0,1
313600,2022,2,0,0,2
313620,2015,6,2,3,11
313620,2016,11,2,4,17
313620,2017,12,2,2,16
313620,2018,10,2,2,14
313620,2019,10,3,5,18
313620,2020,7,0,2,9
313620,2021,8,2,4,14
313620,2022,8,7,2,17
313630,2015,1,0,1,2
313630,2016,2,0,0,2
313630,2017,5,0,1,6
313630,2018,1,0,0,1
313630,2019,5,1,0,6
313630,2020,4,0,2,6
313630,2021,1,0,0,1
313630,2022,2,1,0,3
313660,2017,1,0,0,1
313660,2022,1,0,0,1
313665,2015,1,0,1,2
313665,2016,1,0,1,2
313665,2017,1,2,2,5
313665,2018,1,2,0,3
313665,2019,6,0,5,11
313665,2020,6,0,1,7
313665,2021,1,0,2,3
313665,2022,2,2,1,5
313670,2015,46,8,16,70
313670,2016,47,7,25,79
313670,2017,67,7,24,98
313670,2018,50,10,19,79
313670,2019,44,18,19,81
313670,2020,34,6,18,58
313670,2021,44,16,20,80
313670,2022,48,9,8,65
313690,2016,0,0,2,2
313690,2018,0,0,1,1
313690,2021,1,0,0,1
313690,2022,1,0,0,1
313700,2018,1,0,0,1
313700,2020,1,0,1,2
313720,2015,12,2,7,21
313720,2016,7,2,5,14
313720,2017,8,6,13,27
313720,2018,15,0,8,23
313720,2019,11,1,2,14
313720,2020,6,3,7,16
313720,2021,5,1,2,8
313720,2022,16,4,4,24
313740,2015,1,0,0,1
313740,2016,0,0,1,1
313740,2017,0,0,1,1
313740,2020,2,0,0,2
313740,2021,2,0,0,2
313740,2022,0,1,0,1
313750,2020,1,0,0,1
313750,2022,0,0,1,1
313753,2017,0,0,1,1
313753,2022,0,0,1,1
313760,2015,5,1,3,9
313760,2016,8,0,2,10
313760,2017,7,1,5,13
313760,2018,4,0,0,4
313760,2019,5,0,4,9
313760,2020,4,0,0,4
313760,2021,7,1,4,12
313760,2022,3,3,1,7
313770,2016,0,0,1,1
313770,2017,2,1,0,3
313770,2018,1,0,1,2
313770,2019,1,0,1,2
313770,2020,1,1,0,2
313770,2021,3,0,0,3
313780,2016,0,0,1,1
313780,2017,1,0,0,1
313810,2016,1,0,0,1
313810,2019,0,0,1,1
313820,2015,9,0,5,14
313820,2016,12,4,14,30
313820,2017,19,5,10,34
313820,2018,21,5,11,37
313820,2019,13,4,8,25
313820,2020,19,2,4,25
313820,2021,19,2,6,27
313820,2022,14,8,2,24
313830,2015,1,0,0,1
313830,2017,1,0,0,1
313830,2020,3,0,0,3
313840,2017,1,1,0,2
313840,2020,2,2,1,5
313840,2021,0,2,2,4
313850,2017,0,1,0,1
313860,2015,1,0,1,2
313860,2016,0,0,2,2
313860,2017,1,0,0,1
313860,2018,1,1,0,2
313860,2020,2,0,0,2
313860,2021,1,2,0,3
313860,2022,1,0,0,1
313862,2015,1,0,0,1
313862,2016,0,1,1,2
313862,2018,0,1,0,1
313862,2019,0,0,1,1
313862,2020,1,0,1,2
313862,2021,1,0,3,4
313862,2022,1,1,0,2
313867,2017,2,0,1,3
313867,2020,0,0,1,1
313867,2022,1,0,0,1
313880,2015,2,1,1,4
313880,2016,2,0,0,2
313880,2017,0,0,2,2
313880,2018,2,1,0,3
313880,2019,4,0,0,4
313880,2020,4,0,0,4
313880,2022,1,1,0,2
313900,2015,2,1,0,3
313900,2016,5,0,2,7
313900,2017,6,0,4,10
313900,2018,9,2,1,12
313900,2019,0,2,4,6
313900,2020,4,0,1,5
313900,2021,1,2,2,5
313900,2022,5,1,1,7
313910,2020,1,0,0,1
313920,2016,0,0,1,1
313920,2021,1,0,0,1
313940,2015,7,1,2,10
313940,2016,13,0,6,19
313940,2017,14,1,6,21
313940,2018,11,5,5,21
313940,2019,14,1,6,21
313940,2020,8,2,2,12
313940,2021,7,2,7,16
313940,2022,6,3,5,14
313950,2015,1,0,0,1
313950,2016,1,1,0,2
313950,2017,0,2,0,2
313950,2018,0,3,2,5
313950,2020,2,0,0,2
313960,2015,1,0,1,2
313960,2016,1,0,0,1
313960,2018,1,0,2,3
313960,2019,2,0,1,3
313960,2020,0,1,0,1
313960,2021,0,0,1,1
313960,2022,0,0,1,1
313970,2015,1,0,0,1
313970,2017,1,0,0,1
313970,2018,1,0,0,1
313970,2020,1,0,0,1
313970,2021,0,0,1,1
313970,2022,1,0,1,2
313980,2019,1,0,0,1
313980,2020,1,0,0,1
313980,2021,0,0,1,1
313980,2022,0,0,1,1
313990,2019,1,0,1,2
313990,2021,2,0,0,2
313990,2022,1,0,0,1
314000,2015,6,0,3,9
314000,2016,4,1,4,9
314000,2017,3,6,4,13
314000,2018,7,2,2,11
314000,2019,3,2,0,5
314000,2020,9,0,1,10
314000,2021,6,0,5,11
314000,2022,5,0,0,5
314010,2017,0,0,1,1
314015,2017,1,0,0,1
314015,2018,0,1,0,1
314015,2021,1,0,1,2
314015,2022,1,0,0,1
314020,2017,0,0,2,2
314020,2021,1,0,0,1
314030,2017,1,0,0,1
314030,2020,0,1,0,1
314030,2022,1,0,1,2
314050,2016,1,0,1,2
314050,2017,1,0,1,2
314050,2018,3,0,1,4
314050,2019,1,0,1,2
314050,2020,1,0,4,5
314050,2022,1,1,0,2
314053,2017,1,0,0,1
314053,2021,1,0,0,1
314070,2015,0,0,2,2
314070,2016,1,1,3,5
314070,2017,2,0,0,2
314070,2018,1,1,2,4
314070,2019,6,5,3,14
314070,2020,2,1,2,5
314070,2021,1,1,5,7
314080,2015,1,0,0,1
314080,2017,1,0,1,2
314080,2018,0,1,1,2
314080,2019,0,0,1,1
314080,2021,0,0,1,1
314080,2022,1,0,0,1
314090,2018,0,1,0,1
314100,2015,0,1,0,1
314100,2016,0,1,0,1
314110,2015,1,0,2,3
314110,2016,2,3,7,12
314110,2017,2,0,1,3
314110,2018,3,0,1,4
314110,2019,4,2,1,7
314110,2020,6,1,3,10
314110,2021,1,3,0,4
314110,2022,4,0,4,8
314120,2019,0,0,1,1
314140,2016,1,1,0,2
314140,2019,1,0,0,1
314160,2016,1,0,0,1
314160,2018,2,0,0,2
314170,2016,0,0,1,1
314170,2017,1,0,0,1
314170,2018,0,0,2,2
314170,2021,0,1,1,2
314180,2018,1,0,0,1
314180,2021,0,0,1,1
314180,2022,0,0,1,1
314210,2018,2,0,0,2
314210,2020,1,0,0,1
314210,2022,1,0,0,1
314230,2020,0,0,1,1
314240,2016,0,0,1,1
314240,2018,5,0,0,5
314240,2019,2,0,1,3
314240,2020,3,0,1,4
314240,2021,2,0,0,2
314240,2022,0,1,0,1
314260,2016,1,0,0,1
314260,2021,1,0,0,1
314280,2017,1,0,1,2
314280,2019,1,0,0,1
314280,2021,0,0,1,1
314280,2022,1,0,0,1
314300,2015,1,0,0,1
314300,2019,0,0,1,1
314300,2020,0,1,2,3
314300,2022,0,0,1,1
314310,2015,1,0,0,1
314310,2016,1,0,0,1
314310,2017,5,0,1,6
314310,2018,3,1,1,5
314310,2019,2,0,0,2
314310,2020,1,1,0,2
314310,2021,2,0,0,2
314310,2022,0,1,1,2
314320,2015,0,0,1,1
314320,2020,1,0,1,2
314320,2021,0,1,0,1
314320,2022,1,0,0,1
314330,2015,27,1,17,45
314330,2016,24,5,17,46
314330,2017,31,7,13,51
314330,2018,27,7,9,43
314330,2019,32,5,12,49
314330,2020,16,10,14,40
314330,2021,18,2,15,35
314330,2022,20,7,6,33
314340,2015,0,1,0,1
314340,2016,1,0,0,1
314340,2017,1,0,0,1
314340,2018,1,0,1,2
314340,2019,1,0,0,1
314340,2022,1,0,0,1
314350,2017,1,0,0,1
314350,2021,2,0,0,2
314380,2016,1,0,0,1
314380,2017,1,0,1,2
314390,2015,3,0,4,7
314390,2016,2,0,2,4
314390,2017,8,0,5,13
314390,2018,4,1,3,8
314390,2019,6,0,1,7
314390,2020,2,0,5,7
314390,2021,6,1,0,7
314390,2022,9,1,0,10
314400,2016,1,0,0,1
314400,2017,1,0,0,1
314410,2016,0,0,2,2
314410,2017,0,0,2,2
314410,2018,1,0,0,1
314410,2020,0,2,1,3
314410,2021,1,0,0,1
314430,2015,1,0,0,1
314430,2016,2,0,0,2
314430,2018,2,0,1,3
314430,2019,0,0,2,2
314430,2020,1,0,0,1
314430,2021,3,2,0,5
314430,2022,0,1,0,1
314435,2016,0,0,1,1
314435,2018,2,0,0,2
314437,2020,1,0,0,1
314450,2017,2,0,2,4
314450,2019,0,0,1,1
314450,2020,0,0,1,1
314450,2021,0,1,0,1
314450,2022,1,0,0,1
314460,2018,2,0,0,2
314460,2019,2,0,1,3
314460,2020,1,0,1,2
314470,2015,0,1,0,1
314470,2018,1,0,0,1
314470,2019,2,1,0,3
314470,2020,0,0,1,1
314470,2021,1,0,1,2
314470,2022,1,1,1,3
314480,2015,6,4,6,16
314480,2016,9,4,3,16
314480,2017,12,1,1,14
314480,2018,16,3,10,29
314480,2019,10,4,5,19
314480,2020,9,4,6,19
314480,2021,12,3,6,21
314480,2022,8,2,4,14
314500,2015,1,0,0,1
314500,2017,1,0,0,1
314500,2019,1,2,0,3
314500,2020,0,0,1,1
314500,2021,3,0,0,3
314510,2016,1,0,0,1
314510,2019,1,0,0,1
314510,2021,1,0,0,1
314510,2022,1,0,0,1
314520,2015,12,1,6,19
314520,2016,8,1,9,18
314520,2017,20,1,11,32
314520,2018,14,3,11,28
314520,2019,10,2,8,20
314520,2020,12,2,3,17
314520,2021,13,3,0,16
314520,2022,11,6,4,21
314530,2021,0,1,0,1
314535,2019,0,0,1,1
314560,2015,4,1,1,6
314560,2016,2,1,1,4
314560,2017,4,1,0,5
314560,2018,7,0,1,8
314560,2019,3,1,0,4
314560,2020,3,0,0,3
314560,2021,1,1,0,2
314560,2022,4,3,1,8
314585,2015,0,0,1,1
314585,2016,1,0,0,1
314585,2017,1,0,0,1
314585,2018,1,0,0,1
314585,2022,0,0,1,1
314587,2017,0,1,0,1
314587,2021,1,0,0,1
314590,2015,3,1,5,9
314590,2016,4,0,1,5
314590,2017,4,0,1,5
314590,2018,4,1,3,8
314590,2019,5,0,4,9
314590,2020,1,0,0,1
314590,2021,2,0,2,4
314590,2022,7,1,2,10
314600,2015,1,1,0,2
314600,2016,4,1,1,6
314600,2018,1,0,0,1
314600,2019,4,0,1,5
314600,2020,1,1,0,2
314600,2021,1,0,0,1
314600,2022,2,0,0,2
314610,2015,6,1,6,13
314610,2016,4,2,6,12
314610,2017,6,4,3,13
314610,2018,11,1,4,16
314610,2019,9,2,2,13
314610,2020,4,3,2,9
314610,2021,2,3,8,13
314610,2022,1,1,4,6
314620,2017,1,0,0,1
314620,2019,1,0,0,1
314625,2018,0,0,1,1
314640,2017,1,0,0,1
314640,2020,0,0,1,1
314650,2017,1,0,0,1
314670,2018,0,1,0,1
314690,2015,0,0,1,1
314690,2018,1,0,2,3
314690,2020,2,0,0,2
314690,2022,0,1,0,1
314700,2015,5,0,0,5
314700,2016,5,1,5,11
314700,2017,4,1,7,12
314700,2018,1,0,3,4
314700,2019,10,1,5,16
314700,2020,8,3,3,14
314700,2021,10,1,1,12
314700,2022,9,0,1,10
314710,2015,6,1,3,10
314710,2016,6,6,7,19
314710,2017,11,3,7,21
314710,2018,9,2,4,15
314710,2019,24,6,8,38
314710,2020,7,2,7,16
314710,2021,14,1,6,21
314710,2022,11,3,1,15
314720,2015,1,0,0,1
314720,2016,5,0,0,5
314720,2017,3,1,1,5
314720,2018,2,1,0,3
314720,2019,2,2,1,5
314720,2020,0,0,1,1
314720,2021,0,1,0,1
314720,2022,2,1,0,3
314730,2016,2,0,1,3
314730,2017,2,0,1,3
314730,2018,1,0,0,1
314730,2020,1,1,1,3
314730,2021,1,2,4,7
314730,2022,1,4,1,6
314740,2015,0,1,1,2
314740,2016,0,1,1,2
314740,2017,2,0,0,2
314740,2018,1,1,0,2
314740,2019,0,0,2,2
314740,2021,1,3,1,5
314740,2022,1,0,0,1
314760,2017,1,0,0,1
314770,2015,0,0,1,1
314770,2017,2,0,0,2
314770,2018,1,0,1,2
314770,2020,1,0,0,1
314770,2022,0,0,1,1
314780,2018,1,0,0,1
314790,2015,6,1,4,11
314790,2016,4,2,5,11
314790,2017,16,3,2,21
314790,2018,8,3,0,11
314790,2019,14,4,4,22
314790,2020,12,2,2,16
314790,2021,7,4,1,12
314790,2022,7,3,1,11
314800,2015,7,3,2,12
314800,2016,5,1,1,7
314800,2017,1,0,2,3
314800,2018,9,1,3,13
314800,2019,10,1,3,14
314800,2020,16,0,7,23
314800,2021,7,0,4,11
314800,2022,10,5,11,26
314810,2015,2,0,4,6
314810,2016,3,2,1,6
314810,2017,2,1,1,4
314810,2018,4,0,3,7
314810,2019,12,1,3,16
314810,2020,7,1,4,12
314810,2021,10,0,1,11
314810,2022,7,1,3,11
314820,2016,0,1,0,1
314830,2016,1,0,1,2
314830,2017,1,0,0,1
314830,2022,1,1,0,2
314850,2022,0,1,0,1
314860,2021,1,0,0,1
314870,2015,0,0,1,1
314870,2017,1,1,0,2
314870,2018,0,0,1,1
314870,2022,2,0,0,2
314890,2016,1,0,1,2
314890,2017,2,0,0,2
314890,2019,0,0,2,2
314890,2020,3,0,0,3
314890,2021,3,1,1,5
314910,2017,1,0,0,1
314930,2015,10,3,4,17
314930,2016,15,1,0,16
314930,2017,8,2,6,16
314930,2018,8,1,4,13
314930,2019,11,2,7,20
314930,2020,8,2,4,14
314930,2021,9,1,2,12
314930,2022,7,4,2,13
314960,2015,1,0,0,1
314970,2016,2,0,1,3
314970,2017,3,1,0,4
314970,2018,1,1,1,3
314970,2019,1,1,2,4
314970,2020,1,1,0,2
314970,2021,1,0,1,2
314970,2022,2,0,0,2
314980,2016,1,0,0,1
314980,2020,0,0,1,1
314980,2021,1,0,0,1
314990,2015,1,0,1,2
314990,2016,2,0,1,3
314990,2017,0,0,1,1
314990,2018,3,0,0,3
314990,2019,0,0,2,2
314990,2020,1,0,0,1
314990,2021,1,0,1,2
315010,2022,1,0,0,1
315020,2018,1,0,0,1
315020,2020,0,0,1,1
315030,2015,0,0,1,1
315050,2017,1,0,0,1
315050,2018,1,0,0,1
315050,2019,0,0,1,1
315050,2021,1,0,0,1
315053,2015,1,0,0,1
315053,2018,1,0,2,3
315053,2020,1,0,0,1
315060,2022,1,1,0,2
315070,2018,0,0,1,1
315070,2022,1,0,0,1
315080,2022,1,0,0,1
315100,2017,1,0,0,1
315100,2020,0,1,1,2
315110,2015,0,0,1,1
315110,2016,1,0,2,3
315110,2017,2,0,2,4
315110,2018,2,0,2,4
315110,2019,2,1,0,3
315110,2020,0,1,0,1
315110,2021,0,1,0,1
315120,2015,1,0,1,2
315120,2016,3,0,0,3
315120,2017,5,0,5,10
315120,2018,4,1,1,6
315120,2019,6,0,4,10
315120,2020,1,0,0,1
315120,2021,2,2,1,5
315120,2022,4,1,1,6
315130,2021,1,0,1,2
315140,2015,1,0,2,3
315140,2016,2,1,1,4
315140,2017,4,1,0,5
315140,2018,3,0,1,4
315140,2019,1,0,1,2
315140,2020,1,0,2,3
315140,2021,4,2,1,7
315140,2022,6,0,0,6
315150,2016,4,0,0,4
315150,2017,1,1,1,3
315150,2018,2,1,1,4
315150,2019,3,0,0,3
315150,2020,1,1,0,2
315150,2022,0,0,2,2
315160,2016,0,0,1,1
315160,2017,0,0,2,2
315160,2018,1,0,0,1
315160,2019,2,0,0,2
315160,2020,1,0,2,3
315160,2022,1,0,0,1
315170,2015,1,0,0,1
315170,2017,0,0,1,1
315170,2019,1,0,0,1
315170,2020,1,0,0,1
315180,2015,27,5,14,46
315180,2016,24,1,12,37
315180,2017,18,2,9,29
315180,2018,22,3,9,34
315180,2019,13,7,10,30
315180,2020,20,4,13,37
315180,2021,12,10,9,31
315180,2022,15,3,4,22
315200,2015,1,0,0,1
315200,2016,1,0,0,1
315200,2018,1,0,0,1
315200,2019,2,0,0,2
315200,2020,2,1,0,3
315200,2021,1,0,0,1
315200,2022,1,0,1,2
315210,2015,8,2,3,13
315210,2016,1,0,2,3
315210,2017,10,1,4,15
315210,2018,9,1,2,12
315210,2019,7,2,3,12
315210,2020,3,4,3,10
315210,2021,6,1,3,10
315210,2022,5,4,1,10
315213,2017,1,0,0,1
315217,2016,1,0,0,1
315217,2019,1,0,0,1
315220,2022,1,0,0,1
315240,2022,1,0,0,1
315250,2015,25,4,18,47
315250,2016,23,6,20,49
315250,2017,23,2,13,38
315250,2018,38,4,10,52
315250,2019,25,5,12,42
315250,2020,10,6,9,25
315250,2021,25,5,6,36
315250,2022,22,5,9,36
315260,2015,0,0,1,1
315260,2016,0,0,1,1
315260,2019,0,1,0,1
315260,2022,1,0,0,1
315270,2018,1,0,0,1
315270,2019,1,0,1,2
315280,2016,1,0,0,1
315280,2017,2,0,1,3
315280,2019,2,0,0,2
315280,2020,0,0,1,1
315280,2022,3,0,0,3
315290,2017,1,0,0,1
315290,2018,1,0,0,1
315290,2020,1,0,0,1
315290,2022,1,0,0,1
315300,2018,0,0,1,1
315300,2020,1,0,0,1
315310,2018,0,1,0,1
315310,2020,1,0,0,1
315320,2017,1,0,0,1
315340,2020,1,0,0,1
315340,2022,1,0,0,1
315350,2015,1,0,0,1
315350,2017,0,0,1,1
315350,2018,0,1,0,1
315360,2016,0,0,1,1
315360,2017,0,0,1,1
315360,2019,1,0,0,1
315360,2021,1,0,0,1
315360,2022,1,0,0,1
315370,2015,0,0,1,1
315390,2015,1,1,1,3
315390,2016,0,1,0,1
315390,2017,2,0,0,2
315390,2018,1,0,1,2
315390,2020,2,1,0,3
315390,2021,1,0,1,2
315400,2015,0,0,1,1
315400,2020,0,1,0,1
315400,2021,1,2,1,4
315400,2022,0,1,0,1
315410,2017,1,0,0,1
315410,2020,0,0,1,1
315420,2016,1,0,0,1
315420,2017,1,0,0,1
315420,2018,0,0,1,1
315420,2020,2,0,0,2
315420,2021,1,0,0,1
315430,2016,2,0,0,2
315430,2017,0,1,0,1
315430,2018,4,0,0,4
315430,2019,0,0,1,1
315430,2021,1,0,0,1
315440,2016,1,0,0,1
315440,2019,1,0,0,1
315440,2022,2,0,0,2
315445,2015,3,0,0,3
315450,2021,0,1,0,1
315450,2022,0,0,1,1
315460,2015,9,0,21,30
315460,2016,12,2,7,21
315460,2017,14,1,11,26
315460,2018,12,1,6,19
315460,2019,12,3,3,18
315460,2020,9,6,11,26
315460,2021,10,2,8,20
315460,2022,13,4,4,21
315470,2021,1,0,0,1
315470,2022,0,0,1,1
315480,2015,2,0,0,2
315480,2018,1,0,0,1
315480,2021,0,1,0,1
315480,2022,1,0,0,1
315490,2018,1,0,0,1
315500,2018,1,0,0,1
315530,2017,1,0,0,1
315530,2019,1,0,0,1
315540,2015,0,0,1,1
315540,2017,2,0,0,2
315550,2015,1,0,0,1
315550,2016,0,1,0,1
315550,2020,2,0,0,2
315550,2022,1,0,0,1
315560,2017,1,0,0,1
315570,2015,4,0,0,4
315570,2019,0,0,1,1
315570,2020,1,0,1,2
315580,2015,1,0,0,1
315580,2016,3,0,0,3
315580,2017,1,0,1,2
315580,2019,1,1,1,3
315580,2021,0,0,1,1
315580,2022,0,0,1,1
315590,2018,1,0,0,1
315590,2020,1,0,0,1
315590,2021,2,0,0,2
315610,2022,1,0,0,1
315620,2015,1,0,0,1
315630,2016,0,0,1,1
315670,2015,6,3,7,16
315670,2016,7,1,3,11
315670,2017,8,2,6,16
315670,2018,4,2,0,6
315670,2019,7,4,2,13
315670,2020,4,2,4,10
315670,2021,4,1,7,12
315670,2022,8,4,4,16
315680,2016,1,0,0,1
315680,2017,1,0,0,1
315680,2020,2,0,0,2
315690,2015,1,0,1,2
315690,2016,2,0,1,3
315690,2017,7,0,1,8
315690,2018,0,1,3,4
315690,2019,2,1,2,5
315690,2020,0,0,1,1
315690,2021,1,1,2,4
315690,2022,2,1,1,4
315700,2015,1,0,0,1
315700,2016,2,1,0,3
315700,2017,2,0,1,3
315700,2018,2,0,0,2
315700,2020,3,0,1,4
315700,2021,1,1,0,2
315700,2022,0,0,2,2
315710,2015,1,0,0,1
315710,2018,1,0,0,1
315710,2022,0,1,0,1
315720,2015,5,0,4,9
315720,2016,2,0,2,4
315720,2017,4,1,3,8
315720,2018,3,0,1,4
315720,2019,4,0,1,5
315720,2020,4,1,0,5
315720,2021,3,1,3,7
315720,2022,1,0,5,6
315733,2016,2,0,1,3
315733,2017,1,0,0,1
315733,2018,1,0,1,2
315733,2019,2,0,0,2
315765,2020,1,0,0,1
315770,2016,1,0,0,1
315770,2019,1,0,1,2
315770,2021,0,1,0,1
315770,2022,1,1,0,2
315780,2015,8,1,8,17
315780,2016,4,3,7,14
315780,2017,8,3,5,16
315780,2018,10,3,5,18
315780,2019,9,3,3,15
315780,2020,7,2,3,12
315780,2021,11,5,1,17
315780,2022,16,3,1,20
315790,2015,1,0,0,1
315790,2016,1,0,0,1
315790,2019,0,1,0,1
315790,2022,0,0,1,1
315800,2015,0,0,1,1
315800,2016,1,0,1,2
315800,2019,2,1,0,3
315800,2021,0,0,1,1
315800,2022,0,0,1,1
315830,2016,1,0,0,1
315840,2015,0,0,1,1
315840,2020,1,0,0,1
315850,2019,0,0,1,1
315860,2015,0,1,0,1
315860,2016,1,0,0,1
315860,2021,0,0,1,1
315880,2020,1,0,0,1
315890,2016,1,0,0,1
315890,2018,2,0,0,2
315890,2021,1,0,0,1
315895,2015,0,0,2,2
315895,2016,5,1,5,11
315895,2017,3,1,0,4
315895,2018,1,0,1,2
315895,2019,2,1,4,7
315895,2020,2,1,4,7
315895,2021,2,0,2,4
315895,2022,3,0,0,3
315900,2019,1,0,0,1
315910,2019,1,0,0,1
315920,2017,0,1,0,1
315920,2020,1,0,0,1
315930,2015,1,0,0,1
315950,2015,0,0,1,1
315960,2015,7,0,1,8
315960,2016,5,0,1,6
315960,2017,4,1,2,7
315960,2018,9,0,4,13
315960,2019,8,0,3,11
315960,2020,5,0,3,8
315960,2021,3,0,2,5
315960,2022,5,2,2,9
315980,2015,0,1,1,2
315980,2016,3,0,1,4
315980,2017,1,0,4,5
315980,2018,3,0,0,3
315980,2019,2,0,1,3
315980,2020,1,0,1,2
315980,2021,1,0,0,1
315980,2022,2,0,6,8
315990,2016,1,0,0,1
315990,2020,3,0,0,3
315990,2021,1,0,0,1
316010,2015,1,0,0,1
316040,2015,4,0,5,9
316040,2016,4,1,4,9
316040,2017,7,1,5,13
316040,2018,10,0,1,11
316040,2019,3,3,1,7
316040,2020,7,0,0,7
316040,2021,7,3,3,13
316040,2022,4,2,2,8
316070,2015,1,1,2,4
316070,2016,1,2,0,3
316070,2017,2,0,2,4
316070,2018,2,0,1,3
316070,2019,2,2,0,4
316070,2020,3,0,0,3
316070,2021,8,0,1,9
316070,2022,2,0,1,3
316090,2022,2,0,0,2
316100,2016,0,0,1,1
316100,2017,0,0,1,1
316100,2019,1,0,1,2
316100,2020,1,0,1,2
316110,2015,0,0,1,1
316110,2019,0,0,1,1
316120,2015,1,0,0,1
316120,2016,1,0,0,1
316130,2022,0,0,1,1
316150,2017,3,0,0,3
316150,2018,1,0,0,1
316180,2015,2,0,2,4
316180,2017,2,0,0,2
316180,2018,1,0,3,4
316180,2019,2,0,1,3
316180,2020,0,0,1,1
316180,2021,4,0,1,5
316180,2022,3,1,0,4
316190,2015,4,0,1,5
316190,2016,1,1,1,3
316190,2017,4,1,1,6
316190,2018,1,2,2,5
316190,2019,2,1,0,3
316190,2020,0,0,2,2
316190,2021,2,0,0,2
316190,2022,1,0,1,2
316200,2015,0,0,1,1
316200,2016,1,0,0,1
316200,2017,1,0,0,1
316200,2018,1,0,0,1
316200,2019,1,0,0,1
316200,2020,1,1,0,2
316200,2021,2,0,2,4
316200,2022,0,0,2,2
316210,2015,0,0,1,1
316210,2017,1,0,0,1
316210,2018,1,0,1,2
316210,2019,0,1,1,2
316210,2020,2,2,2,6
316210,2021,5,1,3,9
316210,2022,2,1,1,4
316220,2018,0,0,1,1
316220,2020,0,0,1,1
316240,2016,1,0,0,1
316250,2015,5,0,4,9
316250,2016,8,5,2,15
316250,2017,15,1,2,18
316250,2018,10,1,4,15
316250,2019,7,4,7,18
316250,2020,10,3,3,16
316250,2021,4,1,3,8
316250,2022,5,1,1,7
316255,2017,1,0,0,1
316255,2018,0,1,0,1
316255,2019,1,0,0,1
316255,2021,1,0,0,1
316255,2022,0,0,2,2
316257,2017,1,0,0,1
316260,2018,1,0,0,1
316260,2022,0,1,0,1
316280,2016,1,0,0,1
316280,2018,1,0,0,1
316280,2019,1,0,0,1
316280,2020,1,0,0,1
316280,2021,0,1,0,1
316280,2022,1,0,0,1
316290,2015,2,0,0,2
316290,2016,0,0,3,3
316290,2017,0,0,1,1
316290,2018,0,1,1,2
316290,2019,0,1,0,1
316290,2021,0,2,0,2
316290,2022,5,0,1,6
316292,2015,0,0,4,4
316292,2016,0,0,1,1
316292,2017,1,0,0,1
316292,2019,1,0,1,2
316292,2020,0,0,2,2
316292,2021,5,0,0,5
316292,2022,0,2,1,3
316294,2015,1,0,0,1
316294,2018,0,0,1,1
316294,2021,0,0,2,2
316295,2015,2,0,1,3
316295,2016,2,0,2,4
316295,2017,1,0,0,1
316295,2018,0,0,1,1
316295,2019,1,0,2,3
316295,2020,1,1,4,6
316295,2021,0,2,0,2
316310,2018,1,0,0,1
316310,2021,0,0,1,1
316320,2021,0,2,0,2
316340,2022,0,0,1,1
316360,2017,1,0,0,1
316360,2022,0,1,0,1
316370,2015,0,0,2,2
316370,2016,2,0,0,2
316370,2017,2,0,4,6
316370,2018,6,0,2,8
316370,2019,8,0,0,8
316370,2020,1,0,2,3
316370,2021,0,0,2,2
316370,2022,1,0,0,1
316380,2015,0,0,1,1
316380,2018,1,0,0,1
316380,2019,1,0,0,1
316390,2022,1,0,0,1
316430,2015,1,0,0,1
316430,2018,0,0,1,1
316430,2019,0,1,1,2
316430,2022,1,0,0,1
316440,2016,1,0,0,1
316440,2017,1,0,0,1
316440,2018,0,1,0,1
316440,2020,1,0,0,1
316440,2022,2,1,0,3
316443,2020,1,0,0,1
316450,2018,1,0,0,1
316460,2015,3,0,4,7
316460,2016,2,3,2,7
316460,2017,3,0,0,3
316460,2018,0,0,1,1
316460,2019,1,0,1,2
316460,2020,1,0,1,2
316460,2021,2,0,0,2
316470,2015,4,0,2,6
316470,2016,2,1,2,5
316470,2017,4,2,3,9
316470,2018,6,1,5,12
316470,2019,4,0,2,6
316470,2020,6,1,0,7
316470,2021,3,2,4,9
316470,2022,4,3,5,12
316500,2017,1,0,0,1
316500,2018,1,1,2,4
316500,2020,2,0,1,3
316500,2021,1,0,1,2
316510,2019,1,0,0,1
316530,2016,1,0,0,1
316530,2017,1,0,0,1
316530,2018,1,0,0,1
316530,2019,1,0,0,1
316530,2021,0,1,0,1
316530,2022,1,0,0,1
316553,2015,1,0,2,3
316553,2016,2,0,1,3
316553,2017,0,0,2,2
316553,2018,1,2,2,5
316553,2020,4,0,2,6
316553,2021,2,0,0,2
316553,2022,2,0,0,2
316555,2016,0,0,1,1
316556,2015,1,0,0,1
316556,2016,0,0,2,2
316557,2015,0,0,1,1
316557,2021,0,0,1,1
316570,2015,0,0,1,1
316570,2020,0,1,0,1
316580,2018,1,0,0,1
316600,2022,1,0,0,1
316610,2015,1,0,0,1
316620,2018,1,0,0,1
316670,2020,0,0,1,1
316680,2015,1,0,0,1
316680,2021,0,0,1,1
316690,2017,0,2,0,2
316690,2018,1,0,0,1
316690,2019,0,0,1,1
316690,2022,0,0,1,1
316700,2022,1,0,0,1
316710,2016,0,0,2,2
316710,2017,0,0,1,1
316710,2019,0,0,1,1
316710,2020,2,0,0,2
316710,2021,0,0,1,1
316720,2015,30,2,13,45
316720,2016,16,6,10,32
316720,2017,21,9,12,42
316720,2018,28,12,8,48
316720,2019,23,5,13,41
316720,2020,20,6,7,33
316720,2021,17,3,14,34
316720,2022,21,6,11,38
316740,2015,0,0,2,2
316740,2017,1,1,0,2
316740,2018,0,0,1,1
316740,2019,0,0,1,1
316750,2016,0,1,0,1
316760,2015,0,0,1,1
316760,2018,1,2,0,3
316760,2019,1,0,1,2
316760,2020,1,1,0,2
316760,2021,2,0,0,2
316760,2022,3,0,0,3
316790,2019,2,0,0,2
316800,2016,1,1,0,2
316800,2017,1,0,0,1
316800,2021,1,0,0,1
316810,2015,1,0,0,1
316810,2018,1,0,0,1
316810,2021,0,0,1,1
316820,2018,1,0,0,1
316840,2015,0,0,1,1
316850,2017,2,0,0,2
316850,2018,3,0,0,3
316850,2019,2,0,1,3
316850,2020,2,0,0,2
316860,2015,4,0,0,4
316860,2016,11,2,5,18
316860,2017,10,5,1,16
316860,2018,9,3,5,17
316860,2019,8,3,4,15
316860,2020,6,3,2,11
316860,2021,7,3,2,12
316860,2022,6,1,3,10
316870,2015,7,2,9,18
316870,2016,7,2,6,15
316870,2017,8,2,4,14
316870,2018,9,6,3,18
316870,2019,8,3,4,15
316870,2020,3,1,4,8
316870,2021,9,2,3,14
316870,2022,6,1,3,10
316880,2016,0,0,1,1
316880,2017,1,0,0,1
316880,2019,0,0,1,1
316880,2020,2,0,0,2
316880,2021,1,0,0,1
316890,2019,0,1,0,1
316890,2021,0,1,1,2
316890,2022,0,2,2,4
316900,2015,1,0,0,1
316900,2018,0,0,1,1
316900,2021,0,1,0,1
316910,2015,1,0,0,1
316910,2016,1,0,0,1
316910,2018,1,0,0,1
316920,2016,0,0,1,1
316920,2019,1,0,0,1
316920,2022,1,0,0,1
316930,2015,1,0,3,4
316930,2016,6,0,2,8
316930,2017,4,1,2,7
316930,2018,10,0,2,12
316930,2019,7,0,2,9
316930,2020,6,1,3,10
316930,2021,2,2,1,5
316930,2022,0,1,0,1
316935,2015,0,0,1,1
316935,2016,2,0,0,2
316935,2017,1,0,0,1
316935,2018,1,1,1,3
316935,2019,0,0,2,2
316935,2020,0,1,0,1
316935,2021,1,2,4,7
316935,2022,2,1,1,4
316940,2015,3,4,0,7
316940,2016,1,0,0,1
316940,2017,1,0,0,1
316940,2018,1,0,0,1
316940,2019,2,0,1,3
316940,2021,1,0,0,1
316940,2022,3,0,0,3
316960,2016,0,1,0,1
316960,2017,0,0,1,1
316960,2018,3,0,1,4
316960,2021,1,0,1,2
316960,2022,2,0,0,2
316970,2015,2,0,0,2
316970,2016,0,0,2,2
316970,2018,1,0,2,3
316970,2020,1,0,0,1
316970,2022,1,0,0,1
316980,2016,0,0,1,1
316980,2019,0,0,1,1
316990,2015,8,1,4,13
316990,2016,5,0,1,6
316990,2017,2,4,1,7
316990,2018,6,1,2,9
316990,2019,7,1,4,12
316990,2020,6,2,3,11
316990,2021,5,2,3,10
316990,2022,4,0,1,5
317000,2017,1,0,0,1
317005,2015,0,0,1,1
317010,2015,23,3,15,41
317010,2016,24,11,21,56
317010,2017,47,10,32,89
317010,2018,53,10,30,93
317010,2019,71,8,23,102
317010,2020,51,8,20,79
317010,2021,27,4,15,46
317010,2022,29,9,11,49
317020,2015,38,4,29,71
317020,2016,54,7,27,88
317020,2017,55,15,34,104
317020,2018,66,16,34,116
317020,2019,75,17,33,125
317020,2020,59,14,25,98
317020,2021,59,11,17,87
317020,2022,58,20,30,108
317040,2015,4,0,0,4
317040,2016,3,1,3,7
317040,2017,7,2,3,12
317040,2018,7,1,5,13
317040,2019,5,2,2,9
317040,2020,6,0,3,9
317040,2021,3,1,1,5
317040,2022,6,0,1,7
317043,2020,0,0,1,1
317050,2015,1,0,0,1
317050,2016,1,0,0,1
317050,2019,2,0,0,2
317050,2020,1,0,0,1
317050,2022,1,0,1,2
317057,2018,1,0,0,1
317070,2015,5,0,4,9
317070,2016,11,0,3,14
317070,2017,22,0,8,30
317070,2018,16,3,6,25
317070,2019,21,4,9,34
317070,2020,13,5,8,26
317070,2021,17,3,7,27
317070,2022,7,1,7,15
317075,2015,1,0,0,1
317075,2019,1,0,1,2
317075,2020,1,0,0,1
317075,2021,1,0,0,1
317080,2016,1,0,0,1
317080,2018,1,0,1,2
317080,2019,0,0,2,2
317080,2021,1,0,0,1
317100,2015,2,0,0,2
317100,2017,0,2,0,2
317100,2018,0,0,1,1
317100,2020,1,0,2,3
317100,2021,1,1,0,2
317107,2019,1,0,1,2
317110,2015,1,0,0,1
317120,2015,7,1,5,13
317120,2016,4,1,6,11
317120,2017,5,1,2,8
317120,2018,3,3,0,6
317120,2019,4,0,4,8
317120,2020,4,1,5,10
317120,2021,5,2,4,11
317120,2022,3,2,3,8
317130,2015,10,5,4,19
317130,2016,7,0,4,11
317130,2017,13,4,5,22
317130,2018,15,1,1,17
317130,2019,11,1,4,16
317130,2020,10,1,7,18
317130,2021,6,3,1,10
317130,2022,4,2,1,7
317150,2021,0,0,1,1
317160,2019,1,0,0,1
317180,2016,1,0,0,1
317180,2017,1,0,0,1
317180,2020,1,0,0,1
317200,2015,2,0,2,4
317200,2016,2,0,0,2
317200,2017,0,0,1,1
317200,2020,1,0,1,2
317200,2021,1,0,1,2
317200,2022,2,2,0,4
317210,2015,0,0,1,1
317210,2016,1,0,0,1
320000,2016,1,0,0,1
320000,2017,1,0,0,1
320000,2018,2,0,0,2
320000,2021,1,1,0,2
320010,2015,1,0,0,1
320010,2016,1,0,0,1
320010,2017,1,0,3,4
320010,2018,1,0,1,2
320010,2019,2,1,0,3
320010,2020,2,0,1,3
320010,2021,1,1,1,3
320010,2022,2,0,1,3
320013,2018,1,0,0,1
320013,2019,1,0,0,1
320013,2020,0,0,1,1
320013,2022,1,0,0,1
320016,2019,1,0,0,1
320016,2021,1,0,0,1
320020,2015,1,0,1,2
320020,2017,1,0,2,3
320020,2018,4,0,1,5
320020,2020,3,0,0,3
320020,2021,2,0,0,2
320020,2022,2,0,0,2
320030,2015,1,0,0,1
320030,2016,1,0,0,1
320030,2017,1,0,0,1
320030,2018,2,0,0,2
320030,2019,5,1,0,6
320030,2022,1,0,0,1
320035,2015,2,0,1,3
320035,2018,2,0,0,2
320035,2019,0,1,0,1
320040,2015,0,0,2,2
320040,2016,2,1,1,4
320040,2017,4,0,2,6
320040,2018,0,1,0,1
320040,2019,1,0,1,2
320040,2020,1,0,1,2
320040,2021,4,0,0,4
320040,2022,3,0,0,3
320050,2017,2,0,0,2
320050,2020,1,0,0,1
320060,2015,4,1,3,8
320060,2016,13,1,10,24
320060,2017,23,0,7,30
320060,2018,10,4,4,18
320060,2019,6,3,10,19
320060,2020,10,0,4,14
320060,2021,14,3,5,22
320060,2022,9,7,3,19
320070,2015,0,0,1,1
320070,2018,2,0,0,2
320070,2019,1,0,1,2
320070,2020,1,0,0,1
320070,2022,0,1,0,1
320080,2017,4,0,1,5
320080,2018,2,0,5,7
320080,2019,1,1,0,2
320080,2021,2,1,1,4
320080,2022,0,0,2,2
320090,2015,2,0,1,3
320090,2016,4,0,1,5
320090,2017,0,0,2,2
320090,2018,1,0,4,5
320090,2019,1,0,1,2
320090,2020,2,1,0,3
320090,2021,0,0,1,1
320090,2022,1,1,1,3
320100,2016,0,0,2,2
320100,2017,0,1,0,1
320100,2018,1,0,0,1
320100,2019,1,0,0,1
320100,2020,0,1,0,1
320100,2021,2,0,0,2
320100,2022,0,0,1,1
320110,2015,1,1,0,2
320110,2017,1,1,0,2
320110,2018,0,0,1,1
320110,2020,1,0,1,2
320115,2016,1,0,0,1
320115,2018,1,0,0,1
320115,2019,0,1,0,1
320120,2015,7,0,10,17
320120,2016,17,7,12,36
320120,2017,30,6,13,49
320120,2018,26,3,5,34
320120,2019,13,3,12,28
320120,2020,21,6,9,36
320120,2021,15,4,7,26
320120,2022,11,2,5,18
320130,2015,51,3,29,83
320130,2016,33,8,34,75
320130,2017,50,15,35,100
320130,2018,47,10,23,80
320130,2019,46,10,33,89
320130,2020,48,12,22,82
320130,2021,50,13,18,81
320130,2022,37,1,24,62
320140,2015,3,1,2,6
320140,2016,1,1,1,3
320140,2017,5,0,1,6
320140,2018,4,2,3,9
320140,2019,6,1,0,7
320140,2020,4,2,1,7
320140,2021,3,1,0,4
320140,2022,0,1,0,1
320150,2015,11,0,11,22
320150,2016,8,1,5,14
320150,2017,12,1,5,18
320150,2018,12,6,4,22
320150,2019,9,3,6,18
320150,2020,8,1,1,10
320150,2021,16,2,7,25
320150,2022,8,7,2,17
320160,2015,1,0,2,3
320160,2016,2,0,5,7
320160,2017,2,1,1,4
320160,2019,1,0,0,1
320160,2021,1,0,0,1
320160,2022,1,2,0,3
320170,2015,0,0,1,1
320170,2017,1,0,0,1
320170,2018,1,0,0,1
320170,2019,2,0,1,3
320170,2021,1,0,0,1
320170,2022,1,0,1,2
320180,2017,1,0,0,1
320190,2015,1,0,0,1
320190,2017,1,1,0,2
320190,2018,1,0,1,2
320190,2019,1,1,3,5
320190,2020,0,2,0,2
320190,2021,3,0,0,3
320190,2022,2,0,0,2
320200,2018,1,0,0,1
320210,2018,2,0,1,3
320210,2019,1,0,1,2
320210,2020,0,0,1,1
320220,2015,0,0,3,3
320220,2017,2,0,1,3
320220,2018,1,1,0,2
320220,2019,2,0,0,2
320220,2020,1,0,0,1
320220,2022,2,0,0,2
320225,2015,2,0,0,2
320225,2016,1,0,0,1
320225,2017,2,0,0,2
320225,2018,2,0,1,3
320225,2020,1,0,0,1
320230,2017,0,0,1,1
320230,2019,1,0,0,1
320230,2021,0,1,0,1
320240,2015,6,0,2,8
320240,2016,1,2,3,6
320240,2017,12,2,1,15
320240,2018,6,1,8,15
320240,2019,9,6,5,20
320240,2020,2,2,3,7
320240,2021,2,1,2,5
320240,2022,12,2,2,16
320245,2015,1,0,0,1
320245,2016,1,0,0,1
320245,2017,1,1,0,2
320245,2018,0,0,1,1
320245,2019,1,0,0,1
320250,2016,1,0,1,2
320250,2017,0,0,4,4
320250,2018,1,1,1,3
320250,2019,0,1,0,1
320250,2020,1,0,1,2
320250,2021,1,0,1,2
320250,2022,2,1,0,3
320255,2015,0,0,1,1
320255,2017,0,0,1,1
320260,2015,1,0,1,2
320260,2016,1,0,0,1
320260,2017,1,0,1,2
320260,2018,1,0,0,1
320260,2019,4,0,0,4
320260,2020,0,0,1,1
320260,2021,3,0,1,4
320260,2022,1,0,0,1
320265,2016,1,0,1,2
320265,2017,0,0,2,2
320265,2018,0,0,1,1
320265,2021,0,1,1,2
320270,2016,0,1,0,1
320270,2017,1,0,0,1
320270,2019,1,0,0,1
320280,2015,0,0,1,1
320280,2017,1,0,1,2
320280,2019,1,0,1,2
320280,2020,2,0,0,2
320280,2022,1,1,0,2
320290,2016,1,0,0,1
320290,2017,0,0,1,1
320290,2018,1,0,0,1
320290,2020,1,0,0,1
320290,2021,2,0,0,2
320300,2015,3,0,1,4
320300,2019,2,0,1,3
320300,2020,1,0,0,1
320300,2022,0,0,1,1
320305,2015,1,0,0,1
320305,2016,2,0,0,2
320305,2017,1,0,1,2
320305,2018,2,0,0,2
320305,2020,2,0,2,4
320305,2022,1,0,0,1
320310,2016,2,0,0,2
320310,2017,1,0,1,2
320310,2018,1,0,0,1
320310,2019,0,0,1,1
320310,2021,1,0,0,1
320310,2022,1,0,0,1
320313,2015,2,0,1,3
320313,2016,0,0,3,3
320313,2017,0,0,2,2
320313,2019,0,1,0,1
320313,2020,2,1,0,3
320313,2021,3,0,2,5
320313,2022,3,0,1,4
320316,2022,1,0,0,1
320320,2015,13,2,12,27
320320,2016,22,0,17,39
320320,2017,26,4,20,50
320320,2018,24,10,24,58
320320,2019,37,4,9,50
320320,2020,24,4,13,41
320320,2021,21,9,6,36
320320,2022,21,2,5,28
320330,2015,1,0,0,1
320330,2018,0,0,1,1
320330,2019,1,0,0,1
320330,2020,1,0,0,1
320332,2015,1,0,1,2
320332,2017,1,0,1,2
320332,2018,1,0,1,2
320332,2019,0,0,1,1
320332,2020,3,1,0,4
320332,2021,1,0,1,2
320332,2022,1,0,0,1
320334,2015,0,0,1,1
320334,2016,2,0,0,2
320334,2018,1,0,1,2
320334,2021,0,1,0,1
320335,2015,2,2,1,5
320335,2016,1,1,0,2
320335,2017,1,0,0,1
320335,2019,0,0,4,4
320335,2021,0,2,0,2
320340,2016,2,0,0,2
320340,2017,5,0,0,5
320340,2018,2,0,0,2
320340,2019,1,0,0,1
320340,2020,2,0,1,3
320340,2022,2,0,0,2
320350,2015,2,0,0,2
320350,2016,1,0,0,1
320350,2017,3,0,0,3
320350,2018,1,1,0,2
320350,2019,0,0,1,1
320350,2020,0,1,0,1
320350,2021,1,0,0,1
320350,2022,1,1,0,2
320360,2021,2,0,0,2
320370,2015,0,0,2,2
320370,2016,2,0,0,2
320370,2017,1,0,0,1
320370,2018,3,0,0,3
320370,2019,1,0,0,1
320370,2020,1,0,0,1
320370,2022,0,1,0,1
320380,2015,1,0,1,2
320380,2016,0,1,1,2
320380,2017,1,0,0,1
320380,2018,1,0,0,1
320380,2022,2,0,0,2
320390,2015,5,0,1,6
320390,2016,8,0,1,9
320390,2017,3,0,3,6
320390,2018,4,1,1,6
320390,2019,1,3,1,5
320390,2020,2,0,0,2
320390,2021,1,0,1,2
320390,2022,0,1,0,1
320400,2016,2,2,1,5
320400,2022,2,0,0,2
320405,2015,3,0,1,4
320405,2016,1,0,0,1
320405,2017,2,0,0,2
320405,2018,1,0,1,2
320405,2019,2,0,0,2
320405,2020,0,0,1,1
320405,2021,0,1,0,1
320405,2022,1,2,0,3
320410,2016,1,0,1,2
320410,2017,1,0,2,3
320410,2018,2,0,0,2
320410,2019,2,0,0,2
320410,2022,1,0,0,1
320420,2016,1,0,0,1
320420,2017,2,0,0,2
320420,2020,1,0,1,2
320420,2021,1,0,0,1
320420,2022,2,1,0,3
320430,2015,1,0,0,1
320430,2017,1,1,1,3
320430,2021,0,0,1,1
320435,2015,1,0,1,2
320435,2016,1,0,0,1
320435,2017,1,0,2,3
320435,2018,5,0,2,7
320435,2019,5,0,0,5
320435,2021,3,0,1,4
320435,2022,1,0,1,2
320440,2016,4,0,0,4
320440,2017,1,0,0,1
320440,2019,0,0,1,1
320440,2021,2,0,1,3
320450,2017,1,0,0,1
320455,2015,0,1,1,2
320455,2016,4,0,1,5
320455,2017,1,2,1,4
320455,2018,2,0,1,3
320455,2019,1,1,3,5
320455,2020,0,0,1,1
320455,2021,1,1,0,2
320455,2022,0,0,1,1
320460,2016,0,1,0,1
320460,2017,1,0,1,2
320460,2018,0,2,0,2
320460,2019,0,0,1,1
320460,2020,1,0,0,1
320460,2021,3,0,0,3
320460,2022,2,0,0,2
320465,2016,1,0,0,1
320465,2019,1,0,0,1
320465,2020,1,0,0,1
320470,2015,1,0,0,1
320470,2016,2,0,0,2
320470,2017,2,1,1,4
320470,2018,0,1,1,2
320470,2019,4,3,0,7
320470,2020,3,1,0,4
320470,2021,1,0,0,1
320470,2022,0,1,1,2
320480,2016,0,0,1,1
320480,2019,0,0,1,1
320480,2020,1,0,0,1
320490,2015,13,2,4,19
320490,2016,12,2,7,21
320490,2017,13,1,9,23
320490,2018,11,1,3,15
320490,2019,10,0,4,14
320490,2020,3,0,6,9
320490,2021,4,0,3,7
320490,2022,7,5,1,13
320495,2015,2,0,0,2
320495,2016,0,0,2,2
320495,2018,3,0,0,3
320495,2019,0,2,0,2
320495,2020,0,0,2,2
320495,2022,0,1,0,1
320500,2015,66,12,47,125
320500,2016,54,20,34,108
320500,2017,69,15,33,117
320500,2018,52,24,16,92
320500,2019,60,18,34,112
320500,2020,60,15,36,111
320500,2021,52,25,30,107
320500,2022,44,22,37,103
320501,2015,0,0,1,1
320501,2016,1,2,3,6
320501,2017,2,0,2,4
320501,2018,2,0,3,5
320501,2019,1,0,0,1
320501,2020,2,0,2,4
320501,2021,1,0,0,1
320501,2022,0,0,2,2
320503,2017,1,0,1,2
320503,2018,0,0,3,3
320503,2019,1,0,1,2
320503,2022,0,0,1,1
320506,2015,0,0,1,1
320506,2016,1,0,1,2
320506,2017,2,0,1,3
320506,2018,4,1,1,6
320506,2019,2,1,1,4
320506,2020,0,0,1,1
320506,2022,2,0,0,2
320510,2015,2,0,1,3
320510,2016,3,0,5,8
320510,2017,9,2,8,19
320510,2018,5,1,6,12
320510,2019,5,0,3,8
320510,2020,4,0,1,5
320510,2021,5,0,5,10
320510,2022,5,0,1,6
320515,2016,1,0,0,1
320515,2021,2,0,0,2
320517,2019,1,0,1,2
320517,2021,1,0,0,1
320520,2015,49,9,30,88
320520,2016,59,5,30,94
320520,2017,107,12,31,150
320520,2018,71,10,25,106
320520,2019,60,23,23,106
320520,2020,53,14,16,83
320520,2021,51,13,12,76
320520,2022,62,10,19,91
320530,2015,58,4,13,75
320530,2016,74,13,12,99
320530,2017,64,32,21,117
320530,2018,56,15,13,84
320530,2019,43,13,14,70
320530,2020,33,11,14,58
320530,2021,56,12,10,78
320530,2022,25,16,10,51
330000,2015,4,1,0,5
330000,2016,8,1,1,10
330000,2017,6,2,2,10
330000,2018,3,1,0,4
330000,2019,4,3,0,7
330000,2020,0,1,0,1
330000,2021,7,0,0,7
330000,2022,0,3,0,3
330010,2015,21,4,15,40
330010,2016,17,1,9,27
330010,2017,17,3,9,29
330010,2018,15,3,4,22
330010,2019,11,2,6,19
330010,2020,17,3,8,28
330010,2021,16,4,4,24
330010,2022,9,2,7,18
330015,2015,1,0,0,1
330015,2016,1,0,1,2
330015,2018,3,0,1,4
330015,2019,0,0,1,1
330015,2020,1,0,0,1
330015,2022,0,1,0,1
330020,2015,6,2,5,13
330020,2016,12,2,3,17
330020,2017,9,2,4,15
330020,2018,19,4,0,23
330020,2019,5,4,4,13
330020,2020,4,1,2,7
330020,2021,5,2,0,7
330020,2022,0,1,2,3
330022,2015,0,0,3,3
330022,2016,3,0,1,4
330022,2017,0,1,1,2
330022,2018,1,0,0,1
330022,2019,3,0,1,4
330022,2020,3,0,1,4
330022,2021,3,0,0,3
330022,2022,1,0,0,1
330023,2015,0,0,1,1
330023,2016,0,1,0,1
330023,2017,3,2,2,7
330023,2018,3,1,0,4
330023,2019,2,0,1,3
330023,2020,0,0,1,1
330023,2021,1,0,1,2
330025,2015,3,0,2,5
330025,2017,3,0,0,3
330025,2018,1,2,0,3
330025,2019,1,0,1,2
330025,2020,4,1,0,5
330025,2021,1,0,1,2
330025,2022,2,0,1,3
330030,2015,5,0,5,10
330030,2016,6,2,6,14
330030,2017,6,2,4,12
330030,2018,10,1,1,12
330030,2019,7,2,13,22
330030,2020,5,2,2,9
330030,2021,3,0,4,7
330030,2022,10,2,5,17
330040,2015,12,1,20,33
330040,2016,23,0,10,33
330040,2017,18,9,15,42
330040,2018,29,10,14,53
330040,2019,26,5,4,35
330040,2020,10,1,10,21
330040,2021,29,3,7,39
330040,2022,15,4,10,29
330045,2015,16,3,15,34
330045,2016,19,1,25,45
330045,2017,29,4,27,60
330045,2018,28,4,24,56
330045,2019,20,2,19,41
330045,2020,24,1,13,38
330045,2021,11,2,14,27
330045,2022,18,2,12,32
330050,2015,0,1,2,3
330050,2016,4,0,1,5
330050,2017,0,1,0,1
330050,2018,2,0,2,4
330050,2019,1,0,0,1
330050,2020,1,0,1,2
330050,2021,1,0,0,1
330050,2022,2,0,0,2
330060,2015,3,1,1,5
330060,2016,0,1,1,2
330060,2018,1,0,0,1
330060,2019,3,0,2,5
330060,2020,2,0,0,2
330060,2021,2,2,1,5
330060,2022,0,3,1,4
330070,2015,10,0,6,16
330070,2016,13,3,6,22
330070,2017,10,4,5,19
330070,2018,15,0,3,18
330070,2019,7,4,6,17
330070,2020,12,4,4,20
330070,2021,4,3,7,14
330070,2022,6,4,4,14
330080,2015,0,0,1,1
330080,2016,2,0,3,5
330080,2017,1,0,1,2
330080,2018,1,0,0,1
330080,2019,2,2,0,4
330080,2021,1,0,0,1
330090,2016,1,0,0,1
330090,2017,1,0,0,1
330090,2018,1,0,0,1
330090,2019,0,0,2,2
330090,2020,0,1,0,1
330090,2022,1,1,0,2
330093,2017,0,0,2,2
330093,2018,1,0,0,1
330093,2019,0,0,1,1
330095,2015,0,0,1,1
330095,2016,1,0,0,1
330095,2018,1,0,1,2
330100,2015,40,2,16,58
330100,2016,48,10,38,96
330100,2017,82,21,43,146
330100,2018,66,18,29,113
330100,2019,63,14,36,113
330100,2020,43,13,20,76
330100,2021,43,11,18,72
330100,2022,43,6,17,66
330110,2015,1,0,1,2
330110,2016,2,1,1,4
330110,2017,3,2,1,6
330110,2018,4,0,0,4
330110,2020,1,0,0,1
330110,2021,1,0,0,1
330110,2022,0,1,1,2
330115,2016,0,0,1,1
330115,2018,1,1,0,2
330115,2021,0,0,2,2
330120,2017,1,0,0,1
330120,2018,2,0,1,3
330130,2015,1,0,0,1
330130,2016,0,0,2,2
330130,2017,2,2,1,5
330130,2018,1,0,0,1
330130,2019,0,0,1,1
330130,2020,2,0,1,3
330140,2015,1,0,2,3
330140,2016,3,0,0,3
330140,2017,0,0,1,1
330140,2018,2,0,0,2
330140,2019,2,0,0,2
330140,2020,1,0,0,1
330140,2021,0,0,1,1
330150,2015,1,0,0,1
330150,2017,3,2,2,7
330150,2018,1,0,1,2
330150,2019,3,1,1,5
330150,2020,4,0,0,4
330150,2022,2,0,0,2
330160,2018,1,0,0,1
330170,2015,47,9,45,101
330170,2016,75,12,58,145
330170,2017,79,10,45,134
330170,2018,74,18,42,134
330170,2019,60,16,40,116
330170,2020,57,8,31,96
330170,2021,29,19,34,82
330170,2022,41,8,28,77
330180,2019,1,0,0,1
330180,2021,0,1,0,1
330185,2015,4,2,2,8
330185,2017,2,1,1,4
330185,2018,3,1,0,4
330185,2019,0,0,2,2
330185,2020,4,0,0,4
330185,2021,2,0,0,2
330185,2022,2,0,0,2
330187,2015,2,0,0,2
330187,2017,3,0,1,4
330187,2018,1,0,1,2
330187,2019,1,0,2,3
330187,2020,2,0,0,2
330187,2021,0,2,0,2
330187,2022,1,0,0,1
330190,2015,9,1,6,16
330190,2016,12,5,8,25
330190,2017,12,3,10,25
330190,2018,12,4,4,20
330190,2019,15,1,7,23
330190,2020,5,0,8,13
330190,2021,8,0,8,16
330190,2022,10,4,6,20
330200,2015,9,0,8,17
330200,2016,8,0,6,14
330200,2017,12,3,11,26
330200,2018,10,1,5,16
330200,2019,8,3,7,18
330200,2020,13,2,9,24
330200,2021,6,1,3,10
330200,2022,5,2,6,13
330205,2018,2,0,0,2
330205,2022,1,0,0,1
330210,2015,0,1,4,5
330210,2017,1,0,1,2
330210,2018,3,0,2,5
330210,2019,3,0,0,3
330220,2015,7,3,0,10
330220,2016,7,0,0,7
330220,2017,5,0,4,9
330220,2018,7,4,6,17
330220,2019,10,2,5,17
330220,2020,9,2,4,15
330220,2021,2,2,2,6
330220,2022,15,3,4,22
330225,2015,1,0,3,4
330225,2016,2,0,1,3
330225,2017,3,1,1,5
330225,2018,2,0,4,6
330225,2019,7,1,0,8
330225,2020,2,0,0,2
330225,2021,4,1,2,7
330225,2022,5,3,1,9
330227,2015,4,0,1,5
330227,2016,1,0,1,2
330227,2017,4,3,2,9
330227,2018,2,0,0,2
330227,2019,3,0,1,4
330227,2020,2,1,0,3
330227,2021,5,0,0,5
330227,2022,1,0,3,4
330230,2015,0,0,1,1
330240,2015,28,2,24,54
330240,2016,20,1,19,40
330240,2017,24,4,21,49
330240,2018,22,5,9,36
330240,2019,22,3,16,41
330240,2020,22,5,8,35
330240,2021,14,2,11,27
330240,2022,18,3,7,28
330245,2016,1,0,0,1
330245,2019,1,0,1,2
330245,2020,0,0,1,1
330250,2015,10,1,4,15
330250,2016,11,0,7,18
330250,2017,15,0,6,21
330250,2018,7,2,4,13
330250,2019,5,2,1,8
330250,2020,4,2,4,10
330250,2021,8,3,2,13
330250,2022,7,0,1,8
330260,2015,2,1,0,3
330260,2016,1,0,1,2
330260,2017,0,2,5,7
330260,2018,0,2,0,2
330260,2019,1,1,1,3
330260,2020,2,0,0,2
330260,2021,3,1,2,6
330260,2022,0,1,1,2
330270,2015,4,3,12,19
330270,2016,10,0,1,11
330270,2017,12,1,12,25
330270,2018,10,2,4,16
330270,2019,6,0,2,8
330270,2020,3,2,6,11
330270,2021,6,0,4,10
330270,2022,6,2,4,12
330280,2018,0,0,1,1
330280,2021,1,0,0,1
330280,2022,1,0,0,1
330285,2015,5,1,3,9
330285,2016,5,1,3,9
330285,2017,12,0,6,18
330285,2018,11,1,6,18
330285,2019,9,0,7,16
330285,2020,11,2,0,13
330285,2021,9,3,5,17
330285,2022,17,2,9,28
330290,2015,2,0,0,2
330290,2017,0,0,1,1
330290,2018,1,0,1,2
330290,2019,1,0,0,1
330290,2020,1,3,1,5
330290,2021,1,2,1,4
330290,2022,2,0,1,3
330300,2017,0,1,0,1
330300,2018,3,0,0,3
330300,2019,1,0,1,2
330300,2020,1,0,1,2
330300,2021,0,1,0,1
330300,2022,1,0,2,3
330310,2015,1,0,0,1
330310,2016,0,0,1,1
330310,2017,2,0,0,2
330310,2018,1,0,0,1
330310,2019,1,0,0,1
330310,2020,1,0,0,1
330310,2021,2,0,0,2
330310,2022,0,2,0,2
330320,2015,7,3,5,15
330320,2016,11,2,5,18
330320,2017,11,1,7,19
330320,2018,11,5,5,21
330320,2019,12,4,8,24
330320,2020,6,5,3,14
330320,2021,11,3,5,19
330320,2022,11,4,8,23
330330,2015,73,17,32,122
330330,2016,105,22,41,168
330330,2017,72,24,42,138
330330,2018,57,20,26,103
330330,2019,64,15,21,100
330330,2020,46,16,11,73
330330,2021,37,20,19,76
330330,2022,46,16,18,80
330340,2015,7,3,7,17
330340,2016,9,1,9,19
330340,2017,21,5,8,34
330340,2018,10,2,6,18
330340,2019,7,6,3,16
330340,2020,1,2,0,3
330340,2021,9,2,2,13
330340,2022,11,3,7,21
330350,2015,31,5,27,63
330350,2016,33,7,18,58
330350,2017,51,13,36,100
330350,2018,36,11,16,63
330350,2019,36,10,21,67
330350,2020,32,12,15,59
330350,2021,35,8,22,65
330350,2022,51,13,27,91
330360,2015,1,0,1,2
330360,2016,0,1,0,1
330360,2017,0,0,1,1
330360,2019,2,1,2,5
330360,2020,1,0,1,2
330360,2021,1,0,0,1
330370,2015,5,0,0,5
330370,2016,4,3,3,10
330370,2017,4,1,2,7
330370,2018,3,3,0,6
330370,2019,3,0,0,3
330370,2020,3,0,1,4
330370,2021,1,0,1,2
330370,2022,1,0,0,1
330380,2015,1,1,1,3
330380,2016,6,1,0,7
330380,2017,4,2,0,6
330380,2018,2,1,2,5
330380,2019,2,1,0,3
330380,2021,1,1,2,4
330380,2022,3,1,2,6
330385,2015,1,0,0,1
330385,2017,0,1,0,1
330385,2020,1,0,0,1
330385,2021,0,2,1,3
330385,2022,0,0,1,1
330390,2015,31,6,15,52
330390,2016,39,10,23,72
330390,2017,37,12,21,70
330390,2018,31,14,21,66
330390,2019,29,10,12,51
330390,2020,11,4,8,23
330390,2021,12,3,7,22
330390,2022,7,6,4,17
330395,2015,1,0,1,2
330395,2016,2,0,2,4
330395,2017,1,0,0,1
330395,2018,1,0,2,3
330395,2019,0,2,0,2
330395,2021,1,1,0,2
330395,2022,2,0,0,2
330400,2015,1,0,2,3
330400,2016,1,0,2,3
330400,2017,1,0,2,3
330400,2018,0,0,1,1
330400,2019,1,1,2,4
330400,2022,0,0,1,1
330410,2015,1,0,0,1
330410,2016,0,1,0,1
330410,2017,0,1,0,1
330410,2019,1,0,0,1
330410,2021,0,0,3,3
330411,2015,3,0,2,5
330411,2016,3,1,4,8
330411,2017,3,0,2,5
330411,2018,2,2,1,5
330411,2019,2,1,2,5
330411,2020,1,0,1,2
330411,2021,6,0,1,7
330411,2022,6,2,2,10
330412,2015,3,0,0,3
330412,2016,1,0,1,2
330412,2017,0,0,1,1
330412,2018,1,0,0,1
330412,2019,1,0,1,2
330412,2020,0,0,1,1
330412,2021,1,0,0,1
330412,2022,2,0,1,3
330414,2015,6,3,2,11
330414,2016,2,3,5,10
330414,2017,4,1,2,7
330414,2018,6,0,2,8
330414,2019,3,3,1,7
330414,2020,3,4,3,10
330414,2021,6,1,3,10
330414,2022,4,2,3,9
330415,2015,1,1,0,2
330415,2018,1,0,0,1
330420,2015,10,2,12,24
330420,2016,8,2,8,18
330420,2017,14,1,6,21
330420,2018,14,3,6,23
330420,2019,11,2,8,21
330420,2020,9,3,2,14
330420,2021,16,3,2,21
330420,2022,9,3,6,18
330430,2015,1,0,3,4
330430,2016,4,0,3,7
330430,2017,5,1,1,7
330430,2018,0,0,4,4
330430,2020,2,0,1,3
330430,2021,3,1,2,6
330430,2022,1,0,0,1
330440,2015,2,0,4,6
330440,2016,9,1,2,12
330440,2017,4,0,3,7
330440,2018,4,0,1,5
330440,2019,1,0,2,3
330440,2020,4,0,2,6
330440,2021,3,2,1,6
330440,2022,3,1,1,5
330450,2021,1,0,0,1
330452,2015,2,1,4,7
330452,2016,11,2,5,18
330452,2017,7,4,4,15
330452,2018,5,1,5,11
330452,2019,5,2,1,8
330452,2020,6,1,2,9
330452,2021,3,0,4,7
330452,2022,7,3,1,11
330455,2015,476,121,272,869
330455,2016,591,135,338,1064
330455,2017,678,171,324,1173
330455,2018,658,180,305,1143
330455,2019,681,149,303,1133
330455,2020,494,159,232,885
330455,2021,459,172,227,858
330455,2022,485,175,237,897
330460,2022,1,0,0,1
330470,2015,1,1,3,5
330470,2016,1,0,2,3
330470,2017,0,1,1,2
330470,2018,4,2,0,6
330470,2019,2,1,0,3
330470,2020,1,1,0,2
330470,2021,2,0,2,4
330470,2022,1,0,1,2
330475,2015,0,0,1,1
330475,2016,1,0,2,3
330475,2017,1,0,0,1
330475,2018,0,1,1,2
330475,2019,1,0,2,3
330475,2020,1,0,0,1
330475,2022,2,0,0,2
330480,2015,1,0,2,3
330480,2016,1,1,2,4
330480,2017,3,2,0,5
330480,2018,1,1,1,3
330480,2019,5,2,3,10
330480,2020,4,1,1,6
330490,2015,37,8,33,78
330490,2016,37,6,32,75
330490,2017,39,5,35,79
330490,2018,24,5,18,47
330490,2019,24,2,16,42
330490,2020,17,8,19,44
330490,2021,15,6,19,40
330490,2022,10,8,15,33
330500,2015,0,0,2,2
330500,2016,3,0,0,3
330500,2018,3,0,0,3
330500,2019,4,2,0,6
330500,2020,1,0,0,1
330500,2021,3,0,0,3
330500,2022,0,1,0,1
330510,2015,15,2,12,29
330510,2016,12,2,14,28
330510,2017,10,1,8,19
330510,2018,13,2,11,26
330510,2019,11,4,10,25
330510,2020,9,2,6,17
330510,2021,9,6,5,20
330510,2022,11,2,13,26
330513,2016,0,1,0,1
330513,2017,1,0,0,1
330515,2015,0,0,1,1
330515,2016,1,0,1,2
330515,2018,0,1,1,2
330515,2019,1,1,0,2
330515,2020,2,1,0,3
330520,2015,3,0,1,4
330520,2016,1,0,2,3
330520,2017,1,1,0,2
330520,2018,1,0,3,4
330520,2019,2,2,0,4
330520,2021,3,1,1,5
330520,2022,2,0,1,3
330540,2016,0,0,2,2
330540,2017,1,0,0,1
330540,2019,2,0,1,3
330540,2020,1,1,0,2
330540,2021,2,0,0,2
330550,2015,1,0,2,3
330550,2016,3,0,7,10
330550,2017,1,0,2,3
330550,2018,0,0,2,2
330550,2019,4,0,0,4
330550,2020,1,0,0,1
330550,2022,1,0,1,2
330555,2015,0,1,1,2
330555,2016,1,0,2,3
330555,2017,3,0,1,4
330555,2018,1,0,0,1
330555,2019,1,0,0,1
330555,2020,3,1,0,4
330555,2022,1,1,0,2
330560,2018,0,0,1,1
330560,2019,0,0,1,1
330570,2015,1,0,0,1
330570,2017,1,0,0,1
330570,2019,0,1,0,1
330575,2015,2,0,1,3
330575,2017,2,0,2,4
330575,2018,0,0,1,1
330575,2019,1,0,0,1
330575,2020,1,0,0,1
330580,2015,2,1,1,4
330580,2016,4,2,4,10
330580,2017,3,4,7,14
330580,2018,3,0,10,13
330580,2019,11,1,1,13
330580,2020,11,1,6,18
330580,2021,4,0,1,5
330580,2022,12,1,4,17
330590,2021,0,1,0,1
330600,2015,4,0,3,7
330600,2016,4,1,1,6
330600,2017,7,3,3,13
330600,2018,3,0,2,5
330600,2019,0,0,2,2
330600,2020,4,0,1,5
330600,2021,3,1,1,5
330600,2022,0,0,1,1
330610,2015,1,0,0,1
330610,2016,2,0,1,3
330610,2017,0,1,0,1
330610,2018,2,1,0,3
330610,2019,2,0,1,3
330610,2021,2,0,1,3
330610,2022,2,0,1,3
330615,2016,1,0,0,1
330620,2016,0,0,1,1
330620,2017,1,0,0,1
330620,2019,1,0,0,1
330620,2020,0,0,1,1
330620,2021,1,0,0,1
330630,2015,19,3,18,40
330630,2016,30,4,18,52
330630,2017,25,6,8,39
330630,2018,35,6,19,60
330630,2019,17,2,16,35
330630,2020,6,2,6,14
330630,2021,9,3,5,17
330630,2022,11,9,7,27
350000,2015,45,10,10,65
350000,2016,43,19,10,72
350000,2017,71,15,5,91
350000,2018,56,9,5,70
350000,2019,54,14,4,72
350000,2020,45,14,0,59
350000,2021,44,10,0,54
350000,2022,20,16,0,36
350010,2015,1,0,0,1
350010,2016,5,1,3,9
350010,2017,6,3,2,11
350010,2018,7,1,2,10
350010,2019,5,0,3,8
350010,2020,10,0,2,12
350010,2021,1,0,0,1
350010,2022,2,2,2,6
350020,2017,1,0,0,1
350030,2016,2,0,1,3
350030,2017,3,0,1,4
350030,2018,4,2,2,8
350030,2019,2,0,2,4
350030,2020,1,1,0,2
350030,2021,4,0,1,5
350030,2022,4,0,1,5
350040,2015,0,0,4,4
350040,2018,1,0,3,4
350040,2019,0,0,1,1
350040,2020,1,0,0,1
350040,2022,1,0,0,1
350050,2015,2,1,0,3
350050,2016,5,0,0,5
350050,2017,0,0,1,1
350050,2018,3,0,0,3
350050,2019,2,1,1,4
350050,2020,1,0,0,1
350050,2021,2,1,0,3
350055,2016,0,0,1,1
350055,2017,0,1,1,2
350055,2018,1,0,0,1
350055,2019,0,0,1,1
350055,2022,0,0,1,1
350060,2020,2,0,0,2
350060,2021,0,1,0,1
350070,2015,4,2,3,9
350070,2016,3,0,2,5
350070,2017,2,0,3,5
350070,2018,2,1,1,4
350070,2019,3,0,4,7
350070,2020,2,0,1,3
350070,2021,2,0,1,3
350070,2022,5,0,1,6
350075,2019,0,0,1,1
350075,2022,0,0,1,1
350080,2019,1,0,0,1
350080,2021,0,1,0,1
350080,2022,0,0,3,3
350090,2015,0,0,1,1
350090,2017,0,0,1,1
350090,2018,0,0,1,1
350090,2019,1,0,0,1
350090,2022,0,0,1,1
350100,2015,0,0,1,1
350100,2018,1,0,0,1
350100,2020,3,0,0,3
350100,2021,0,0,3,3
350100,2022,1,0,0,1
350110,2015,1,0,0,1
350110,2021,0,0,1,1
350110,2022,1,0,0,1
350115,2015,1,0,4,5
350115,2016,0,0,1,1
350115,2017,4,2,1,7
350115,2018,3,0,5,8
350115,2019,4,0,2,6
350115,2020,2,0,2,4
350115,2021,3,1,0,4
350130,2015,1,1,2,4
350130,2016,3,0,0,3
350130,2017,0,0,1,1
350130,2018,1,1,0,2
350130,2019,1,0,0,1
350130,2020,1,2,1,4
350130,2021,1,0,0,1
350130,2022,6,2,0,8
350150,2017,1,0,0,1
350160,2015,53,8,25,86
350160,2016,48,16,26,90
350160,2017,77,9,36,122
350160,2018,82,10,26,118
350160,2019,78,7,31,116
350160,2020,74,12,40,126
350160,2021,74,10,27,111
350160,2022,64,18,24,106
350170,2015,3,0,6,9
350170,2016,3,2,5,10
350170,2017,4,2,7,13
350170,2018,8,1,1,10
350170,2019,6,0,4,10
350170,2020,4,1,3,8
350170,2021,3,0,2,5
350170,2022,3,1,3,7
350180,2016,0,0,1,1
350180,2018,0,1,0,1
350180,2019,0,0,2,2
350190,2015,5,2,4,11
350190,2016,2,0,2,4
350190,2017,6,2,4,12
350190,2018,10,2,4,16
350190,2019,12,2,2,16
350190,2020,2,3,2,7
350190,2021,11,3,7,21
350190,2022,9,2,10,21
350200,2015,1,0,0,1
350200,2017,1,0,0,1
350200,2020,0,1,0,1
350200,2021,0,0,1,1
350200,2022,1,0,0,1
350210,2015,2,0,0,2
350210,2016,2,0,4,6
350210,2017,7,1,4,12
350210,2018,7,1,1,9
350210,2019,3,0,2,5
350210,2020,1,0,2,3
350210,2021,1,0,2,3
350210,2022,3,0,1,4
350220,2016,1,0,0,1
350220,2017,0,1,0,1
350220,2018,2,0,0,2
350220,2019,0,0,1,1
350220,2020,0,1,0,1
350220,2021,0,0,1,1
350220,2022,2,0,0,2
350230,2017,1,0,0,1
350230,2018,1,0,1,2
350230,2022,0,0,1,1
350240,2020,0,1,1,2
350250,2015,0,0,1,1
350250,2016,2,0,2,4
350250,2017,3,0,5,8
350250,2018,4,0,2,6
350250,2019,1,0,3,4
350250,2021,1,0,0,1
350250,2022,2,0,0,2
350260,2016,1,0,0,1
350270,2015,0,1,0,1
350270,2017,1,0,0,1
350270,2018,0,1,0,1
350270,2021,0,0,1,1
350270,2022,1,0,0,1
350275,2016,0,0,1,1
350275,2017,2,0,4,6
350275,2018,1,0,0,1
350275,2019,2,0,1,3
350275,2020,2,0,1,3
350275,2021,1,1,2,4
350275,2022,1,0,1,2
350280,2015,15,5,8,28
350280,2016,7,3,4,14
350280,2017,17,0,7,24
350280,2018,17,1,7,25
350280,2019,21,4,10,35
350280,2020,7,3,4,14
350280,2021,19,1,8,28
350280,2022,6,3,7,16
350290,2016,1,0,0,1
350290,2017,5,0,0,5
350290,2018,1,1,3,5
350290,2019,2,0,0,2
350290,2020,1,0,1,2
350290,2021,0,0,2,2
350290,2022,7,0,1,8
350300,2015,2,0,1,3
350300,2016,1,0,2,3
350300,2017,1,2,0,3
350300,2019,1,0,1,2
350300,2021,0,1,0,1
350300,2022,1,0,0,1
350310,2019,0,1,0,1
350310,2022,0,1,0,1
350320,2015,22,7,5,34
350320,2016,27,3,16,46
350320,2017,32,3,14,49
350320,2018,18,13,8,39
350320,2019,26,6,15,47
350320,2020,11,5,10,26
350320,2021,12,4,6,22
350320,2022,32,7,11,50
350330,2015,5,1,2,8
350330,2016,9,3,8,20
350330,2017,26,2,12,40
350330,2018,17,3,15,35
350330,2019,18,4,12,34
350330,2020,13,1,9,23
350330,2021,28,4,12,44
350330,2022,16,2,6,24
350340,2015,1,0,0,1
350340,2016,1,0,0,1
350350,2021,1,0,0,1
350360,2015,0,0,1,1
350360,2016,0,0,2,2
350360,2017,0,0,1,1
350360,2018,1,0,1,2
350360,2020,2,0,0,2
350360,2021,1,0,1,2
350370,2015,1,0,0,1
350370,2016,1,0,3,4
350370,2017,0,0,2,2
350370,2018,1,0,1,2
350370,2019,1,0,1,2
350370,2020,0,0,1,1
350370,2021,1,1,0,2
350380,2015,3,2,3,8
350380,2016,2,1,3,6
350380,2017,4,0,1,5
350380,2018,6,1,4,11
350380,2019,4,2,3,9
350380,2020,5,0,1,6
350380,2021,3,1,4,8
350380,2022,2,0,2,4
350390,2015,6,1,4,11
350390,2016,11,2,7,20
350390,2017,11,6,9,26
350390,2018,8,6,7,21
350390,2019,8,1,7,16
350390,2020,8,4,1,13
350390,2021,11,3,9,23
350390,2022,7,2,9,18
350400,2015,5,2,6,13
350400,2016,7,2,2,11
350400,2017,4,1,2,7
350400,2018,9,0,2,11
350400,2019,6,3,8,17
350400,2020,5,1,7,13
350400,2021,6,0,2,8
350400,2022,6,3,1,10
350410,2015,25,7,12,44
350410,2016,22,3,15,40
350410,2017,39,6,25,70
350410,2018,20,6,15,41
350410,2019,31,6,12,49
350410,2020,27,8,9,44
350410,2021,27,13,12,52
350410,2022,22,9,12,43
350420,2015,1,0,0,1
350420,2017,4,0,1,5
350420,2018,1,0,0,1
350420,2019,2,1,0,3
350420,2020,2,0,1,3
350420,2022,2,0,0,2
350430,2021,0,0,1,1
350440,2015,1,0,2,3
350440,2017,0,0,1,1
350440,2018,1,0,0,1
350450,2015,2,0,3,5
350450,2016,0,1,3,4
350450,2017,10,3,6,19
350450,2018,0,2,0,2
350450,2019,3,0,0,3
350450,2020,4,0,0,4
350450,2021,3,4,0,7
350450,2022,4,0,1,5
350460,2015,2,0,0,2
350460,2016,4,1,1,6
350460,2017,2,1,2,5
350460,2019,0,0,2,2
350460,2020,1,0,1,2
350460,2021,1,0,1,2
350460,2022,1,0,4,5
350480,2017,3,0,0,3
350480,2018,4,0,0,4
350480,2019,2,1,0,3
350480,2020,1,0,0,1
350490,2015,0,0,1,1
350490,2018,1,1,0,2
350500,2016,0,0,1,1
350510,2017,0,1,1,2
350520,2015,1,1,0,2
350520,2016,3,0,0,3
350520,2017,4,1,1,6
350520,2019,1,1,1,3
350520,2021,3,0,0,3
350520,2022,4,1,0,5
350530,2016,2,0,2,4
350530,2017,0,0,1,1
350530,2018,3,0,0,3
350530,2019,4,2,4,10
350530,2020,6,1,3,10
350530,2021,3,0,2,5
350530,2022,1,0,2,3
350540,2019,0,0,1,1
350540,2020,0,0,1,1
350540,2022,0,0,1,1
350550,2015,6,0,2,8
350550,2016,4,3,10,17
350550,2017,13,1,3,17
350550,2018,15,1,4,20
350550,2019,20,2,7,29
350550,2020,7,1,5,13
350550,2021,18,3,2,23
350550,2022,8,0,4,12
350560,2015,2,1,5,8
350560,2016,3,0,2,5
350560,2017,4,0,4,8
350560,2018,1,0,1,2
350560,2019,1,0,0,1
350560,2020,1,0,1,2
350560,2021,0,0,2,2
350560,2022,1,3,2,6
350570,2015,78,18,52,148
350570,2016,135,26,73,234
350570,2017,164,28,83,275
350570,2018,145,32,60,237
350570,2019,127,25,63,215
350570,2020,111,24,52,187
350570,2021,108,25,31,164
350570,2022,114,34,40,188
350580,2020,0,1,1,2
350590,2015,7,1,0,8
350590,2016,2,0,0,2
350590,2017,0,2,2,4
350590,2018,3,1,1,5
350590,2019,4,3,1,8
350590,2020,2,0,0,2
350590,2021,2,0,0,2
350590,2022,3,0,0,3
350600,2015,53,6,23,82
350600,2016,42,8,11,61
350600,2017,36,8,8,52
350600,2018,28,7,9,44
350600,2019,45,9,23,77
350600,2020,22,7,6,35
350600,2021,37,8,13,58
350600,2022,30,9,12,51
350610,2015,3,1,1,5
350610,2016,0,0,3,3
350610,2017,16,3,10,29
350610,2018,15,4,1,20
350610,2019,10,3,2,15
350610,2020,5,1,1,7
350610,2021,5,4,1,10
350610,2022,4,1,4,9
350620,2016,0,0,1,1
350620,2017,1,0,0,1
350620,2018,1,0,1,2
350620,2019,0,1,0,1
350630,2020,1,0,0,1
350635,2015,0,0,2,2
350635,2016,3,0,1,4
350635,2017,4,2,3,9
350635,2018,5,0,2,7
350635,2019,5,0,3,8
350635,2020,0,1,3,4
350635,2021,1,0,3,4
350635,2022,0,2,2,4
350640,2016,0,0,1,1
350640,2019,0,0,1,1
350640,2022,2,0,0,2
350650,2015,0,1,0,1
350650,2016,5,1,0,6
350650,2017,5,2,5,12
350650,2018,3,2,2,7
350650,2019,8,0,7,15
350650,2020,3,2,6,11
350650,2021,7,1,2,10
350650,2022,9,2,2,13
350660,2015,1,0,1,2
350660,2016,1,0,0,1
350660,2017,0,1,0,1
350660,2018,1,0,2,3
350660,2019,4,1,0,5
350660,2020,1,0,0,1
350660,2021,2,0,0,2
350660,2022,1,0,1,2
350670,2016,1,0,0,1
350670,2017,0,1,0,1
350670,2018,0,0,1,1
350670,2021,0,0,1,1
350670,2022,0,1,0,1
350680,2015,0,0,1,1
350680,2016,1,0,0,1
350680,2019,0,0,2,2
350680,2020,0,2,0,2
350690,2018,2,0,0,2
350690,2020,1,0,1,2
350690,2021,2,1,1,4
350700,2015,8,1,8,17
350700,2016,16,0,3,19
350700,2017,12,1,4,17
350700,2018,2,4,6,12
350700,2019,10,0,4,14
350700,2020,4,2,1,7
350700,2021,4,1,2,7
350700,2022,5,1,1,7
350710,2015,1,0,3,4
350710,2016,0,0,2,2
350710,2017,2,0,0,2
350710,2018,1,1,0,2
350710,2019,3,0,1,4
350710,2020,1,1,1,3
350710,2021,0,1,0,1
350720,2019,1,0,1,2
350730,2021,0,0,1,1
350740,2015,2,0,0,2
350740,2016,2,0,0,2
350740,2017,1,0,1,2
350740,2018,1,0,0,1
350740,2020,0,1,0,1
350740,2022,2,0,0,2
350750,2015,19,2,8,29
350750,2016,18,2,11,31
350750,2017,12,3,12,27
350750,2018,14,3,9,26
350750,2019,24,6,7,37
350750,2020,15,3,10,28
350750,2021,15,7,7,29
350750,2022,13,0,2,15
350760,2015,28,7,12,47
350760,2016,40,6,22,68
350760,2017,26,9,13,48
350760,2018,29,6,18,53
350760,2019,23,8,14,45
350760,2020,16,4,4,24
350760,2021,17,6,9,32
350760,2022,22,2,6,30
350775,2022,1,0,0,1
350780,2015,0,0,3,3
350780,2016,0,0,1,1
350780,2017,4,1,0,5
350780,2018,3,0,0,3
350780,2019,2,0,0,2
350780,2020,2,0,1,3
350780,2021,2,0,0,2
350780,2022,2,0,0,2
350790,2015,2,0,2,4
350790,2016,1,0,0,1
350790,2017,0,1,0,1
350790,2018,4,1,1,6
350790,2019,1,0,0,1
350790,2020,1,0,0,1
350790,2021,1,1,1,3
350790,2022,1,0,3,4
350800,2016,1,0,0,1
350800,2019,1,0,0,1
350810,2015,0,0,2,2
350810,2018,1,0,2,3
350810,2020,1,0,0,1
350810,2021,3,1,0,4
350820,2016,3,0,3,6
350820,2018,0,0,1,1
350820,2019,1,0,2,3
350830,2016,0,0,1,1
350830,2017,0,0,1,1
350840,2015,11,1,7,19
350840,2016,9,0,4,13
350840,2017,4,1,10,15
350840,2018,4,3,3,10
350840,2019,2,2,2,6
350840,2020,6,0,4,10
350840,2021,3,2,4,9
350840,2022,1,0,4,5
350850,2015,11,0,5,16
350850,2016,13,2,10,25
350850,2017,13,0,6,19
350850,2018,12,1,13,26
350850,2019,15,3,7,25
350850,2020,9,2,4,15
350850,2021,17,0,11,28
350850,2022,9,5,2,16
350860,2015,1,0,1,2
350860,2016,3,0,3,6
350860,2017,6,0,1,7
350860,2018,2,0,2,4
350860,2019,4,1,2,7
350860,2020,3,1,0,4
350860,2021,1,0,1,2
350860,2022,2,1,0,3
350870,2016,2,0,0,2
350870,2017,4,0,0,4
350870,2019,2,1,0,3
350870,2021,1,0,0,1
350870,2022,1,0,0,1
350880,2016,1,0,0,1
350880,2017,0,1,0,1
350880,2019,1,0,0,1
350880,2020,1,0,0,1
350880,2021,2,0,0,2
350880,2022,4,1,0,5
350900,2015,9,3,8,20
350900,2016,14,6,9,29
350900,2017,19,3,5,27
350900,2018,17,5,12,34
350900,2019,10,4,8,22
350900,2020,9,1,6,16
350900,2021,10,5,4,19
350900,2022,9,2,3,14
350910,2016,1,0,0,1
350910,2018,0,0,1,1
350910,2019,0,1,0,1
350920,2015,15,1,7,23
350920,2016,14,2,5,21
350920,2017,21,4,11,36
350920,2018,13,3,17,33
350920,2019,16,2,11,29
350920,2020,14,4,5,23
350920,2021,6,4,8,18
350920,2022,8,2,6,16
350925,2015,1,0,0,1
350925,2016,2,0,0,2
350925,2017,2,0,0,2
350925,2018,2,0,0,2
350925,2019,3,0,1,4
350925,2020,6,1,2,9
350925,2021,1,0,2,3
350925,2022,1,0,0,1
350930,2015,2,0,0,2
350930,2016,0,0,1,1
350930,2017,1,0,0,1
350930,2018,2,0,1,3
350930,2019,2,0,1,3
350930,2021,1,0,0,1
350940,2015,1,0,2,3
350940,2016,1,0,5,6
350940,2017,0,2,1,3
350940,2018,4,0,0,4
350940,2019,1,0,5,6
350940,2020,2,0,1,3
350940,2021,3,0,0,3
350940,2022,4,0,0,4
350945,2015,1,0,1,2
350945,2016,3,0,0,3
350945,2017,1,0,2,3
350945,2018,2,0,1,3
350945,2019,2,0,0,2
350945,2020,2,0,0,2
350945,2021,0,1,1,2
350945,2022,2,0,1,3
350950,2015,155,25,82,262
350950,2016,159,35,69,263
350950,2017,252,60,111,423
350950,2018,223,47,119,389
350950,2019,243,62,95,400
350950,2020,187,55,81,323
350950,2021,166,54,69,289
350950,2022,164,46,86,296
350960,2015,4,1,15,20
350960,2016,12,2,4,18
350960,2017,10,4,10,24
350960,2018,17,0,15,32
350960,2019,8,0,11,19
350960,2020,8,2,5,15
350960,2021,7,1,12,20
350960,2022,9,0,6,15
350970,2015,2,0,0,2
350970,2017,2,0,1,3
350970,2018,1,0,0,1
350970,2019,2,0,0,2
350970,2020,0,1,0,1
350970,2021,1,1,1,3
350970,2022,1,0,0,1
350980,2017,1,0,0,1
350990,2016,1,0,1,2
350990,2017,1,0,0,1
350990,2019,2,0,1,3
350995,2018,0,0,1,1
350995,2019,0,0,1,1
350995,2022,0,1,0,1
351000,2015,0,1,2,3
351000,2017,1,1,2,4
351000,2018,1,0,0,1
351000,2019,3,0,3,6
351000,2020,3,0,0,3
351000,2021,2,1,0,3
351000,2022,2,1,0,3
351015,2016,1,0,0,1
351015,2017,0,0,1,1
351015,2019,0,0,1,1
351015,2022,0,0,1,1
351020,2016,1,0,0,1
351020,2017,3,0,0,3
351020,2018,2,0,0,2
351020,2019,1,3,1,5
351020,2020,0,1,0,1
351020,2021,4,0,0,4
351020,2022,0,0,2,2
351030,2015,1,0,0,1
351030,2017,0,0,1,1
351030,2018,0,0,1,1
351030,2020,1,0,0,1
351030,2021,1,0,0,1
351040,2015,5,3,7,15
351040,2016,11,5,5,21
351040,2017,11,4,11,26
351040,2018,13,3,9,25
351040,2019,11,2,9,22
351040,2020,6,1,5,12
351040,2021,6,1,7,14
351040,2022,6,0,7,13
351050,2015,21,3,12,36
351050,2016,9,4,5,18
351050,2017,15,4,13,32
351050,2018,7,2,4,13
351050,2019,12,3,5,20
351050,2020,14,1,2,17
351050,2021,11,5,1,17
351050,2022,9,7,5,21
351060,2015,34,12,38,84
351060,2016,44,3,29,76
351060,2017,56,10,38,104
351060,2018,30,9,26,65
351060,2019,32,9,25,66
351060,2020,42,10,25,77
351060,2021,46,16,29,91
351060,2022,32,12,27,71
351070,2017,1,0,0,1
351070,2018,1,0,2,3
351070,2019,1,0,0,1
351070,2020,0,0,1,1
351080,2015,0,0,1,1
351080,2016,0,0,1,1
351080,2017,1,1,1,3
351080,2018,2,0,0,2
351080,2019,2,1,1,4
351080,2020,4,0,1,5
351080,2021,1,1,0,2
351080,2022,2,1,1,4
351100,2015,0,0,1,1
351100,2016,0,0,3,3
351100,2017,0,1,0,1
351100,2018,0,0,2,2
351100,2019,0,0,1,1
351100,2020,0,0,1,1
351100,2021,0,0,1,1
351110,2015,7,2,3,12
351110,2016,13,0,6,19
351110,2017,12,1,4,17
351110,2018,11,2,5,18
351110,2019,10,1,2,13
351110,2020,13,4,3,20
351110,2021,5,6,4,15
351110,2022,8,3,3,14
351120,2015,1,0,0,1
351120,2016,1,0,0,1
351120,2022,0,0,1,1
351130,2015,0,0,1,1
351130,2017,0,0,1,1
351130,2018,2,0,0,2
351130,2019,1,0,0,1
351130,2020,3,0,0,3
351130,2021,0,0,1,1
351140,2016,0,1,0,1
351140,2017,0,0,1,1
351140,2018,1,0,0,1
351140,2019,1,0,0,1
351140,2021,0,0,1,1
351150,2015,4,0,5,9
351150,2016,8,0,7,15
351150,2017,6,1,2,9
351150,2018,4,2,3,9
351150,2019,3,1,4,8
351150,2020,8,0,2,10
351150,2021,7,1,3,11
351150,2022,8,1,4,13
351160,2015,1,0,0,1
351160,2016,2,0,0,2
351160,2017,1,0,0,1
351160,2018,1,0,0,1
351160,2019,0,0,1,1
351160,2020,2,0,1,3
351160,2021,1,1,0,2
351160,2022,0,0,1,1
351170,2015,2,0,2,4
351170,2016,2,0,2,4
351170,2017,2,1,3,6
351170,2018,1,0,3,4
351170,2019,3,1,1,5
351170,2020,0,0,2,2
351170,2021,3,0,4,7
351170,2022,4,1,2,7
351190,2016,1,0,0,1
351190,2018,1,0,0,1
351190,2020,1,0,0,1
351190,2022,0,0,1,1
351200,2015,1,0,2,3
351200,2017,2,0,0,2
351200,2018,0,0,2,2
351200,2019,0,1,0,1
351200,2020,1,1,0,2
351210,2016,1,0,0,1
351210,2017,0,0,1,1
351210,2018,1,0,0,1
351210,2020,0,0,1,1
351210,2021,1,0,0,1
351220,2015,0,0,1,1
351220,2016,0,0,1,1
351220,2017,0,0,3,3
351220,2018,0,0,1,1
351220,2019,1,0,3,4
351220,2020,1,0,1,2
351220,2021,4,0,0,4
351230,2016,1,0,0,1
351230,2017,1,0,0,1
351230,2018,0,0,1,1
351230,2019,0,1,0,1
351230,2020,1,0,0,1
351230,2022,1,0,0,1
351240,2015,2,1,1,4
351240,2016,1,1,0,2
351240,2017,2,0,1,3
351240,2018,7,1,1,9
351240,2019,3,1,1,5
351240,2020,2,0,1,3
351240,2021,2,1,1,4
351240,2022,6,1,1,8
351250,2017,0,1,0,1
351250,2019,2,0,0,2
351270,2017,0,0,1,1
351270,2018,0,0,1,1
351270,2019,0,0,1,1
351270,2020,1,0,0,1
351270,2022,1,2,1,4
351280,2015,7,1,3,11
351280,2016,4,1,2,7
351280,2017,7,3,2,12
351280,2018,3,4,2,9
351280,2019,3,2,3,8
351280,2020,6,2,2,10
351280,2021,3,5,2,10
351280,2022,1,1,1,3
351290,2018,1,1,0,2
351290,2019,0,2,0,2
351290,2020,2,0,0,2
351290,2021,1,0,0,1
351300,2015,24,3,17,44
351300,2016,25,10,25,60
351300,2017,35,7,11,53
351300,2018,25,4,19,48
351300,2019,36,6,10,52
351300,2020,25,10,14,49
351300,2021,23,2,7,32
351300,2022,32,7,14,53
351310,2015,1,0,1,2
351310,2016,3,0,0,3
351310,2017,6,0,3,9
351310,2018,1,0,1,2
351310,2019,3,3,1,7
351310,2020,1,0,0,1
351310,2021,5,1,0,6
351310,2022,3,0,0,3
351320,2015,0,0,1,1
351320,2016,0,0,1,1
351320,2018,1,0,0,1
351320,2022,1,0,0,1
351330,2015,1,0,0,1
351340,2015,7,0,8,15
351340,2016,5,0,0,5
351340,2017,3,1,4,8
351340,2018,2,0,4,6
351340,2019,2,0,3,5
351340,2020,3,2,1,6
351340,2021,1,0,3,4
351340,2022,5,1,2,8
351350,2015,5,0,5,10
351350,2016,5,0,2,7
351350,2017,13,4,11,28
351350,2018,8,0,1,9
351350,2019,17,3,11,31
351350,2020,10,1,5,16
351350,2021,12,1,7,20
351350,2022,12,0,9,21
351360,2018,0,1,0,1
351360,2022,0,0,1,1
351370,2015,6,2,1,9
351370,2016,3,0,2,5
351370,2017,2,0,2,4
351370,2018,2,0,1,3
351370,2019,6,1,0,7
351370,2020,3,1,2,6
351370,2021,3,1,1,5
351370,2022,6,0,0,6
351380,2015,33,5,30,68
351380,2016,39,7,30,76
351380,2017,73,23,41,137
351380,2018,59,16,38,113
351380,2019,49,15,36,100
351380,2020,55,21,38,114
351380,2021,61,12,31,104
351380,2022,30,9,25,64
351385,2016,0,0,1,1
351390,2017,0,1,0,1
351390,2020,1,0,0,1
351400,2016,2,0,0,2
351400,2017,1,1,1,3
351400,2018,0,0,2,2
351400,2020,3,0,2,5
351400,2021,0,0,6,6
351400,2022,0,0,2,2
351410,2015,0,1,0,1
351410,2016,3,0,0,3
351410,2018,3,0,0,3
351410,2019,1,0,1,2
351410,2020,2,0,2,4
351410,2021,0,3,0,3
351410,2022,2,0,0,2
351430,2017,0,0,1,1
351430,2018,0,0,3,3
351430,2019,0,0,1,1
351430,2021,0,0,1,1
351430,2022,1,1,0,2
351440,2015,6,0,1,7
351440,2016,1,1,0,2
351440,2017,3,2,1,6
351440,2018,3,1,0,4
351440,2019,3,0,1,4
351440,2020,2,1,0,3
351440,2021,3,3,0,6
351450,2015,0,0,2,2
351450,2016,1,0,0,1
351450,2017,1,0,0,1
351450,2019,0,1,0,1
351450,2022,1,0,0,1
351460,2016,2,0,0,2
351460,2017,1,1,3,5
351460,2018,1,0,0,1
351460,2019,2,0,0,2
351460,2022,1,0,0,1
351470,2021,1,0,0,1
351480,2016,0,0,1,1
351480,2022,1,0,0,1
351490,2015,3,0,3,6
351490,2016,1,0,1,2
351490,2017,2,0,2,4
351490,2018,7,0,0,7
351490,2019,0,0,2,2
351490,2020,2,0,0,2
351490,2022,0,0,1,1
351492,2019,0,0,1,1
351492,2021,2,0,0,2
351495,2018,1,0,0,1
351495,2019,1,0,0,1
351495,2020,1,0,0,1
351495,2022,1,0,0,1
351500,2015,10,2,8,20
351500,2016,39,3,13,55
351500,2017,29,5,17,51
351500,2018,25,4,20,49
351500,2019,20,6,8,34
351500,2020,18,5,16,39
351500,2021,23,6,10,39
351500,2022,15,5,6,26
351510,2015,2,0,3,5
351510,2016,0,0,4,4
351510,2017,2,2,2,6
351510,2018,0,0,1,1
351510,2019,3,0,1,4
351510,2020,2,0,0,2
351510,2021,0,0,1,1
351510,2022,2,1,3,6
351512,2017,1,0,1,2
351512,2018,0,0,1,1
351515,2015,0,2,0,2
351515,2016,3,0,1,4
351515,2018,2,0,2,4
351515,2019,2,0,1,3
351515,2020,0,0,2,2
351515,2021,1,1,1,3
351518,2015,9,0,4,13
351518,2016,15,0,9,24
351518,2017,8,0,7,15
351518,2018,7,5,7,19
351518,2019,8,0,4,12
351518,2020,6,1,2,9
351518,2021,5,1,3,9
351518,2022,2,1,9,12
351520,2016,2,0,0,2
351520,2017,2,0,1,3
351520,2019,2,0,0,2
351520,2020,0,0,1,1
351520,2021,0,0,1,1
351520,2022,0,0,1,1
351530,2020,0,0,2,2
351530,2022,0,0,1,1
351535,2016,0,1,0,1
351535,2017,1,0,0,1
351550,2015,2,1,2,5
351550,2016,2,1,2,5
351550,2017,7,2,7,16
351550,2018,13,2,3,18
351550,2019,9,2,10,21
351550,2020,2,7,2,11
351550,2021,9,0,3,12
351550,2022,5,1,0,6
351560,2015,0,0,1,1
351560,2020,1,0,0,1
351570,2015,14,2,7,23
351570,2016,16,1,8,25
351570,2017,17,5,10,32
351570,2018,12,0,8,20
351570,2019,17,5,12,34
351570,2020,16,2,9,27
351570,2021,21,6,6,33
351570,2022,10,5,7,22
351590,2021,2,0,0,2
351590,2022,1,0,0,1
351600,2016,0,0,2,2
351600,2018,1,0,2,3
351600,2019,1,0,0,1
351600,2020,1,0,0,1
351600,2021,0,0,1,1
351600,2022,1,2,0,3
351620,2015,19,5,11,35
351620,2016,24,5,27,56
351620,2017,24,7,8,39
351620,2018,34,4,9,47
351620,2019,17,7,9,33
351620,2020,12,4,7,23
351620,2021,20,2,6,28
351620,2022,14,2,9,25
351630,2015,9,0,13,22
351630,2016,10,4,14,28
351630,2017,24,4,21,49
351630,2018,15,6,15,36
351630,2019,11,4,5,20
351630,2020,11,1,7,19
351630,2021,12,4,7,23
351630,2022,8,2,11,21
351640,2015,6,1,9,16
351640,2016,9,1,11,21
351640,2017,28,0,15,43
351640,2018,11,4,8,23
351640,2019,12,2,7,21
351640,2020,10,0,4,14
351640,2021,10,4,10,24
351640,2022,2,2,10,14
351660,2016,1,0,0,1
351670,2015,1,0,0,1
351670,2017,1,1,2,4
351670,2018,2,1,1,4
351670,2019,3,0,0,3
351670,2020,4,0,0,4
351670,2021,1,0,1,2
351670,2022,1,0,0,1
351680,2015,1,0,0,1
351680,2016,1,0,0,1
351680,2018,1,0,0,1
351680,2019,1,0,0,1
351680,2021,0,0,1,1
351685,2017,2,0,0,2
351685,2018,1,0,0,1
351685,2019,1,0,0,1
351685,2022,0,1,0,1
351690,2019,0,0,1,1
351690,2021,1,0,1,2
351700,2015,1,0,1,2
351700,2016,1,0,0,1
351700,2017,0,1,0,1
351700,2019,1,0,0,1
351700,2021,1,0,0,1
351700,2022,1,0,0,1
351720,2015,0,0,2,2
351720,2017,0,1,0,1
351720,2020,1,1,0,2
351720,2021,1,0,0,1
351730,2017,1,0,0,1
351730,2018,3,0,0,3
351730,2020,0,1,0,1
351740,2015,12,1,7,20
351740,2016,9,1,12,22
351740,2017,12,1,14,27
351740,2018,6,0,5,11
351740,2019,1,0,7,8
351740,2020,8,1,2,11
351740,2021,4,1,1,6
351740,2022,2,0,0,2
351750,2015,2,0,0,2
351750,2016,0,1,0,1
351750,2017,3,0,2,5
351750,2018,1,0,0,1
351750,2019,1,1,1,3
351750,2021,1,0,0,1
351760,2018,1,0,0,1
351770,2015,1,1,1,3
351770,2016,2,0,2,4
351770,2017,4,0,2,6
351770,2018,0,4,1,5
351770,2019,1,0,3,4
351770,2020,2,0,0,2
351770,2021,1,0,1,2
351770,2022,3,1,1,5
351780,2016,1,0,0,1
351790,2015,1,0,1,2
351790,2016,0,0,2,2
351790,2018,2,0,0,2
351790,2019,1,0,0,1
351790,2020,0,0,1,1
351790,2021,1,0,0,1
351790,2022,0,1,1,2
351800,2017,1,0,0,1
351800,2018,0,1,0,1
351810,2016,2,0,0,2
351820,2015,2,0,0,2
351820,2016,2,0,0,2
351820,2017,2,0,0,2
351820,2018,3,1,0,4
351820,2019,3,0,1,4
351820,2020,5,2,0,7
351820,2022,1,0,0,1
351830,2015,2,0,2,4
351830,2016,1,1,2,4
351830,2017,1,0,2,3
351830,2018,4,1,1,6
351830,2019,1,0,0,1
351830,2020,2,0,1,3
351830,2022,2,0,1,3
351840,2015,10,4,3,17
351840,2016,7,0,4,11
351840,2017,6,1,8,15
351840,2018,9,2,4,15
351840,2019,10,1,4,15
351840,2020,4,3,1,8
351840,2021,11,2,5,18
351840,2022,4,1,5,10
351850,2021,1,0,0,1
351860,2015,0,1,3,4
351860,2016,4,1,4,9
351860,2017,3,1,4,8
351860,2018,4,0,1,5
351860,2019,2,1,5,8
351860,2020,0,0,1,1
351860,2021,3,1,2,6
351860,2022,7,0,3,10
351870,2015,14,5,12,31
351870,2016,18,3,17,38
351870,2017,35,8,20,63
351870,2018,27,7,13,47
351870,2019,30,8,27,65
351870,2020,24,9,23,56
351870,2021,26,10,26,62
351870,2022,29,6,20,55
351880,2015,134,21,92,247
351880,2016,183,45,121,349
351880,2017,178,43,116,337
351880,2018,182,32,93,307
351880,2019,146,49,119,314
351880,2020,124,25,78,227
351880,2021,148,37,97,282
351880,2022,134,41,96,271
351885,2016,0,1,0,1
351885,2017,1,0,0,1
351885,2018,2,0,0,2
351885,2020,0,1,0,1
351900,2015,1,0,0,1
351900,2016,4,0,0,4
351900,2017,1,0,0,1
351900,2018,3,0,0,3
351900,2019,0,0,2,2
351900,2021,2,1,0,3
351905,2015,4,0,0,4
351905,2016,0,0,1,1
351905,2017,1,0,0,1
351905,2018,2,0,0,2
351905,2019,1,0,0,1
351905,2020,5,0,0,5
351905,2021,1,0,0,1
351907,2015,17,3,16,36
351907,2016,14,3,9,26
351907,2017,29,6,19,54
351907,2018,22,3,25,50
351907,2019,22,6,15,43
351907,2020,20,8,6,34
351907,2021,18,5,7,30
351907,2022,13,1,15,29
351910,2015,2,0,0,2
351910,2016,0,0,1,1
351910,2017,1,0,0,1
351910,2019,0,0,1,1
351910,2020,0,0,1,1
351910,2021,0,1,0,1
351920,2019,1,0,0,1
351925,2016,1,0,1,2
351925,2017,1,0,0,1
351930,2015,2,1,2,5
351930,2016,5,0,0,5
351930,2017,3,0,2,5
351930,2018,5,0,2,7
351930,2019,2,1,3,6
351930,2020,2,0,3,5
351930,2021,1,0,2,3
351930,2022,2,0,1,3
351940,2017,1,0,0,1
351940,2018,4,0,0,4
351940,2019,1,2,0,3
351940,2022,1,0,1,2
351950,2021,1,0,0,1
351950,2022,1,0,0,1
351960,2015,7,3,4,14
351960,2016,6,1,4,11
351960,2017,15,1,1,17
351960,2018,7,1,6,14
351960,2019,5,1,1,7
351960,2020,3,3,4,10
351960,2021,7,2,4,13
351960,2022,2,2,4,8
351970,2015,3,2,0,5
351970,2016,2,0,3,5
351970,2017,2,2,3,7
351970,2018,5,0,3,8
351970,2019,6,2,1,9
351970,2020,4,0,1,5
351970,2021,4,2,0,6
351970,2022,2,1,0,3
351980,2015,1,0,0,1
351980,2016,0,0,1,1
351980,2018,0,0,1,1
351980,2019,0,0,1,1
351980,2021,0,0,2,2
351980,2022,1,0,1,2
351990,2016,0,0,1,1
351990,2022,1,0,0,1
352000,2015,1,0,2,3
352000,2018,3,0,1,4
352000,2019,1,0,0,1
352000,2020,4,0,0,4
352000,2021,0,1,3,4
352000,2022,0,0,2,2
352010,2015,0,0,1,1
352010,2016,2,0,6,8
352010,2017,3,1,2,6
352010,2018,5,0,2,7
352010,2019,2,0,5,7
352010,2020,2,0,4,6
352010,2021,3,0,1,4
352010,2022,1,2,1,4
352020,2015,2,0,0,2
352020,2017,2,0,0,2
352020,2018,1,0,0,1
352020,2019,1,0,1,2
352020,2021,2,0,0,2
352030,2016,0,0,1,1
352030,2020,2,0,1,3
352030,2021,1,3,0,4
352040,2015,3,0,0,3
352040,2016,2,0,0,2
352040,2017,2,0,0,2
352040,2019,1,0,0,1
352040,2020,0,1,0,1
352044,2015,1,0,3,4
352044,2016,3,0,0,3
352044,2017,5,0,1,6
352044,2018,1,0,0,1
352044,2019,2,2,0,4
352044,2020,1,0,1,2
352044,2021,1,1,0,2
352044,2022,0,1,0,1
352050,2015,37,2,36,75
352050,2016,28,7,28,63
352050,2017,51,9,38,98
352050,2018,51,14,24,89
352050,2019,37,12,28,77
352050,2020,42,19,17,78
352050,2021,42,4,21,67
352050,2022,35,12,18,65
352060,2017,1,0,1,2
352060,2022,0,1,0,1
352070,2018,0,0,2,2
352080,2021,2,0,0,2
352090,2016,0,0,1,1
352090,2018,0,0,1,1
352090,2019,2,0,1,3
352090,2022,1,0,2,3
352100,2016,1,0,3,4
352100,2017,1,1,2,4
352100,2018,3,1,2,6
352100,2019,2,0,4,6
352100,2020,1,0,1,2
352100,2021,4,0,1,5
352100,2022,1,0,0,1
352110,2015,1,0,0,1
352110,2016,2,0,0,2
352110,2017,1,0,0,1
352110,2018,1,0,0,1
352110,2021,1,0,0,1
352110,2022,1,0,0,1
352115,2015,0,0,1,1
352130,2015,0,0,2,2
352130,2016,2,0,5,7
352130,2017,0,1,2,3
352130,2018,0,2,1,3
352130,2019,2,0,0,2
352130,2020,0,1,0,1
352130,2021,1,0,0,1
352130,2022,2,0,1,3
352140,2016,0,0,2,2
352140,2017,5,0,1,6
352140,2018,3,1,1,5
352140,2019,2,0,1,3
352140,2020,4,0,2,6
352140,2021,5,1,2,8
352140,2022,3,2,0,5
352150,2016,0,0,1,1
352150,2017,0,0,1,1
352150,2018,1,0,0,1
352150,2019,1,1,0,2
352150,2020,0,0,2,2
352150,2022,1,0,0,1
352160,2016,0,0,2,2
352160,2017,1,0,2,3
352160,2019,1,0,0,1
352160,2022,1,0,0,1
352180,2017,0,1,0,1
352180,2022,1,0,0,1
352190,2018,1,0,2,3
352190,2021,1,0,1,2
352190,2022,1,0,0,1
352200,2016,1,0,0,1
352210,2015,2,0,0,2
352210,2016,2,0,1,3
352210,2017,2,0,2,4
352210,2018,6,0,2,8
352210,2019,1,0,3,4
352210,2020,1,4,3,8
352210,2021,3,0,2,5
352210,2022,6,2,1,9
352220,2015,12,1,10,23
352220,2016,5,2,10,17
352220,2017,24,5,5,34
352220,2018,7,1,4,12
352220,2019,6,5,11,22
352220,2020,8,0,4,12
352220,2021,4,1,6,11
352220,2022,6,0,6,12
352230,2015,2,1,0,3
352230,2016,3,2,4,9
352230,2017,8,3,2,13
352230,2018,8,2,1,11
352230,2019,12,4,9,25
352230,2020,12,2,7,21
352230,2021,13,2,8,23
352230,2022,9,3,1,13
352240,2015,1,0,3,4
352240,2016,6,1,1,8
352240,2017,3,0,2,5
352240,2018,3,0,1,4
352240,2019,4,1,1,6
352240,2020,4,2,0,6
352240,2021,0,0,1,1
352240,2022,3,0,3,6
352250,2015,16,6,19,41
352250,2016,22,2,19,43
352250,2017,25,4,11,40
352250,2018,14,7,11,32
352250,2019,15,6,11,32
352250,2020,20,4,10,34
352250,2021,15,6,9,30
352250,2022,15,1,7,23
352260,2015,1,0,1,2
352260,2016,2,0,2,4
352260,2017,2,0,1,3
352260,2018,10,2,6,18
352260,2019,6,2,4,12
352260,2020,2,2,1,5
352260,2021,8,0,1,9
352260,2022,6,3,9,18
352270,2015,1,0,3,4
352270,2016,3,0,0,3
352270,2017,6,0,2,8
352270,2018,2,0,2,4
352270,2019,1,3,2,6
352270,2020,3,2,1,6
352270,2021,5,0,1,6
352270,2022,3,1,3,7
352280,2018,0,0,1,1
352290,2016,1,1,0,2
352290,2018,2,0,0,2
352290,2022,1,0,0,1
352310,2015,17,4,17,38
352310,2016,22,9,29,60
352310,2017,30,8,20,58
352310,2018,29,7,20,56
352310,2019,27,5,18,50
352310,2020,17,3,12,32
352310,2021,25,5,23,53
352310,2022,18,5,17,40
352320,2015,0,1,1,2
352320,2016,0,0,1,1
352320,2017,1,0,1,2
352320,2018,2,0,0,2
352320,2019,1,0,1,2
352340,2015,14,1,14,29
352340,2016,19,0,10,29
352340,2017,7,1,8,16
352340,2018,10,1,7,18
352340,2019,18,4,4,26
352340,2020,12,4,6,22
352340,2021,11,2,2,15
352340,2022,6,2,9,17
352350,2015,1,0,1,2
352350,2016,1,0,0,1
352350,2017,0,0,2,2
352350,2018,0,0,2,2
352350,2020,1,2,0,3
352350,2021,2,0,2,4
352350,2022,2,0,1,3
352360,2015,1,0,0,1
352360,2017,0,0,2,2
352360,2020,3,0,0,3
352360,2021,0,0,1,1
352360,2022,0,1,0,1
352370,2018,0,0,1,1
352370,2019,1,0,0,1
352370,2021,0,0,1,1
352370,2022,1,0,0,1
352380,2019,1,0,2,3
352380,2020,1,0,0,1
352380,2022,0,0,1,1
352390,2015,25,3,14,42
352390,2016,33,6,19,58
352390,2017,29,5,21,55
352390,2018,29,4,18,51
352390,2019,32,14,22,68
352390,2020,23,4,11,38
352390,2021,19,4,9,32
352390,2022,19,3,7,29
352400,2015,6,1,6,13
352400,2016,9,2,8,19
352400,2017,7,1,8,16
352400,2018,10,7,12,29
352400,2019,14,4,7,25
352400,2020,11,4,7,22
352400,2021,7,0,8,15
352400,2022,8,3,5,16
352410,2015,2,0,1,3
352410,2016,8,0,1,9
352410,2017,7,3,7,17
352410,2018,3,2,5,10
352410,2019,7,0,4,11
352410,2020,5,1,4,10
352410,2021,3,1,3,7
352410,2022,7,4,1,12
352420,2016,1,0,0,1
352420,2017,1,0,0,1
352430,2015,7,1,0,8
352430,2016,4,1,4,9
352430,2017,7,4,4,15
352430,2018,8,1,4,13
352430,2019,5,1,2,8
352430,2020,2,2,1,5
352430,2021,5,4,1,10
352430,2022,7,0,4,11
352440,2015,30,5,20,55
352440,2016,34,10,26,70
352440,2017,38,1,17,56
352440,2018,27,4,18,49
352440,2019,19,7,14,40
352440,2020,11,3,5,19
352440,2021,36,3,10,49
352440,2022,27,5,18,50
352450,2018,0,0,1,1
352450,2020,4,0,0,4
352450,2022,1,0,0,1
352460,2016,0,0,1,1
352460,2017,0,0,1,1
352460,2018,3,0,0,3
352460,2020,3,0,0,3
352460,2021,2,0,1,3
352460,2022,1,0,0,1
352470,2015,6,1,1,8
352470,2016,3,3,4,10
352470,2017,3,4,1,8
352470,2018,4,1,4,9
352470,2019,10,1,1,12
352470,2020,0,0,2,2
352470,2021,6,3,2,11
352470,2022,4,0,2,6
352480,2015,5,1,5,11
352480,2016,3,0,4,7
352480,2017,11,1,2,14
352480,2018,5,1,1,7
352480,2019,5,3,3,11
352480,2020,6,1,7,14
352480,2021,9,1,4,14
352480,2022,11,5,3,19
352490,2015,0,0,1,1
352490,2016,0,0,2,2
352490,2017,1,0,1,2
352490,2018,1,1,0,2
352490,2019,1,0,0,1
352490,2020,1,0,0,1
352490,2021,1,0,0,1
352490,2022,1,0,1,2
352500,2015,12,0,2,14
352500,2016,11,1,12,24
352500,2017,8,3,4,15
352500,2018,11,1,4,16
352500,2019,6,3,2,11
352500,2020,9,3,3,15
352500,2021,7,2,6,15
352500,2022,8,0,8,16
352510,2015,1,0,4,5
352510,2016,2,1,4,7
352510,2017,6,0,4,10
352510,2018,6,1,1,8
352510,2019,8,1,3,12
352510,2020,2,1,0,3
352510,2021,1,0,0,1
352510,2022,2,0,2,4
352520,2015,2,3,2,7
352520,2016,2,1,1,4
352520,2017,1,0,3,4
352520,2018,2,1,4,7
352520,2019,3,0,2,5
352520,2020,1,0,0,1
352520,2021,4,0,2,6
352520,2022,2,2,2,6
352530,2015,13,2,6,21
352530,2016,11,0,6,17
352530,2017,7,0,1,8
352530,2018,10,2,1,13
352530,2019,5,1,2,8
352530,2020,6,2,2,10
352530,2021,13,1,0,14
352530,2022,3,1,7,11
352540,2017,0,0,1,1
352540,2019,0,0,2,2
352550,2015,1,0,2,3
352550,2016,1,0,0,1
352550,2017,2,0,0,2
352550,2019,1,0,0,1
352560,2017,1,0,0,1
352560,2021,0,1,0,1
352570,2015,3,1,3,7
352570,2016,6,1,5,12
352570,2017,5,0,6,11
352570,2018,2,0,3,5
352570,2019,1,1,2,4
352570,2020,4,0,2,6
352570,2021,0,1,0,1
352580,2020,0,0,1,1
352585,2016,2,0,1,3
352585,2017,1,0,0,1
352585,2018,1,0,0,1
352585,2021,0,0,1,1
352590,2015,63,14,43,120
352590,2016,74,16,38,128
352590,2017,77,18,41,136
352590,2018,82,12,41,135
352590,2019,75,18,41,134
352590,2020,64,16,30,110
352590,2021,63,24,26,113
352590,2022,49,6,22,77
352600,2016,1,0,2,3
352600,2017,2,0,1,3
352600,2018,1,0,2,3
352600,2019,0,1,0,1
352600,2020,3,0,0,3
352600,2021,1,0,0,1
352610,2015,0,0,1,1
352610,2016,0,0,1,1
352610,2017,1,0,0,1
352610,2018,1,0,1,2
352610,2019,1,0,0,1
352620,2016,1,0,0,1
352620,2020,0,0,1,1
352620,2022,0,0,2,2
352630,2018,0,0,1,1
352630,2022,0,0,1,1
352640,2015,2,0,2,4
352640,2016,1,0,3,4
352640,2017,0,1,2,3
352640,2018,2,3,3,8
352640,2019,1,0,0,1
352640,2020,4,0,1,5
352640,2021,0,1,1,2
352640,2022,2,1,2,5
352650,2022,1,0,0,1
352660,2022,0,0,1,1
352670,2015,6,1,6,13
352670,2016,3,0,4,7
352670,2017,9,0,3,12
352670,2018,21,2,8,31
352670,2019,14,3,5,22
352670,2020,15,4,7,26
352670,2021,9,5,4,18
352670,2022,9,4,3,16
352680,2015,7,2,0,9
352680,2016,6,2,4,12
352680,2017,11,2,2,15
352680,2018,6,1,4,11
352680,2019,6,1,6,13
352680,2020,7,1,1,9
352680,2021,11,3,2,16
352680,2022,4,0,7,11
352690,2015,34,4,21,59
352690,2016,8,7,4,19
352690,2017,40,5,24,69
352690,2018,35,5,27,67
352690,2019,39,4,19,62
352690,2020,27,11,12,50
352690,2021,21,4,14,39
352690,2022,26,6,10,42
352700,2021,1,0,0,1
352710,2015,5,0,3,8
352710,2016,8,2,2,12
352710,2017,4,1,0,5
352710,2018,9,4,4,17
352710,2019,5,4,2,11
352710,2020,5,5,3,13
352710,2021,3,4,8,15
352710,2022,15,4,3,22
352720,2015,7,1,3,11
352720,2016,5,0,3,8
352720,2017,3,1,4,8
352720,2018,1,0,3,4
352720,2019,9,0,1,10
352720,2020,7,0,2,9
352720,2021,6,1,4,11
352720,2022,2,0,6,8
352730,2015,7,0,2,9
352730,2016,4,1,2,7
352730,2017,7,1,3,11
352730,2018,8,0,7,15
352730,2019,5,0,6,11
352730,2020,2,1,5,8
352730,2021,3,0,2,5
352730,2022,4,0,2,6
352740,2015,1,0,0,1
352740,2018,1,1,0,2
352740,2022,2,0,0,2
352750,2015,1,0,1,2
352750,2020,0,1,0,1
352760,2015,0,0,1,1
352760,2016,1,0,0,1
352760,2018,1,0,2,3
352760,2019,1,0,0,1
352760,2020,1,1,1,3
352760,2021,0,1,1,2
352760,2022,1,0,1,2
352780,2017,0,0,1,1
352790,2020,1,0,0,1
352790,2022,0,0,1,1
352800,2017,3,0,0,3
352800,2018,3,1,0,4
352800,2019,2,0,0,2
352800,2020,0,1,2,3
352800,2021,0,1,2,3
352800,2022,3,0,1,4
352810,2015,1,0,2,3
352810,2016,0,0,1,1
352810,2017,0,0,1,1
352810,2018,0,1,0,1
352810,2019,1,0,2,3
352810,2020,0,0,1,1
352810,2021,0,0,1,1
352810,2022,0,0,1,1
352820,2015,1,0,0,1
352840,2015,7,3,4,14
352840,2016,6,3,6,15
352840,2017,1,1,5,7
352840,2018,7,2,5,14
352840,2019,5,0,5,10
352840,2020,3,0,6,9
352840,2021,7,3,3,13
352840,2022,6,4,5,15
352850,2015,5,3,0,8
352850,2016,16,1,1,18
352850,2017,12,6,5,23
352850,2018,6,3,3,12
352850,2019,4,1,1,6
352850,2020,7,0,2,9
352850,2021,4,0,2,6
352850,2022,5,2,5,12
352870,2019,0,1,0,1
352880,2017,1,0,0,1
352880,2018,2,1,0,3
352880,2019,1,1,0,2
352880,2020,1,0,1,2
352880,2021,1,0,0,1
352885,2018,1,0,0,1
352900,2015,6,2,2,10
352900,2016,15,2,8,25
352900,2017,27,6,11,44
352900,2018,33,12,15,60
352900,2019,26,11,12,49
352900,2020,27,6,6,39
352900,2021,23,6,12,41
352900,2022,28,3,9,40
352910,2016,0,0,1,1
352910,2018,0,0,1,1
352920,2016,1,0,1,2
352920,2017,1,0,1,2
352920,2022,2,1,0,3
352930,2015,10,0,14,24
352930,2016,13,1,12,26
352930,2017,10,2,5,17
352930,2018,9,4,6,19
352930,2019,11,0,4,15
352930,2020,17,2,7,26
352930,2021,7,1,10,18
352930,2022,16,4,5,25
352940,2015,24,7,16,47
352940,2016,36,9,41,86
352940,2017,58,15,26,99
352940,2018,40,6,34,80
352940,2019,49,5,26,80
352940,2020,51,16,35,102
352940,2021,45,13,39,97
352940,2022,30,8,23,61
352950,2017,1,1,0,2
352950,2018,1,0,0,1
352950,2019,0,0,4,4
352950,2021,0,0,1,1
352950,2022,0,0,1,1
352960,2015,0,1,1,2
352960,2017,1,0,0,1
352960,2018,0,0,1,1
352960,2019,2,0,0,2
352960,2020,1,0,0,1
352960,2022,1,0,0,1
352965,2017,1,0,0,1
352965,2018,1,0,0,1
352965,2019,1,0,0,1
352970,2015,2,0,1,3
352970,2016,2,0,0,2
352970,2017,4,0,2,6
352970,2018,0,0,1,1
352970,2019,1,0,2,3
352970,2020,1,0,4,5
352970,2021,0,2,2,4
352970,2022,1,0,1,2
352980,2016,4,0,0,4
352990,2015,2,0,0,2
352990,2016,1,0,0,1
352990,2018,0,0,1,1
353000,2016,0,0,1,1
353010,2016,1,0,0,1
353010,2017,3,0,0,3
353010,2018,0,0,2,2
353010,2019,0,0,1,1
353010,2020,2,0,0,2
353020,2015,0,0,1,1
353020,2016,0,0,4,4
353020,2017,1,0,3,4
353020,2018,0,0,2,2
353020,2019,1,0,3,4
353020,2020,0,1,0,1
353020,2021,1,0,0,1
353020,2022,3,0,1,4
353030,2015,4,2,2,8
353030,2016,11,2,4,17
353030,2017,6,0,4,10
353030,2018,6,3,2,11
353030,2019,10,2,1,13
353030,2020,5,2,4,11
353030,2021,3,3,2,8
353030,2022,6,2,0,8
353050,2015,1,1,1,3
353050,2016,6,2,6,14
353050,2017,4,1,5,10
353050,2018,12,0,2,14
353050,2019,7,3,3,13
353050,2020,6,2,3,11
353050,2021,3,1,1,5
353050,2022,5,2,0,7
353060,2015,35,8,23,66
353060,2016,39,11,23,73
353060,2017,37,14,19,70
353060,2018,39,10,20,69
353060,2019,43,12,23,78
353060,2020,20,5,12,37
353060,2021,36,11,15,62
353060,2022,31,2,16,49
353070,2015,14,3,17,34
353070,2016,16,2,11,29
353070,2017,15,3,13,31
353070,2018,24,8,12,44
353070,2019,30,5,12,47
353070,2020,21,11,14,46
353070,2021,21,5,16,42
353070,2022,30,7,11,48
353080,2015,2,3,1,6
353080,2016,8,2,3,13
353080,2017,7,1,3,11
353080,2018,10,2,5,17
353080,2019,12,4,7,23
353080,2020,14,6,8,28
353080,2021,13,2,4,19
353080,2022,12,3,5,20
353090,2015,1,0,0,1
353090,2016,1,0,0,1
353090,2017,1,0,0,1
353090,2018,1,0,0,1
353090,2021,0,0,1,1
353090,2022,0,0,1,1
353100,2021,0,0,1,1
353110,2015,2,0,1,3
353110,2016,1,1,0,2
353110,2017,1,0,1,2
353110,2018,1,1,1,3
353110,2019,2,0,0,2
353110,2020,2,1,0,3
353110,2021,4,0,3,7
353110,2022,2,0,2,4
353120,2015,0,0,1,1
353120,2019,1,0,0,1
353120,2020,1,0,0,1
353130,2015,6,0,3,9
353130,2016,1,0,0,1
353130,2017,2,2,1,5
353130,2018,2,2,0,4
353130,2019,2,0,4,6
353130,2020,4,1,1,6
353130,2021,4,1,2,7
353130,2022,5,0,1,6
353140,2015,0,1,4,5
353140,2016,2,0,0,2
353140,2017,3,0,5,8
353140,2018,1,0,2,3
353140,2019,2,0,1,3
353140,2020,2,0,1,3
353140,2021,0,0,1,1
353140,2022,3,0,0,3
353150,2016,4,0,0,4
353150,2017,1,0,1,2
353150,2019,1,0,0,1
353150,2020,3,0,2,5
353150,2021,3,0,0,3
353150,2022,2,0,0,2
353160,2017,1,0,0,1
353170,2018,0,0,1,1
353170,2022,0,1,0,1
353180,2015,3,0,0,3
353180,2016,1,0,2,3
353180,2017,4,1,3,8
353180,2018,5,1,5,11
353180,2019,6,0,3,9
353180,2020,3,1,0,4
353180,2021,5,2,3,10
353180,2022,4,0,1,5
353190,2016,0,0,2,2
353190,2017,4,0,2,6
353190,2018,2,0,0,2
353190,2019,1,0,1,2
353190,2020,0,0,2,2
353190,2021,2,1,0,3
353190,2022,3,0,2,5
353200,2015,3,0,1,4
353200,2016,2,1,0,3
353200,2019,1,0,3,4
353200,2021,0,0,1,1
353200,2022,0,1,0,1
353205,2017,1,0,0,1
353210,2015,1,0,0,1
353210,2022,1,0,0,1
353215,2022,1,0,0,1
353220,2020,2,0,1,3
353240,2017,0,0,1,1
353240,2018,1,0,0,1
353240,2020,0,0,1,1
353240,2021,0,0,1,1
353250,2017,1,0,0,1
353250,2018,1,0,1,2
353250,2021,2,0,1,3
353260,2016,2,0,1,3
353260,2017,0,0,1,1
353260,2018,1,0,0,1
353260,2021,1,0,0,1
353270,2016,1,1,0,2
353270,2017,1,0,0,1
353270,2020,1,0,0,1
353270,2021,0,1,0,1
353270,2022,0,0,3,3
353280,2017,0,0,1,1
353280,2018,1,0,0,1
353282,2022,1,0,0,1
353284,2016,1,1,0,2
353284,2021,1,0,0,1
353290,2015,3,0,0,3
353290,2017,0,0,2,2
353290,2018,2,0,1,3
353290,2019,3,1,0,4
353290,2020,0,0,3,3
353290,2021,2,0,0,2
353290,2022,1,0,1,2
353300,2015,0,0,2,2
353300,2016,0,0,1,1
353300,2017,3,1,1,5
353300,2018,1,0,1,2
353300,2019,1,1,0,2
353300,2020,0,0,1,1
353300,2021,2,0,0,2
353300,2022,3,0,0,3
353310,2017,0,0,1,1
353310,2021,1,0,0,1
353320,2015,1,0,0,1
353320,2017,0,0,1,1
353320,2018,1,0,1,2
353320,2019,0,0,1,1
353325,2016,0,0,1,1
353325,2018,1,0,0,1
353325,2020,1,0,0,1
353325,2021,1,0,0,1
353330,2016,0,0,1,1
353330,2018,0,0,1,1
353340,2015,9,3,3,15
353340,2016,7,2,2,11
353340,2017,6,3,7,16
353340,2018,9,3,6,18
353340,2019,3,1,4,8
353340,2020,10,0,3,13
353340,2021,8,0,2,10
353340,2022,7,0,3,10
353350,2015,6,2,9,17
353350,2016,1,2,6,9
353350,2017,1,0,6,7
353350,2018,4,2,2,8
353350,2019,3,2,5,10
353350,2020,2,1,0,3
353350,2021,3,0,3,6
353350,2022,6,0,0,6
353360,2016,1,0,0,1
353360,2017,1,0,0,1
353360,2019,0,0,1,1
353360,2020,1,0,0,1
353360,2021,1,0,0,1
353360,2022,0,0,1,1
353370,2017,0,0,1,1
353390,2015,9,1,8,18
353390,2016,5,2,8,15
353390,2017,10,3,2,15
353390,2018,7,0,4,11
353390,2019,3,0,8,11
353390,2020,2,1,4,7
353390,2021,4,3,2,9
353390,2022,4,3,8,15
353400,2016,1,0,0,1
353410,2018,0,0,1,1
353410,2020,1,0,0,1
353410,2021,0,0,1,1
353420,2015,0,0,2,2
353420,2016,0,0,1,1
353420,2018,1,0,0,1
353420,2020,1,0,0,1
353420,2021,0,1,0,1
353420,2022,0,1,0,1
353430,2015,0,0,1,1
353430,2016,0,0,1,1
353430,2017,1,0,3,4
353430,2018,0,0,1,1
353430,2019,1,0,0,1
353430,2020,2,0,0,2
353430,2021,1,1,0,2
353430,2022,5,0,1,6
353440,2015,85,19,57,161
353440,2016,93,20,43,156
353440,2017,90,8,48,146
353440,2018,86,14,51,151
353440,2019,67,23,47,137
353440,2020,73,22,42,137
353440,2021,54,21,40,115
353440,2022,54,23,34,111
353460,2015,4,0,0,4
353460,2016,3,0,1,4
353460,2017,5,0,1,6
353460,2018,3,0,5,8
353460,2019,3,1,1,5
353460,2021,3,1,1,5
353460,2022,2,0,1,3
353470,2015,1,1,0,2
353470,2016,3,3,1,7
353470,2017,5,0,5,10
353470,2018,4,0,2,6
353470,2019,10,0,4,14
353470,2020,3,1,3,7
353470,2021,7,0,2,9
353470,2022,10,0,0,10
353475,2015,0,0,1,1
353475,2017,1,0,0,1
353475,2018,2,0,1,3
353475,2020,0,1,0,1
353475,2021,2,0,0,2
353475,2022,2,0,0,2
353480,2019,0,1,0,1
353480,2021,1,0,0,1
353480,2022,1,0,0,1
353490,2016,0,1,0,1
353490,2017,0,0,1,1
353490,2020,2,0,0,2
353490,2021,1,0,0,1
353500,2015,1,0,0,1
353500,2017,0,0,1,1
353500,2018,2,0,1,3
353500,2019,1,0,0,1
353500,2020,0,1,0,1
353500,2021,1,0,1,2
353500,2022,0,0,2,2
353510,2015,1,0,0,1
353510,2016,2,0,0,2
353510,2017,0,0,1,1
353510,2018,0,0,1,1
353510,2019,1,0,0,1
353510,2021,0,0,1,1
353510,2022,1,0,0,1
353520,2015,0,0,1,1
353520,2016,1,0,0,1
353520,2017,1,0,0,1
353520,2018,1,0,0,1
353520,2020,3,0,1,4
353520,2021,1,0,0,1
353520,2022,2,0,0,2
353530,2019,1,0,0,1
353530,2021,3,1,0,4
353530,2022,1,0,0,1
353540,2015,1,0,0,1
353540,2016,1,0,0,1
353550,2015,2,1,0,3
353550,2016,0,0,1,1
353550,2017,4,1,3,8
353550,2018,1,0,0,1
353550,2019,2,1,1,4
353550,2020,1,2,1,4
353550,2021,4,0,1,5
353550,2022,3,0,0,3
353560,2015,3,1,1,5
353560,2016,1,1,0,2
353560,2017,1,2,1,4
353560,2018,0,2,0,2
353560,2019,1,1,0,2
353560,2020,1,0,1,2
353560,2021,1,0,0,1
353560,2022,4,1,0,5
353570,2016,1,0,0,1
353570,2019,1,0,0,1
353570,2020,1,0,0,1
353570,2021,1,0,0,1
353570,2022,1,0,0,1
353580,2020,0,1,0,1
353590,2015,0,0,1,1
353590,2022,1,0,1,2
353600,2020,0,0,1,1
353610,2015,1,0,1,2
353610,2018,1,0,0,1
353610,2021,1,0,0,1
353610,2022,0,0,1,1
353620,2018,1,0,0,1
353630,2016,0,0,2,2
353630,2018,2,0,0,2
353630,2022,0,0,1,1
353640,2018,1,0,0,1
353650,2015,11,4,4,19
353650,2016,7,3,3,13
353650,2017,13,3,4,20
353650,2018,8,2,5,15
353650,2019,3,2,6,11
353650,2020,13,2,7,22
353650,2021,9,1,3,13
353650,2022,6,0,2,8
353660,2017,0,0,1,1
353660,2019,0,0,1,1
353670,2015,1,0,4,5
353670,2016,3,0,5,8
353670,2017,5,0,2,7
353670,2018,7,2,1,10
353670,2019,2,1,1,4
353670,2020,3,0,1,4
353670,2021,1,0,0,1
353670,2022,2,0,2,4
353680,2015,1,0,0,1
353680,2016,0,0,1,1
353680,2020,0,0,1,1
353700,2015,2,0,2,4
353700,2017,2,0,0,2
353700,2018,0,1,0,1
353700,2019,1,0,1,2
353700,2020,2,0,0,2
353710,2015,1,0,1,2
353710,2016,3,0,1,4
353710,2017,5,1,1,7
353710,2018,1,0,0,1
353710,2019,3,0,1,4
353710,2020,1,1,0,2
353710,2021,4,0,0,4
353710,2022,0,0,1,1
353720,2015,1,0,0,1
353720,2019,1,0,0,1
353730,2015,1,0,1,2
353730,2016,1,0,1,2
353730,2017,4,0,0,4
353730,2018,2,0,2,4
353730,2019,1,1,0,2
353730,2020,1,0,0,1
353730,2021,5,1,1,7
353730,2022,5,2,5,12
353740,2015,0,0,3,3
353740,2016,0,1,1,2
353740,2017,0,0,1,1
353740,2018,2,1,1,4
353740,2019,3,0,1,4
353740,2020,2,0,0,2
353740,2021,3,1,0,4
353740,2022,2,1,0,3
353750,2016,0,0,1,1
353750,2018,1,0,0,1
353760,2015,0,1,1,2
353760,2016,1,2,0,3
353760,2017,6,1,3,10
353760,2018,2,1,0,3
353760,2019,1,0,2,3
353760,2020,1,0,1,2
353760,2022,1,0,0,1
353770,2016,0,1,0,1
353770,2020,1,0,0,1
353770,2022,0,0,1,1
353780,2015,0,0,1,1
353780,2017,2,0,1,3
353780,2018,1,0,0,1
353780,2019,2,0,1,3
353780,2020,5,0,1,6
353780,2022,1,0,4,5
353790,2018,0,0,2,2
353790,2019,1,0,0,1
353790,2020,1,0,0,1
353790,2021,4,0,0,4
353790,2022,3,0,1,4
353800,2015,16,4,13,33
353800,2016,21,1,6,28
353800,2017,23,3,7,33
353800,2018,18,4,6,28
353800,2019,21,5,17,43
353800,2020,20,2,4,26
353800,2021,19,3,7,29
353800,2022,12,4,8,24
353810,2016,0,0,2,2
353810,2020,1,0,0,1
353810,2021,0,1,0,1
353810,2022,1,0,1,2
353820,2016,2,0,1,3
353820,2022,1,0,0,1
353830,2017,1,0,0,1
353850,2018,1,0,0,1
353850,2019,0,0,1,1
353860,2015,4,0,2,6
353860,2016,1,0,3,4
353860,2018,0,1,1,2
353860,2019,3,0,0,3
353860,2020,1,0,1,2
353860,2021,1,1,0,2
353860,2022,1,0,1,2
353870,2015,66,14,43,123
353870,2016,66,16,42,124
353870,2017,79,14,40,133
353870,2018,47,9,25,81
353870,2019,43,8,29,80
353870,2020,77,13,34,124
353870,2021,45,12,24,81
353870,2022,39,9,22,70
353880,2016,1,0,1,2
353880,2017,1,0,0,1
353880,2018,0,0,1,1
353880,2019,0,1,0,1
353880,2020,1,0,0,1
353880,2021,3,0,2,5
353880,2022,2,1,0,3
353890,2015,2,0,3,5
353890,2016,3,0,0,3
353890,2017,1,0,0,1
353890,2018,1,0,0,1
353890,2019,2,0,0,2
353890,2020,1,0,0,1
353890,2021,0,1,2,3
353890,2022,0,0,1,1
353900,2015,0,1,0,1
353900,2016,0,1,0,1
353900,2018,1,0,0,1
353900,2019,0,0,1,1
353900,2020,2,0,0,2
353910,2016,1,0,0,1
353910,2018,0,0,1,1
353910,2019,1,0,0,1
353910,2020,0,0,1,1
353910,2021,1,0,0,1
353920,2015,0,0,1,1
353920,2016,2,0,0,2
353920,2017,3,2,1,6
353920,2018,2,0,0,2
353920,2019,1,0,1,2
353920,2020,1,0,0,1
353920,2021,0,0,1,1
353920,2022,3,1,1,5
353930,2015,0,0,8,8
353930,2016,9,0,3,12
353930,2017,7,1,4,12
353930,2018,9,0,6,15
353930,2019,10,4,2,16
353930,2020,6,2,3,11
353930,2021,11,1,1,13
353930,2022,8,3,2,13
353940,2016,3,1,1,5
353940,2018,1,0,0,1
353940,2019,1,0,0,1
353940,2020,0,0,1,1
353940,2021,1,0,0,1
353940,2022,0,2,1,3
353950,2015,2,0,3,5
353950,2016,3,2,0,5
353950,2017,1,0,2,3
353950,2018,4,0,2,6
353950,2019,4,1,0,5
353950,2020,1,0,1,2
353950,2021,4,0,0,4
353950,2022,1,0,0,1
353960,2015,0,1,0,1
353960,2018,0,0,1,1
353960,2019,1,0,0,1
353970,2018,1,0,0,1
353980,2015,5,0,7,12
353980,2016,18,1,9,28
353980,2017,10,1,2,13
353980,2018,13,0,1,14
353980,2019,12,3,2,17
353980,2020,10,2,3,15
353980,2021,7,1,2,10
353980,2022,3,2,3,8
353990,2015,1,0,1,2
354000,2016,1,1,0,2
354000,2017,3,0,0,3
354000,2018,3,0,2,5
354000,2019,2,0,2,4
354000,2020,4,0,0,4
354000,2021,1,1,0,2
354000,2022,2,0,2,4
354010,2015,1,0,0,1
354010,2019,0,0,1,1
354020,2015,2,1,8,11
354020,2016,3,2,9,14
354020,2017,3,0,1,4
354020,2018,2,2,6,10
354020,2019,3,0,4,7
354020,2020,1,2,2,5
354020,2021,1,1,0,2
354020,2022,3,0,2,5
354030,2017,1,0,0,1
354030,2021,0,1,0,1
354030,2022,0,1,0,1
354040,2019,1,0,0,1
354040,2021,3,0,0,3
354050,2015,0,0,1,1
354050,2017,0,1,0,1
354050,2020,0,0,1,1
354050,2021,1,0,0,1
354060,2015,4,1,1,6
354060,2016,3,1,2,6
354060,2017,3,0,1,4
354060,2018,2,1,1,4
354060,2019,2,0,3,5
354060,2020,4,0,1,5
354060,2021,2,1,2,5
354060,2022,5,0,2,7
354070,2015,5,0,3,8
354070,2016,3,0,2,5
354070,2017,12,1,4,17
354070,2018,15,1,4,20
354070,2019,4,0,4,8
354070,2020,4,1,3,8
354070,2021,8,1,2,11
354070,2022,5,2,2,9
354075,2017,0,1,0,1
354075,2018,1,0,0,1
354075,2019,0,1,0,1
354075,2022,0,0,1,1
354080,2016,0,0,1,1
354080,2017,0,1,1,2
354080,2019,0,2,1,3
354080,2020,2,0,2,4
354080,2021,0,0,1,1
354080,2022,2,0,2,4
354090,2015,2,0,3,5
354090,2017,4,1,4,9
354090,2018,2,0,1,3
354090,2019,3,1,1,5
354090,2020,1,1,1,3
354090,2021,3,0,0,3
354090,2022,2,0,1,3
354100,2015,11,3,14,28
354100,2016,10,2,8,20
354100,2017,17,1,8,26
354100,2018,22,9,11,42
354100,2019,18,13,13,44
354100,2020,17,6,12,35
354100,2021,24,15,19,58
354100,2022,26,10,16,52
354105,2017,0,0,1,1
354105,2021,1,0,0,1
354105,2022,0,1,0,1
354110,2015,1,0,0,1
354120,2015,0,0,1,1
354120,2016,0,0,1,1
354120,2018,0,0,1,1
354120,2019,2,0,0,2
354120,2021,0,0,1,1
354120,2022,3,0,0,3
354130,2015,4,0,0,4
354130,2016,2,0,2,4
354130,2017,1,1,2,4
354130,2018,3,2,1,6
354130,2019,2,0,0,2
354130,2020,2,0,2,4
354130,2021,3,0,1,4
354130,2022,2,1,0,3
354140,2015,5,3,8,16
354140,2016,11,2,8,21
354140,2017,17,3,5,25
354140,2018,20,2,6,28
354140,2019,14,4,5,23
354140,2020,31,2,6,39
354140,2021,17,7,8,32
354140,2022,27,11,2,40
354150,2015,1,0,2,3
354150,2016,2,0,1,3
354150,2017,5,0,0,5
354150,2018,3,0,2,5
354150,2019,0,1,0,1
354150,2020,7,0,0,7
354150,2021,0,0,2,2
354150,2022,1,0,1,2
354160,2015,1,1,0,2
354160,2017,0,0,1,1
354160,2018,1,3,0,4
354160,2019,3,1,0,4
354160,2020,1,1,1,3
354160,2021,0,0,1,1
354160,2022,3,0,0,3
354165,2017,1,0,0,1
354170,2017,3,0,1,4
354170,2018,2,0,1,3
354170,2019,2,0,0,2
354170,2022,1,1,0,2
354180,2021,0,1,0,1
354190,2017,0,0,1,1
354190,2018,0,0,1,1
354190,2022,0,0,1,1
354200,2018,1,0,0,1
354200,2020,2,0,2,4
354200,2021,1,0,0,1
354210,2015,0,0,1,1
354210,2017,1,0,2,3
354210,2018,1,0,4,5
354210,2019,1,0,0,1
354210,2020,1,0,0,1
354210,2021,1,0,0,1
354220,2015,4,0,0,4
354220,2018,1,1,0,2
354220,2020,0,1,1,2
354220,2021,2,0,0,2
354220,2022,4,0,0,4
354230,2019,0,0,1,1
354240,2015,1,0,0,1
354240,2016,1,0,0,1
354240,2018,2,1,1,4
354240,2019,2,0,0,2
354240,2021,1,0,1,2
354250,2017,1,0,0,1
354260,2015,1,2,1,4
354260,2016,3,1,3,7
354260,2017,2,2,1,5
354260,2018,8,1,5,14
354260,2019,7,1,2,10
354260,2020,3,1,2,6
354260,2021,1,2,1,4
354260,2022,1,0,0,1
354280,2019,0,0,1,1
354290,2015,1,0,0,1
354290,2016,1,0,0,1
354290,2017,3,0,0,3
354290,2020,0,0,1,1
354290,2022,1,0,0,1
354300,2016,1,0,0,1
354320,2018,0,1,0,1
354330,2015,5,1,1,7
354330,2016,5,2,2,9
354330,2017,12,6,7,25
354330,2018,14,4,6,24
354330,2019,7,2,6,15
354330,2020,11,1,14,26
354330,2021,12,5,11,28
354330,2022,6,3,2,11
354340,2015,48,19,31,98
354340,2016,88,8,34,130
354340,2017,104,21,44,169
354340,2018,73,12,28,113
354340,2019,67,21,44,132
354340,2020,65,15,18,98
354340,2021,61,17,30,108
354340,2022,40,27,10,77
354350,2017,0,0,1,1
354360,2018,0,0,1,1
354370,2016,0,1,2,3
354370,2021,0,0,1,1
354380,2019,1,0,0,1
354380,2020,2,1,0,3
354390,2015,28,7,16,51
354390,2016,29,10,12,51
354390,2017,39,8,25,72
354390,2018,33,10,24,67
354390,2019,22,6,9,37
354390,2020,23,3,16,42
354390,2021,23,2,9,34
354390,2022,24,6,16,46
354400,2015,4,1,4,9
354400,2016,5,0,6,11
354400,2017,4,1,1,6
354400,2018,1,0,2,3
354400,2019,0,0,3,3
354400,2020,3,1,4,8
354400,2021,3,0,2,5
354400,2022,4,0,4,8
354410,2015,1,0,1,2
354410,2016,2,0,1,3
354410,2017,1,2,2,5
354410,2018,3,0,2,5
354410,2019,3,1,2,6
354410,2020,3,0,3,6
354410,2021,3,0,2,5
354410,2022,2,2,2,6
354420,2015,2,0,0,2
354420,2016,1,0,0,1
354420,2017,1,0,0,1
354420,2018,0,0,2,2
354420,2020,1,0,0,1
354420,2021,0,0,1,1
354425,2015,1,0,0,1
354425,2017,1,0,0,1
354425,2021,1,0,0,1
354430,2015,0,0,1,1
354430,2017,0,1,0,1
354430,2018,0,0,1,1
354430,2019,1,0,0,1
354430,2020,2,0,0,2
354430,2021,0,0,2,2
354430,2022,1,0,0,1
354440,2018,0,0,1,1
354440,2020,0,1,0,1
354440,2021,1,0,1,2
354440,2022,0,2,0,2
354450,2017,1,0,0,1
354450,2019,1,0,0,1
354450,2020,1,0,0,1
354460,2019,1,0,0,1
354460,2021,0,1,0,1
354480,2015,0,0,1,1
354480,2016,0,0,1,1
354480,2017,1,0,0,1
354480,2019,2,0,0,2
354500,2016,1,0,0,1
354500,2019,1,0,0,1
354500,2022,0,0,1,1
354515,2015,1,0,0,1
354515,2016,1,1,0,2
354515,2020,0,1,0,1
354515,2021,0,0,1,1
354515,2022,1,0,0,1
354520,2015,10,3,12,25
354520,2016,5,1,13,19
354520,2017,12,1,12,25
354520,2018,19,5,9,33
354520,2019,13,3,7,23
354520,2020,8,7,5,20
354520,2021,11,3,6,20
354520,2022,8,0,11,19
354530,2015,1,0,2,3
354530,2017,2,0,2,4
354530,2018,0,0,3,3
354530,2019,1,0,0,1
354530,2020,1,1,1,3
354530,2021,2,2,1,5
354530,2022,1,1,0,2
354540,2017,1,0,0,1
354540,2018,1,0,0,1
354550,2015,0,0,2,2
354550,2017,1,0,0,1
354550,2019,1,0,0,1
354560,2016,1,0,0,1
354560,2017,2,0,0,2
354560,2018,2,0,1,3
354560,2020,0,0,1,1
354560,2021,1,0,0,1
354560,2022,0,1,1,2
354570,2018,1,0,0,1
354570,2019,2,0,2,4
354570,2020,1,0,0,1
354570,2021,1,0,1,2
354580,2015,11,1,12,24
354580,2016,19,5,10,34
354580,2017,20,3,7,30
354580,2018,14,5,7,26
354580,2019,15,6,9,30
354580,2020,20,5,11,36
354580,2021,14,6,11,31
354580,2022,13,0,10,23
354600,2015,1,0,0,1
354600,2017,1,0,0,1
354600,2019,0,0,1,1
354600,2021,0,2,0,2
354610,2019,1,0,0,1
354610,2020,1,0,0,1
354620,2015,3,0,0,3
354620,2020,1,0,0,1
354630,2015,2,0,2,4
354630,2016,3,0,2,5
354630,2017,1,1,4,6
354630,2018,1,0,2,3
354630,2019,1,0,3,4
354630,2020,3,1,1,5
354630,2021,1,1,0,2
354630,2022,0,0,2,2
354640,2015,1,0,0,1
354640,2016,1,0,0,1
354640,2017,3,0,3,6
354640,2018,1,0,2,3
354640,2019,1,1,3,5
354640,2020,3,0,0,3
354640,2021,1,0,0,1
354640,2022,2,0,0,2
354650,2015,1,0,0,1
354650,2016,0,0,1,1
354650,2017,1,0,0,1
354650,2018,0,0,1,1
354660,2015,1,0,0,1
354660,2017,5,0,2,7
354660,2018,1,1,2,4
354660,2019,1,1,0,2
354660,2020,3,3,2,8
354660,2021,6,0,0,6
354660,2022,4,1,0,5
354670,2015,1,1,3,5
354670,2016,2,2,0,4
354670,2017,1,0,1,2
354670,2018,1,0,4,5
354670,2019,1,1,0,2
354670,2020,2,1,1,4
354670,2022,3,1,2,6
354680,2015,1,0,4,5
354680,2016,2,0,3,5
354680,2017,2,1,2,5
354680,2018,3,0,1,4
354680,2019,1,0,2,3
354680,2020,2,1,2,5
354680,2021,1,1,1,3
354680,2022,1,0,0,1
354690,2016,0,0,2,2
354690,2017,1,0,1,2
354690,2018,2,0,1,3
354690,2019,1,0,0,1
354700,2020,1,0,0,1
354720,2020,1,0,0,1
354730,2015,12,1,5,18
354730,2016,10,4,5,19
354730,2017,10,5,6,21
354730,2018,11,4,12,27
354730,2019,10,4,3,17
354730,2020,12,1,4,17
354730,2021,12,2,5,19
354730,2022,11,4,4,19
354750,2015,3,0,1,4
354750,2016,2,2,0,4
354750,2017,6,0,1,7
354750,2018,5,0,3,8
354750,2019,3,2,1,6
354750,2020,3,0,1,4
354750,2021,4,0,1,5
354750,2022,4,2,2,8
354760,2015,1,0,0,1
354760,2016,1,0,0,1
354760,2017,1,1,0,2
354760,2018,2,0,1,3
354760,2019,3,2,1,6
354760,2021,1,1,0,2
354760,2022,1,0,2,3
354765,2020,0,1,0,1
354770,2015,1,0,0,1
354770,2016,1,0,0,1
354770,2018,2,0,0,2
354770,2019,1,0,0,1
354770,2021,1,1,1,3
354770,2022,1,1,0,2
354780,2015,66,12,34,112
354780,2016,87,25,38,150
354780,2017,108,26,55,189
354780,2018,116,25,40,181
354780,2019,86,25,39,150
354780,2020,66,24,40,130
354780,2021,92,25,32,149
354780,2022,63,23,18,104
354800,2015,2,0,1,3
354800,2016,0,1,0,1
354800,2017,0,0,1,1
354800,2018,0,0,2,2
354800,2020,2,0,0,2
354800,2021,0,0,1,1
354800,2022,2,0,0,2
354805,2015,1,0,0,1
354805,2016,0,1,0,1
354810,2016,1,0,1,2
354810,2017,1,0,0,1
354810,2018,2,0,0,2
354810,2019,1,1,1,3
354810,2020,1,0,0,1
354810,2021,1,0,1,2
354820,2016,1,0,0,1
354820,2020,1,0,0,1
354820,2022,1,0,1,2
354840,2019,1,0,0,1
354840,2021,0,0,1,1
354850,2015,27,11,13,51
354850,2016,29,6,25,60
354850,2017,45,9,15,69
354850,2018,37,21,15,73
354850,2019,56,17,16,89
354850,2020,34,10,14,58
354850,2021,34,14,19,67
354850,2022,34,15,14,63
354860,2021,1,0,0,1
354870,2015,67,8,37,112
354870,2016,77,16,29,122
354870,2017,101,17,57,175
354870,2018,99,29,56,184
354870,2019,83,29,38,150
354870,2020,82,26,29,137
354870,2021,82,17,43,142
354870,2022,51,21,24,96
354880,2015,12,4,5,21
354880,2016,13,5,10,28
354880,2017,33,3,4,40
354880,2018,21,13,5,39
354880,2019,15,6,7,28
354880,2020,16,5,2,23
354880,2021,12,1,5,18
354880,2022,8,9,5,22
354890,2015,48,6,22,76
354890,2016,47,14,19,80
354890,2017,43,10,16,69
354890,2018,45,13,12,70
354890,2019,34,9,14,57
354890,2020,32,10,9,51
354890,2021,34,10,13,57
354890,2022,34,13,12,59
354910,2015,14,3,11,28
354910,2016,12,5,6,23
354910,2017,8,1,0,9
354910,2018,10,2,4,16
354910,2019,12,0,5,17
354910,2020,18,0,2,20
354910,2021,9,3,3,15
354910,2022,6,1,4,11
354920,2018,1,0,2,3
354930,2016,1,0,0,1
354930,2017,2,0,1,3
354930,2018,0,0,1,1
354940,2015,1,0,0,1
354940,2016,5,1,3,9
354940,2017,9,0,7,16
354940,2018,4,0,0,4
354940,2019,4,1,2,7
354940,2020,4,2,1,7
354940,2021,1,2,2,5
354940,2022,6,3,0,9
354950,2018,0,1,0,1
354960,2017,0,0,1,1
354960,2018,0,0,1,1
354970,2015,1,0,2,3
354970,2016,2,4,4,10
354970,2017,6,2,1,9
354970,2018,5,4,2,11
354970,2019,4,1,1,6
354970,2020,7,2,3,12
354970,2021,4,1,3,8
354970,2022,4,2,1,7
354980,2015,48,5,14,67
354980,2016,30,3,18,51
354980,2017,54,4,27,85
354980,2018,44,9,19,72
354980,2019,44,16,20,80
354980,2020,30,10,13,53
354980,2021,21,9,21,51
354980,2022,31,8,6,45
354990,2015,70,17,36,123
354990,2016,110,26,53,189
354990,2017,106,24,65,195
354990,2018,69,11,33,113
354990,2019,66,25,30,121
354990,2020,57,19,35,111
354990,2021,54,17,32,103
354990,2022,55,13,22,90
354995,2016,1,0,0,1
354995,2018,1,0,0,1
354995,2019,0,0,1,1
355000,2015,0,1,0,1
355000,2016,1,0,0,1
355000,2017,1,0,0,1
355000,2018,0,1,1,2
355000,2019,1,0,0,1
355000,2020,1,0,1,2
355000,2021,0,0,1,1
355010,2015,3,0,2,5
355010,2016,0,0,1,1
355010,2017,1,0,4,5
355010,2018,3,0,4,7
355010,2019,5,3,2,10
355010,2020,1,0,0,1
355010,2021,3,0,1,4
355010,2022,1,1,0,2
355020,2017,1,0,0,1
355020,2020,1,0,1,2
355020,2021,1,0,0,1
355030,2015,1346,317,919,2582
355030,2016,1729,438,1049,3216
355030,2017,1460,377,775,2612
355030,2018,1326,298,546,2170
355030,2019,1149,326,560,2035
355030,2020,811,253,457,1521
355030,2021,797,248,380,1425
355030,2022,818,253,404,1475
355040,2015,1,1,0,2
355040,2016,1,0,0,1
355040,2017,0,2,4,6
355040,2018,0,0,1,1
355040,2019,0,1,0,1
355040,2020,2,0,1,3
355040,2022,1,0,0,1
355050,2020,0,0,1,1
355060,2015,8,0,4,12
355060,2016,3,2,1,6
355060,2017,8,4,4,16
355060,2018,2,0,2,4
355060,2019,5,4,0,9
355060,2020,4,1,3,8
355060,2021,5,3,1,9
355060,2022,4,1,2,7
355070,2015,7,0,3,10
355070,2016,2,0,2,4
355070,2017,4,2,4,10
355070,2018,1,1,0,2
355070,2019,3,1,0,4
355070,2020,1,0,0,1
355070,2021,1,1,1,3
355070,2022,3,2,2,7
355080,2019,0,1,0,1
355080,2020,0,0,1,1
355090,2017,2,0,0,2
355090,2018,0,1,0,1
355090,2019,2,0,0,2
355090,2020,0,0,1,1
355090,2022,1,0,0,1
355100,2015,17,1,9,27
355100,2016,12,5,5,22
355100,2017,19,2,9,30
355100,2018,8,8,13,29
355100,2019,16,5,7,28
355100,2020,12,3,9,24
355100,2021,14,10,13,37
355100,2022,14,5,15,34
355130,2016,1,0,0,1
355130,2018,1,0,0,1
355130,2019,1,0,0,1
355140,2015,0,0,3,3
355140,2017,1,0,0,1
355140,2018,0,0,1,1
355140,2019,0,0,1,1
355140,2020,0,0,1,1
355150,2015,1,1,4,6
355150,2016,2,0,0,2
355150,2017,2,1,0,3
355150,2018,3,2,1,6
355150,2019,2,0,2,4
355150,2020,0,0,1,1
355150,2021,2,1,0,3
355150,2022,1,0,1,2
355160,2015,0,1,0,1
355160,2017,2,0,2,4
355160,2018,1,2,0,3
355160,2019,2,0,0,2
355160,2020,1,0,1,2
355160,2021,2,0,1,3
355160,2022,0,3,1,4
355170,2015,19,3,11,33
355170,2016,9,1,4,14
355170,2017,1,3,2,6
355170,2018,10,4,1,15
355170,2019,8,2,3,13
355170,2020,7,1,8,16
355170,2021,12,5,8,25
355170,2022,11,0,3,14
355180,2016,0,1,0,1
355180,2018,1,0,0,1
355180,2020,0,0,1,1
355190,2016,1,1,3,5
355190,2017,1,0,1,2
355190,2018,3,0,0,3
355190,2019,0,0,2,2
355190,2020,0,1,0,1
355190,2021,1,0,1,2
355200,2019,1,0,1,2
355200,2020,0,0,1,1
355210,2015,1,0,2,3
355210,2016,1,2,2,5
355210,2017,1,1,1,3
355210,2019,1,0,1,2
355210,2021,0,1,0,1
355210,2022,2,0,0,2
355220,2015,23,9,22,54
355220,2016,25,13,15,53
355220,2017,72,14,50,136
355220,2018,55,6,33,94
355220,2019,38,10,18,66
355220,2020,38,7,22,67
355220,2021,49,19,35,103
355220,2022,58,14,32,104
355230,2016,1,0,0,1
355230,2017,1,0,0,1
355230,2020,0,0,1,1
355240,2015,18,7,17,42
355240,2016,14,4,10,28
355240,2017,17,10,16,43
355240,2018,21,7,10,38
355240,2019,20,1,17,38
355240,2020,21,6,6,33
355240,2021,21,10,12,43
355240,2022,6,7,8,21
355250,2015,7,2,12,21
355250,2016,15,2,11,28
355250,2017,19,2,9,30
355250,2018,7,5,16,28
355250,2019,15,5,11,31
355250,2020,7,0,5,12
355250,2021,6,1,8,15
355250,2022,5,1,2,8
355255,2016,2,0,0,2
355255,2017,0,0,2,2
355255,2018,1,0,0,1
355255,2019,1,0,0,1
355255,2021,1,0,0,1
355255,2022,1,0,1,2
355260,2015,1,0,0,1
355260,2018,1,1,0,2
355260,2019,1,0,1,2
355260,2020,0,0,1,1
355270,2018,0,0,1,1
355270,2021,0,1,0,1
355270,2022,0,0,1,1
355280,2015,10,6,4,20
355280,2016,15,7,11,33
355280,2017,19,4,17,40
355280,2018,16,3,10,29
355280,2019,14,3,9,26
355280,2020,14,5,5,24
355280,2021,12,3,7,22
355280,2022,6,0,5,11
355290,2015,1,0,0,1
355290,2019,1,0,0,1
355290,2022,0,1,0,1
355310,2016,1,0,0,1
355310,2017,1,0,0,1
355310,2018,0,0,1,1
355310,2019,0,0,1,1
355310,2020,1,0,0,1
355330,2016,2,0,1,3
355330,2017,3,0,1,4
355330,2018,1,0,0,1
355330,2019,4,0,0,4
355330,2020,0,1,2,3
355330,2021,1,2,0,3
355330,2022,2,1,0,3
355340,2015,2,0,0,2
355340,2016,2,0,0,2
355340,2017,7,1,2,10
355340,2018,3,1,0,4
355340,2019,1,0,0,1
355340,2020,1,0,2,3
355340,2021,1,0,0,1
355360,2015,1,0,0,1
355360,2017,2,0,0,2
355360,2018,0,2,2,4
355360,2019,1,0,0,1
355360,2020,0,1,1,2
355360,2021,0,0,2,2
355365,2021,1,0,0,1
355370,2016,2,1,2,5
355370,2017,0,1,0,1
355370,2019,1,0,1,2
355370,2020,0,0,1,1
355370,2021,1,1,1,3
355370,2022,1,0,1,2
355380,2015,0,1,0,1
355380,2022,1,0,0,1
355390,2017,1,0,1,2
355390,2019,2,0,0,2
355390,2022,0,0,1,1
355395,2015,0,1,0,1
355395,2018,2,2,1,5
355395,2019,0,0,1,1
355395,2021,0,0,1,1
355400,2015,6,2,2,10
355400,2016,1,0,8,9
355400,2017,3,0,3,6
355400,2018,1,2,5,8
355400,2019,8,2,4,14
355400,2020,8,2,3,13
355400,2021,2,1,8,11
355400,2022,4,1,1,6
355410,2015,13,3,10,26
355410,2016,25,6,8,39
355410,2017,38,10,9,57
355410,2018,23,1,6,30
355410,2019,34,4,11,49
355410,2020,21,5,9,35
355410,2021,21,9,10,40
355410,2022,26,7,23,56
355430,2016,1,0,0,1
355430,2017,1,0,3,4
355430,2018,1,0,2,3
355430,2019,1,0,4,5
355430,2020,1,0,5,6
355430,2021,3,0,1,4
355430,2022,1,0,0,1
355440,2016,0,0,1,1
355440,2017,0,1,0,1
355440,2018,0,0,2,2
355440,2020,1,0,0,1
355440,2022,0,0,1,1
355450,2015,2,2,0,4
355450,2016,3,1,2,6
355450,2017,0,0,3,3
355450,2018,3,0,1,4
355450,2020,3,0,1,4
355450,2021,3,0,0,3
355450,2022,4,1,0,5
355470,2015,1,0,0,1
355470,2020,0,0,1,1
355475,2015,0,1,0,1
355475,2016,0,1,0,1
355475,2022,0,0,1,1
355480,2015,3,0,1,4
355480,2016,3,0,0,3
355480,2017,1,0,1,2
355480,2018,2,0,0,2
355480,2019,0,1,1,2
355480,2021,2,1,1,4
355480,2022,1,0,0,1
355490,2019,0,0,2,2
355490,2022,0,0,1,1
355495,2020,1,0,0,1
355500,2015,4,0,0,4
355500,2017,1,0,1,2
355500,2018,6,0,7,13
355500,2019,7,0,3,10
355500,2020,3,1,2,6
355500,2021,1,3,1,5
355500,2022,3,1,0,4
355510,2015,0,1,0,1
355510,2016,0,0,1,1
355510,2017,0,0,1,1
355510,2018,2,0,0,2
355510,2019,0,0,1,1
355510,2020,1,0,1,2
355510,2022,0,0,1,1
355520,2015,0,0,1,1
355520,2017,0,1,0,1
355530,2017,1,0,0,1
355530,2022,0,1,0,1
355535,2015,0,1,0,1
355535,2017,1,0,0,1
355535,2020,0,0,1,1
355540,2015,3,0,2,5
355540,2016,6,0,0,6
355540,2017,0,3,3,6
355540,2018,4,0,1,5
355540,2019,3,1,0,4
355540,2020,2,0,1,3
355540,2021,3,0,0,3
355540,2022,1,0,2,3
355550,2019,1,0,0,1
355550,2021,1,0,0,1
355560,2016,0,1,0,1
355560,2022,0,0,1,1
355580,2015,1,0,3,4
355580,2016,2,0,0,2
355580,2017,1,0,0,1
355580,2019,2,0,0,2
355580,2020,1,0,0,1
355580,2021,1,1,0,2
355600,2018,0,0,1,1
355600,2019,1,0,0,1
355600,2020,2,1,1,4
355600,2022,0,1,0,1
355610,2017,0,0,1,1
355610,2018,0,1,0,1
355610,2019,3,0,0,3
355610,2022,0,0,1,1
355620,2015,8,1,3,12
355620,2016,10,2,12,24
355620,2017,19,7,10,36
355620,2018,18,3,7,28
355620,2019,25,4,6,35
355620,2020,7,2,4,13
355620,2021,10,2,4,16
355620,2022,4,2,6,12
355630,2015,1,0,0,1
355630,2016,1,0,0,1
355630,2018,2,1,0,3
355630,2019,0,0,4,4
355630,2020,2,0,0,2
355630,2022,0,1,0,1
355635,2015,0,0,1,1
355635,2016,0,0,1,1
355635,2017,0,0,1,1
355635,2018,1,0,0,1
355635,2019,2,0,0,2
355635,2020,1,0,0,1
355635,2022,1,0,0,1
355640,2015,2,0,1,3
355640,2016,6,1,5,12
355640,2017,6,0,3,9
355640,2018,3,1,4,8
355640,2019,3,1,2,6
355640,2020,2,2,1,5
355640,2021,3,2,2,7
355640,2022,2,0,1,3
355645,2015,1,0,0,1
355645,2016,3,0,2,5
355645,2017,1,0,1,2
355645,2018,1,0,1,2
355645,2019,0,1,2,3
355645,2020,2,0,0,2
355645,2021,1,1,0,2
355645,2022,0,0,1,1
355650,2015,13,6,9,28
355650,2016,6,2,6,14
355650,2017,9,1,10,20
355650,2018,4,2,7,13
355650,2019,6,2,8,16
355650,2020,8,3,7,18
355650,2021,9,3,5,17
355650,2022,8,0,4,12
355660,2017,0,0,2,2
355660,2018,0,0,1,1
355670,2015,1,0,2,3
355670,2016,5,0,3,8
355670,2017,4,3,2,9
355670,2018,6,2,3,11
355670,2019,3,1,3,7
355670,2020,2,2,2,6
355670,2021,5,1,1,7
355670,2022,2,0,4,6
355680,2015,0,0,1,1
355680,2016,3,0,2,5
355680,2017,2,0,4,6
355680,2018,1,1,1,3
355680,2019,1,0,1,2
355680,2020,1,0,1,2
355680,2021,1,0,0,1
355690,2018,1,0,0,1
355690,2019,1,0,0,1
355695,2021,1,0,0,1
355695,2022,1,0,0,1
355700,2015,6,0,2,8
355700,2016,1,0,1,2
355700,2017,10,0,6,16
355700,2018,4,2,2,8
355700,2019,6,0,2,8
355700,2020,2,3,2,7
355700,2021,0,0,2,2
355700,2022,7,1,8,16
355710,2015,8,2,3,13
355710,2016,13,1,5,19
355710,2017,12,4,5,21
355710,2018,18,5,6,29
355710,2019,9,1,4,14
355710,2020,16,3,6,25
355710,2021,5,3,5,13
355710,2022,7,3,0,10
355715,2021,1,0,0,1
355720,2017,2,0,0,2
355720,2018,2,1,0,3
355720,2021,0,0,1,1
355730,2017,1,0,0,1
355730,2018,1,0,1,2
355730,2019,0,0,2,2
355730,2020,3,1,2,6
355730,2021,0,0,1,1
355730,2022,2,0,0,2
410000,2015,5,0,1,6
410000,2016,1,1,0,2
410000,2017,7,1,0,8
410000,2018,8,2,0,10
410000,2019,3,0,1,4
410000,2020,3,1,0,4
410000,2021,0,1,0,1
410000,2022,3,0,0,3
410010,2015,0,2,0,2
410010,2016,1,0,0,1
410010,2017,1,0,0,1
410010,2019,0,0,1,1
410010,2021,1,0,0,1
410020,2019,0,0,1,1
410030,2022,0,1,0,1
410040,2015,2,1,8,11
410040,2016,2,0,2,4
410040,2017,11,1,3,15
410040,2018,3,1,7,11
410040,2019,3,0,4,7
410040,2020,5,0,3,8
410040,2021,5,2,8,15
410040,2022,4,0,3,7
410050,2022,1,0,0,1
410060,2015,1,0,0,1
410060,2016,0,0,1,1
410060,2017,1,0,0,1
410060,2018,2,0,0,2
410060,2022,1,0,1,2
410070,2017,2,0,1,3
410070,2020,0,0,1,1
410080,2020,0,0,1,1
410100,2016,1,0,1,2
410100,2018,1,0,0,1
410105,2016,0,0,1,1
410105,2022,1,0,0,1
410110,2015,2,0,0,2
410110,2017,3,1,0,4
410110,2019,2,0,2,4
410110,2022,1,0,0,1
410120,2017,2,0,0,2
410120,2021,0,0,1,1
410120,2022,1,0,0,1
410140,2015,6,0,3,9
410140,2016,4,0,5,9
410140,2017,9,1,6,16
410140,2018,9,0,7,16
410140,2019,6,3,3,12
410140,2020,5,0,3,8
410140,2021,1,0,2,3
410140,2022,9,1,1,11
410150,2015,4,0,1,5
410150,2016,1,0,2,3
410150,2017,6,1,0,7
410150,2018,7,1,3,11
410150,2019,10,1,0,11
410150,2020,9,1,3,13
410150,2021,6,2,6,14
410150,2022,6,0,3,9
410160,2015,0,0,1,1
410160,2016,0,0,1,1
410160,2018,1,0,1,2
410160,2019,1,1,0,2
410160,2020,1,0,0,1
410160,2021,0,0,1,1
410160,2022,0,0,1,1
410165,2015,2,0,0,2
410170,2015,0,0,1,1
410170,2016,0,1,0,1
410170,2017,0,0,2,2
410170,2018,1,0,3,4
410170,2019,1,0,2,3
410170,2020,0,0,6,6
410180,2015,9,0,7,16
410180,2016,3,0,3,6
410180,2017,8,2,17,27
410180,2018,5,0,8,13
410180,2019,11,4,9,24
410180,2020,6,2,8,16
410180,2021,15,4,8,27
410180,2022,15,5,9,29
410185,2022,0,1,0,1
410190,2019,1,0,1,2
410190,2020,0,0,1,1
410190,2021,1,0,0,1
410190,2022,1,0,0,1
410200,2015,1,0,0,1
410200,2016,3,0,1,4
410200,2017,2,1,2,5
410200,2018,4,1,1,6
410200,2019,1,0,2,3
410200,2020,1,0,4,5
410200,2021,1,0,0,1
410200,2022,1,0,0,1
410210,2015,0,1,2,3
410210,2018,1,0,0,1
410210,2019,0,1,0,1
410210,2020,7,1,2,10
410210,2021,2,0,0,2
410210,2022,0,0,1,1
410220,2015,0,1,0,1
410220,2016,0,0,1,1
410220,2020,0,1,0,1
410220,2021,2,1,0,3
410230,2015,0,0,1,1
410230,2016,2,0,1,3
410230,2017,1,0,2,3
410230,2018,1,0,1,2
410230,2019,0,0,1,1
410230,2021,0,0,1,1
410230,2022,1,0,0,1
410240,2015,2,0,2,4
410240,2016,1,0,0,1
410240,2018,1,0,1,2
410240,2019,1,0,0,1
410240,2021,5,0,1,6
410240,2022,2,0,0,2
410250,2022,1,0,0,1
410260,2018,1,0,0,1
410280,2016,2,0,0,2
410280,2019,1,0,0,1
410280,2020,1,0,1,2
410280,2022,1,0,1,2
410290,2018,2,0,3,5
410290,2021,2,0,0,2
410290,2022,1,0,0,1
410300,2015,1,0,0,1
410300,2022,0,0,1,1
410302,2018,0,0,1,1
410302,2021,0,0,1,1
410304,2017,1,0,0,1
410304,2018,0,0,1,1
410305,2017,1,0,0,1
410310,2021,1,0,0,1
410322,2017,0,0,1,1
410330,2018,1,0,0,1
410335,2015,1,0,0,1
410335,2018,1,0,1,2
410335,2019,0,0,1,1
410335,2022,0,0,1,1
410345,2015,1,0,0,1
410345,2016,3,0,0,3
410345,2017,1,0,0,1
410345,2018,3,1,3,7
410345,2019,1,0,0,1
410345,2021,2,0,2,4
410345,2022,2,0,0,2
410347,2018,1,0,0,1
410347,2019,1,0,0,1
410350,2018,1,0,0,1
410350,2019,1,0,0,1
410360,2015,2,0,0,2
410360,2016,1,0,0,1
410360,2020,1,0,0,1
410360,2021,1,0,0,1
410360,2022,1,0,0,1
410370,2015,7,0,3,10
410370,2016,2,2,1,5
410370,2017,5,1,2,8
410370,2018,7,2,6,15
410370,2019,12,0,5,17
410370,2020,14,4,1,19
410370,2021,7,0,2,9
410370,2022,7,0,2,9
410380,2015,1,0,1,2
410380,2018,1,0,0,1
410380,2019,1,0,0,1
410380,2021,1,0,0,1
410380,2022,1,0,0,1
410390,2015,0,1,2,3
410390,2018,0,0,2,2
410390,2021,0,0,2,2
410390,2022,0,1,1,2
410400,2015,1,1,4,6
410400,2016,1,0,3,4
410400,2017,2,1,2,5
410400,2018,2,1,5,8
410400,2019,1,0,6,7
410400,2020,2,1,0,3
410400,2021,3,0,3,6
410400,2022,2,2,2,6
410405,2022,0,0,1,1
410420,2015,11,0,8,19
410420,2016,6,1,4,11
410420,2017,7,0,8,15
410420,2018,9,0,6,15
410420,2019,9,0,2,11
410420,2020,11,3,3,17
410420,2021,9,2,2,13
410420,2022,11,0,3,14
410425,2015,2,0,1,3
410425,2016,2,0,0,2
410425,2017,2,1,3,6
410425,2018,0,0,2,2
410425,2019,1,0,1,2
410425,2020,3,0,1,4
410425,2021,1,0,0,1
410425,2022,2,0,0,2
410430,2015,5,1,5,11
410430,2016,11,1,6,18
410430,2017,13,5,12,30
410430,2018,23,4,10,37
410430,2019,14,3,6,23
410430,2020,15,3,11,29
410430,2021,15,2,4,21
410430,2022,17,1,7,25
410440,2018,1,0,0,1
410440,2020,1,0,0,1
410445,2018,0,1,0,1
410445,2019,0,1,0,1
410450,2017,1,0,0,1
410450,2018,1,0,0,1
410450,2020,1,0,0,1
410450,2021,0,1,0,1
410460,2017,1,0,0,1
410460,2020,0,0,1,1
410460,2022,1,0,0,1
410465,2015,3,1,5,9
410465,2016,2,0,1,3
410465,2017,2,0,2,4
410465,2018,3,0,1,4
410465,2019,1,0,1,2
410465,2022,1,0,1,2
410480,2015,19,2,15,36
410480,2016,22,2,19,43
410480,2017,46,4,31,81
410480,2018,38,10,20,68
410480,2019,29,5,8,42
410480,2020,22,1,7,30
410480,2021,33,7,19,59
410480,2022,28,12,24,64
410490,2015,5,0,1,6
410490,2016,3,0,3,6
410490,2017,7,1,2,10
410490,2018,3,0,1,4
410490,2019,5,0,1,6
410490,2021,0,0,1,1
410490,2022,1,0,0,1
410500,2015,0,0,1,1
410500,2019,1,0,1,2
410500,2022,1,0,0,1
410510,2021,1,0,1,2
410510,2022,0,0,1,1
410520,2019,0,0,1,1
410530,2015,3,0,1,4
410530,2016,1,0,0,1
410530,2018,1,0,0,1
410530,2020,1,0,0,1
410540,2015,1,0,0,1
410540,2016,2,0,1,3
410540,2017,2,1,1,4
410540,2018,1,0,0,1
410540,2019,0,1,1,2
410540,2020,1,0,0,1
410540,2021,0,0,1,1
410540,2022,0,0,1,1
410550,2015,4,1,1,6
410550,2016,4,2,2,8
410550,2017,4,0,2,6
410550,2018,2,1,0,3
410550,2019,2,0,1,3
410550,2020,0,0,1,1
410550,2021,2,0,1,3
410550,2022,3,1,0,4
410560,2016,0,0,1,1
410560,2017,0,0,1,1
410560,2018,2,0,1,3
410560,2019,1,0,0,1
410560,2021,2,0,0,2
410560,2022,0,0,1,1
410570,2015,1,0,0,1
410570,2016,2,0,0,2
410570,2017,1,0,0,1
410570,2018,2,1,0,3
410570,2020,1,0,1,2
410570,2021,0,0,1,1
410570,2022,3,0,2,5
410580,2015,13,0,8,21
410580,2016,15,1,11,27
410580,2017,18,4,15,37
410580,2018,21,2,4,27
410580,2019,8,7,13,28
410580,2020,16,4,13,33
410580,2021,10,1,6,17
410580,2022,12,4,5,21
410590,2015,1,0,0,1
410590,2016,1,0,2,3
410590,2017,1,0,1,2
410590,2018,2,0,0,2
410590,2019,2,0,0,2
410590,2020,0,1,1,2
410590,2021,2,2,3,7
410590,2022,0,0,1,1
410610,2018,0,1,0,1
410630,2015,2,0,0,2
410630,2016,2,0,0,2
410630,2017,1,0,1,2
410630,2018,2,0,1,3
410630,2019,2,0,1,3
410630,2021,2,0,1,3
410630,2022,2,1,1,4
410640,2016,7,1,3,11
410640,2017,5,0,0,5
410640,2018,1,0,1,2
410640,2019,2,1,0,3
410640,2020,5,0,0,5
410640,2021,2,0,0,2
410640,2022,1,0,2,3
410645,2016,0,0,3,3
410645,2022,0,1,0,1
410650,2015,2,0,1,3
410650,2016,4,0,1,5
410650,2017,6,0,2,8
410650,2018,1,6,3,10
410650,2019,2,0,0,2
410650,2020,1,1,1,3
410650,2022,0,0,2,2
410660,2016,1,0,0,1
410660,2019,1,1,1,3
410660,2020,0,0,2,2
410660,2021,2,0,3,5
410660,2022,1,0,1,2
410670,2017,0,0,1,1
410680,2017,1,0,0,1
410690,2015,225,53,123,401
410690,2016,212,35,97,344
410690,2017,258,49,155,462
410690,2018,242,55,102,399
410690,2019,234,61,93,388
410690,2020,201,58,77,336
410690,2021,199,65,83,347
410690,2022,237,68,89,394
410700,2017,2,0,2,4
410700,2018,2,0,1,3
410700,2019,0,0,1,1
410700,2021,0,0,1,1
410700,2022,0,1,1,2
410710,2016,1,0,0,1
410715,2015,1,0,0,1
410720,2015,4,2,3,9
410720,2016,3,2,0,5
410720,2017,5,0,0,5
410720,2018,5,1,3,9
410720,2019,4,0,1,5
410720,2020,2,0,1,3
410720,2021,1,1,3,5
410720,2022,3,0,3,6
410725,2015,2,0,1,3
410725,2016,2,1,0,3
410725,2017,1,0,2,3
410725,2018,4,1,1,6
410725,2020,3,0,1,4
410725,2021,1,0,0,1
410725,2022,2,0,0,2
410730,2016,0,0,2,2
410730,2019,1,0,0,1
410730,2020,3,0,1,4
410730,2021,2,0,1,3
410730,2022,1,0,0,1
410740,2018,2,0,0,2
410750,2016,1,0,0,1
410750,2017,0,0,1,1
410750,2018,2,0,0,2
410750,2019,3,0,0,3
410750,2020,1,0,0,1
410750,2022,1,0,0,1
410753,2015,1,0,0,1
410753,2016,0,0,1,1
410753,2019,1,0,0,1
410753,2020,0,0,1,1
410755,2018,1,0,1,2
410760,2015,1,0,1,2
410760,2016,1,0,0,1
410760,2017,0,0,2,2
410760,2019,1,0,0,1
410760,2020,0,0,1,1
410765,2015,4,0,3,7
410765,2016,3,0,3,6
410765,2017,1,1,2,4
410765,2018,2,0,7,9
410765,2019,5,1,4,10
410765,2020,1,1,3,5
410765,2021,0,2,2,4
410765,2022,6,0,4,10
410770,2018,0,0,2,2
410770,2019,0,0,2,2
410770,2021,2,0,0,2
410770,2022,1,0,0,1
410775,2022,0,1,0,1
410780,2016,0,0,2,2
410780,2019,2,0,1,3
410785,2017,0,0,1,1
410785,2022,1,0,0,1
410790,2015,0,0,4,4
410790,2017,1,0,1,2
410790,2022,2,0,1,3
410800,2019,0,0,1,1
410800,2020,0,0,1,1
410820,2021,1,0,0,1
410830,2015,9,1,13,23
410830,2016,7,2,6,15
410830,2017,12,1,6,19
410830,2018,7,1,6,14
410830,2019,7,2,4,13
410830,2020,10,2,3,15
410830,2021,14,4,3,21
410830,2022,14,3,4,21
410832,2016,0,1,0,1
410832,2017,0,1,0,1
410832,2019,1,0,0,1
410832,2020,1,0,1,2
410832,2021,0,1,0,1
410840,2015,5,1,4,10
410840,2016,5,1,7,13
410840,2017,5,0,0,5
410840,2018,1,3,3,7
410840,2019,3,1,0,4
410840,2020,3,0,3,6
410840,2021,0,2,1,3
410840,2022,2,0,0,2
410850,2016,0,0,1,1
410850,2018,4,0,0,4
410850,2020,0,0,2,2
410860,2015,0,0,1,1
410860,2016,2,1,1,4
410860,2017,1,1,1,3
410860,2018,1,0,1,2
410860,2019,1,0,0,1
410860,2021,0,0,2,2
410860,2022,0,0,1,1
410870,2016,1,0,0,1
410870,2020,0,1,0,1
410880,2015,1,0,2,3
410880,2017,2,0,1,3
410880,2018,4,0,0,4
410880,2019,5,0,1,6
410880,2020,4,0,0,4
410880,2021,2,0,0,2
410890,2019,0,0,1,1
410890,2021,0,1,0,1
410895,2018,1,0,0,1
410895,2019,1,0,0,1
410910,2022,1,0,0,1
410920,2016,1,0,0,1
410930,2018,1,0,0,1
410930,2019,0,0,1,1
410930,2021,1,0,0,1
410940,2015,12,0,2,14
410940,2016,6,2,6,14
410940,2017,6,5,5,16
410940,2018,11,2,7,20
410940,2019,9,4,5,18
410940,2020,5,1,0,6
410940,2021,4,1,5,10
410940,2022,0,0,3,3
410950,2021,1,0,0,1
410960,2015,0,0,1,1
410965,2017,5,0,0,5
410965,2018,0,0,1,1
410970,2016,2,0,0,2
410970,2018,0,0,2,2
410970,2021,1,0,0,1
410975,2017,1,0,2,3
410975,2019,1,0,0,1
410980,2015,2,1,0,3
410980,2016,3,0,1,4
410980,2017,2,0,1,3
410980,2018,1,3,4,8
410980,2019,6,1,0,7
410980,2020,11,2,0,13
410980,2021,9,2,1,12
410980,2022,6,1,2,9
411000,2018,1,0,0,1
411000,2021,1,0,1,2
411005,2015,1,0,0,1
411005,2019,1,0,0,1
411007,2017,0,0,1,1
411007,2018,0,0,1,1
411007,2019,0,0,2,2
411007,2020,1,0,0,1
411010,2017,0,0,1,1
411030,2022,0,0,1,1
411050,2015,1,0,0,1
411050,2016,1,0,0,1
411050,2019,1,0,0,1
411060,2015,0,0,1,1
411060,2016,1,1,0,2
411060,2018,1,0,0,1
411060,2020,0,1,0,1
411070,2015,1,0,4,5
411070,2016,2,0,1,3
411070,2017,0,1,1,2
411070,2018,2,1,0,3
411070,2019,2,0,2,4
411070,2020,0,0,2,2
411070,2021,1,0,1,2
411070,2022,5,0,3,8
411080,2015,0,0,1,1
411080,2018,0,0,1,1
411080,2020,0,0,1,1
411080,2022,0,0,1,1
411095,2018,1,0,0,1
411095,2021,1,0,0,1
411095,2022,2,0,0,2
411100,2018,1,0,0,1
411100,2021,1,0,0,1
411100,2022,1,0,0,1
411110,2015,1,1,0,2
411110,2018,1,0,0,1
411110,2019,1,0,0,1
411110,2020,1,0,0,1
411110,2021,1,0,0,1
411120,2016,0,0,1,1
411120,2017,1,0,0,1
411120,2019,2,0,0,2
411120,2021,2,0,1,3
411120,2022,1,1,0,2
411125,2015,1,0,1,2
411125,2018,1,0,0,1
411130,2020,1,0,0,1
411150,2015,2,0,1,3
411150,2016,1,1,1,3
411150,2017,1,0,2,3
411150,2018,3,0,3,6
411150,2019,1,1,0,2
411150,2020,0,0,1,1
411150,2021,1,0,2,3
411150,2022,1,0,0,1
411155,2016,1,0,0,1
411155,2018,1,0,0,1
411155,2019,0,0,1,1
411155,2020,1,0,0,1
411180,2015,0,0,1,1
411180,2017,2,0,2,4
411180,2018,2,0,2,4
411180,2019,6,1,1,8
411180,2020,1,0,0,1
411180,2021,1,1,1,3
411180,2022,3,2,0,5
411190,2018,1,0,0,1
411190,2021,0,1,0,1
411200,2015,1,0,1,2
411200,2016,0,0,1,1
411200,2017,0,0,1,1
411200,2018,1,0,0,1
411200,2020,1,0,0,1
411200,2021,1,1,0,2
411200,2022,1,1,0,2
411210,2015,1,0,0,1
411210,2016,0,0,1,1
411210,2017,0,0,2,2
411210,2020,0,1,1,2
411210,2021,1,0,0,1
411210,2022,1,0,2,3
411220,2017,0,0,1,1
411220,2018,1,0,0,1
411240,2021,2,0,0,2
411250,2018,0,1,0,1
411270,2017,0,0,1,1
411270,2018,0,0,1,1
411275,2018,1,0,0,1
411280,2016,1,0,0,1
411280,2019,1,0,1,2
411295,2017,0,0,1,1
411295,2018,1,0,1,2
411295,2019,0,0,2,2
411295,2020,1,0,0,1
411295,2021,1,0,0,1
411295,2022,0,0,1,1
411300,2018,2,0,0,2
411320,2015,1,0,0,1
411320,2017,1,0,1,2
411320,2018,2,0,1,3
411320,2020,1,0,0,1
411320,2021,1,0,0,1
411325,2015,1,0,0,1
411330,2016,1,0,0,1
411330,2018,1,0,0,1
411330,2019,1,0,0,1
411330,2022,0,1,0,1
411342,2020,0,0,1,1
411350,2018,0,0,1,1
411350,2019,3,1,0,4
411350,2020,1,0,0,1
411360,2016,1,0,0,1
411360,2019,1,0,0,1
411360,2021,1,1,0,2
411370,2015,26,2,13,41
411370,2016,37,6,10,53
411370,2017,42,8,27,77
411370,2018,48,11,21,80
411370,2019,37,8,23,68
411370,2020,36,10,21,67
411370,2021,29,3,17,49
411370,2022,45,13,13,71
411373,2015,0,0,1,1
411373,2016,0,0,2,2
411373,2017,0,0,2,2
411375,2020,1,0,0,1
411380,2022,1,1,0,2
411390,2017,1,0,1,2
411390,2019,1,0,0,1
411390,2021,0,0,1,1
411400,2017,0,0,2,2
411400,2018,1,0,1,2
411400,2020,0,0,1,1
411400,2021,0,0,1,1
411400,2022,0,0,2,2
411410,2015,0,0,3,3
411410,2016,2,0,2,4
411410,2017,0,0,1,1
411410,2018,2,0,1,3
411410,2019,3,0,3,6
411410,2020,3,1,2,6
411410,2021,0,2,2,4
411410,2022,3,0,4,7
411420,2015,2,0,2,4
411420,2016,5,1,1,7
411420,2017,4,0,3,7
411420,2018,1,1,0,2
411420,2019,3,1,1,5
411420,2020,4,1,1,6
411420,2021,3,1,0,4
411420,2022,2,2,3,7
411430,2015,2,0,1,3
411430,2016,1,0,1,2
411430,2019,0,0,1,1
411430,2020,1,0,0,1
411430,2021,0,0,1,1
411430,2022,0,0,1,1
411440,2015,1,0,1,2
411440,2016,3,0,0,3
411440,2017,1,0,1,2
411440,2018,1,0,2,3
411440,2022,1,0,1,2
411450,2017,0,0,3,3
411450,2018,0,1,0,1
411450,2019,1,0,2,3
411450,2020,0,1,0,1
411450,2022,1,0,0,1
411460,2015,11,2,7,20
411460,2016,8,2,8,18
411460,2017,10,2,7,19
411460,2018,7,1,9,17
411460,2019,9,2,5,16
411460,2020,6,1,4,11
411460,2021,10,0,4,14
411460,2022,4,0,4,8
411470,2015,1,1,0,2
411470,2017,0,0,1,1
411480,2015,3,1,1,5
411480,2016,2,0,0,2
411480,2017,4,0,2,6
411480,2018,2,1,1,4
411480,2019,11,2,6,19
411480,2020,3,2,0,5
411480,2021,7,0,3,10
411480,2022,6,1,7,14
411510,2018,0,0,1,1
411510,2022,0,0,1,1
411520,2015,52,7,43,102
411520,2016,64,6,30,100
411520,2017,63,6,23,92
411520,2018,52,6,23,81
411520,2019,63,16,29,108
411520,2020,68,10,33,111
411520,2021,55,13,18,86
411520,2022,72,19,32,123
411530,2017,1,0,0,1
411530,2018,1,0,0,1
411530,2019,2,0,2,4
411530,2020,1,0,1,2
411535,2016,1,0,0,1
411535,2017,2,0,0,2
411535,2018,0,1,0,1
411535,2019,0,0,2,2
411540,2016,0,0,1,1
411540,2019,1,0,0,1
411560,2015,7,0,1,8
411560,2016,3,0,1,4
411560,2017,3,1,4,8
411560,2018,5,0,1,6
411560,2021,1,0,0,1
411560,2022,0,0,1,1
411570,2016,1,0,1,2
411570,2017,1,1,1,3
411570,2019,0,1,1,2
411570,2020,1,0,1,2
411570,2021,0,0,1,1
411575,2019,0,0,1,1
411580,2015,7,2,10,19
411580,2016,12,2,9,23
411580,2017,14,0,8,22
411580,2018,12,4,6,22
411580,2019,1,0,2,3
411580,2020,4,1,0,5
411580,2021,3,0,0,3
411580,2022,9,2,10,21
411585,2016,1,0,0,1
411585,2017,0,0,1,1
411585,2018,1,0,1,2
411585,2020,1,0,0,1
411585,2021,1,0,0,1
411600,2022,0,0,1,1
411605,2015,2,0,0,2
411605,2017,1,0,1,2
411605,2018,2,0,0,2
411605,2022,0,0,1,1
411620,2015,1,0,0,1
411620,2019,1,0,1,2
411620,2022,0,1,0,1
411630,2022,1,0,0,1
411670,2015,0,1,0,1
411670,2016,1,0,0,1
411670,2017,1,0,1,2
411670,2018,1,0,0,1
411670,2021,0,1,0,1
411670,2022,1,0,1,2
411690,2015,2,1,1,4
411690,2016,0,0,1,1
411690,2017,2,0,1,3
411690,2018,1,2,0,3
411690,2019,2,0,2,4
411690,2020,1,0,4,5
411690,2021,1,2,0,3
411695,2016,0,0,1,1
411700,2022,0,0,2,2
411710,2018,0,1,1,2
411710,2019,0,0,1,1
411710,2020,1,0,0,1
411720,2015,1,0,0,1
411720,2022,1,0,1,2
411721,2016,1,0,0,1
411721,2019,0,1,0,1
411721,2020,0,1,1,2
411722,2015,0,0,1,1
411722,2016,2,0,1,3
411722,2017,2,0,0,2
411722,2018,1,0,1,2
411722,2019,1,0,0,1
411722,2020,0,0,4,4
411722,2021,0,0,3,3
411727,2015,1,0,0,1
411727,2019,0,0,1,1
411730,2019,0,0,1,1
411740,2017,1,0,0,1
411740,2021,1,1,0,2
411740,2022,0,1,0,1
411745,2016,1,0,0,1
411745,2019,0,0,1,1
411745,2020,1,0,0,1
411745,2021,1,0,0,1
411750,2015,3,2,2,7
411750,2016,1,0,3,4
411750,2017,1,0,4,5
411750,2018,2,0,1,3
411750,2019,3,0,2,5
411750,2020,4,0,3,7
411750,2021,4,0,4,8
411750,2022,1,0,1,2
411760,2015,2,0,1,3
411760,2016,2,0,3,5
411760,2017,7,0,2,9
411760,2018,2,0,1,3
411760,2021,0,1,0,1
411760,2022,0,1,0,1
411770,2016,3,0,1,4
411770,2017,0,0,1,1
411770,2018,3,1,0,4
411770,2019,0,0,1,1
411770,2021,0,1,0,1
411770,2022,0,0,1,1
411780,2016,0,0,1,1
411780,2019,1,0,0,1
411790,2015,0,0,1,1
411790,2016,5,0,1,6
411790,2017,6,0,1,7
411790,2018,1,0,0,1
411790,2019,4,0,5,9
411790,2020,9,1,1,11
411790,2021,2,1,1,4
411790,2022,6,1,2,9
411800,2017,1,0,0,1
411800,2018,2,0,0,2
411810,2015,1,0,0,1
411810,2016,0,1,0,1
411810,2018,0,0,1,1
411820,2015,10,0,7,17
411820,2016,7,2,14,23
411820,2017,16,0,16,32
411820,2018,8,1,12,21
411820,2019,5,2,10,17
411820,2020,5,0,5,10
411820,2021,4,1,6,11
411820,2022,5,1,6,12
411840,2015,4,0,2,6
411840,2016,4,0,1,5
411840,2017,1,0,3,4
411840,2018,5,0,1,6
411840,2019,1,0,1,2
411840,2020,0,2,1,3
411840,2021,3,0,2,5
411840,2022,5,1,2,8
411845,2016,1,1,0,2
411845,2017,1,0,0,1
411845,2018,3,0,0,3
411845,2019,0,0,1,1
411845,2021,1,0,0,1
411850,2015,11,0,8,19
411850,2016,6,0,4,10
411850,2017,10,1,8,19
411850,2018,16,1,4,21
411850,2019,10,0,5,15
411850,2020,6,1,2,9
411850,2021,4,1,1,6
411850,2022,11,1,3,15
411870,2020,1,0,0,1
411880,2015,1,0,0,1
411880,2017,1,0,0,1
411880,2018,3,0,0,3
411880,2019,0,0,2,2
411880,2020,1,0,2,3
411880,2022,2,0,0,2
411885,2017,1,0,0,1
411885,2019,1,0,0,1
411885,2021,1,0,0,1
411890,2019,2,0,0,2
411910,2015,1,0,0,1
411910,2020,0,0,1,1
411910,2021,0,0,1,1
411910,2022,1,0,2,3
411915,2015,5,0,4,9
411915,2016,7,1,1,9
411915,2017,11,0,4,15
411915,2018,5,0,4,9
411915,2019,9,2,3,14
411915,2020,7,0,2,9
411915,2021,7,2,3,12
411915,2022,7,1,4,12
411925,2019,1,0,0,1
411930,2016,1,0,0,1
411930,2017,1,0,0,1
411930,2019,0,0,1,1
411930,2022,0,0,1,1
411940,2017,1,0,0,1
411950,2015,1,1,6,8
411950,2016,0,0,1,1
411950,2017,2,0,3,5
411950,2018,4,1,1,6
411950,2019,0,1,1,2
411950,2020,1,0,3,4
411950,2021,5,0,5,10
411950,2022,1,1,2,4
411960,2016,1,0,0,1
411960,2017,0,0,1,1
411960,2018,2,1,1,4
411960,2019,0,1,1,2
411960,2020,1,0,0,1
411990,2015,32,3,18,53
411990,2016,25,5,34,64
411990,2017,31,10,23,64
411990,2018,22,1,15,38
411990,2019,8,1,10,19
411990,2020,15,2,11,28
411990,2021,4,2,6,12
411990,2022,12,3,8,23
411995,2015,0,0,1,1
411995,2016,0,0,1,1
411995,2017,1,0,2,3
411995,2022,1,0,1,2
412000,2016,1,0,0,1
412000,2019,1,0,0,1
412000,2020,0,0,1,1
412000,2022,0,0,1,1
412035,2020,1,0,0,1
412040,2015,0,0,3,3
412040,2016,0,0,1,1
412040,2017,1,0,0,1
412040,2019,0,0,1,1
412040,2020,0,0,1,1
412040,2022,0,0,1,1
412050,2018,3,0,1,4
412050,2019,1,0,0,1
412050,2020,1,0,0,1
412050,2022,0,1,0,1
412060,2016,1,0,1,2
412060,2017,1,0,0,1
412060,2020,0,1,0,1
412060,2022,0,1,0,1
412065,2018,1,0,0,1
412065,2020,2,0,0,2
412065,2022,0,0,1,1
412080,2015,0,0,3,3
412080,2016,1,0,2,3
412080,2017,0,0,1,1
412080,2018,0,0,2,2
412080,2019,1,1,1,3
412080,2020,1,0,2,3
412080,2021,1,1,2,4
412080,2022,1,0,0,1
412085,2016,2,0,0,2
412085,2017,0,1,0,1
412085,2018,1,0,0,1
412085,2020,2,0,1,3
412085,2021,0,0,1,1
412085,2022,0,0,1,1
412090,2016,1,0,0,1
412090,2018,1,0,0,1
412090,2020,0,0,1,1
412100,2022,1,0,0,1
412110,2017,1,0,0,1
412120,2017,1,0,0,1
412120,2022,0,1,0,1
412125,2015,1,0,0,1
412130,2018,0,1,0,1
412135,2016,0,0,1,1
412135,2019,0,2,0,2
412140,2015,1,1,0,2
412140,2016,2,0,0,2
412140,2018,0,0,1,1
412140,2020,1,0,0,1
412140,2021,2,0,1,3
412160,2016,2,0,0,2
412170,2016,0,1,0,1
412170,2017,0,0,1,1
412170,2018,1,0,0,1
412170,2019,1,0,0,1
412170,2022,1,0,0,1
412175,2017,1,0,0,1
412175,2020,1,0,0,1
412175,2021,1,0,0,1
412180,2018,1,0,0,1
412190,2015,1,0,0,1
412190,2016,1,0,1,2
412190,2018,1,0,0,1
412200,2015,1,0,0,1
412200,2022,1,0,0,1
412210,2021,1,0,0,1
412215,2017,1,0,0,1
412220,2015,1,0,0,1
412220,2016,0,0,1,1
412220,2017,0,0,2,2
412220,2018,1,0,3,4
412220,2019,0,1,0,1
412220,2020,1,0,0,1
412220,2022,1,0,1,2
412230,2017,2,0,0,2
412230,2018,0,2,1,3
412230,2019,1,1,0,2
412230,2020,3,0,0,3
412230,2022,1,0,0,1
412240,2015,1,1,0,2
412240,2016,1,2,1,4
412240,2017,3,1,0,4
412240,2018,0,1,2,3
412240,2019,8,1,4,13
412240,2020,4,1,2,7
412240,2021,3,0,0,3
412240,2022,5,2,1,8
412250,2021,1,0,0,1
412250,2022,2,0,0,2
412260,2015,1,0,1,2
412260,2016,1,0,0,1
412260,2018,0,0,1,1
412260,2019,0,0,1,1
412270,2017,0,0,1,1
412270,2021,0,0,1,1
412270,2022,0,0,1,1
412280,2015,1,0,0,1
412280,2017,0,0,1,1
412300,2018,2,0,0,2
412300,2019,0,1,1,2
412300,2020,0,0,1,1
412320,2020,1,0,0,1
412330,2018,1,0,0,1
412340,2016,1,0,0,1
412340,2020,1,0,0,1
412340,2021,2,0,0,2
412350,2015,1,0,0,1
412350,2016,0,0,1,1
412350,2017,1,0,1,2
412350,2018,0,0,2,2
412350,2019,1,0,1,2
412350,2020,3,0,1,4
412350,2021,0,0,2,2
412350,2022,2,1,0,3
412370,2018,0,1,0,1
412380,2016,0,0,1,1
412380,2022,1,0,0,1
412390,2022,0,0,1,1
412395,2015,1,0,0,1
412395,2022,0,0,1,1
412402,2017,1,0,1,2
412402,2018,1,0,0,1
412402,2021,1,0,0,1
412402,2022,2,0,0,2
412405,2015,1,0,0,1
412405,2016,4,0,0,4
412405,2017,1,0,2,3
412405,2018,1,0,0,1
412405,2019,1,0,0,1
412405,2020,1,0,0,1
412410,2015,1,0,0,1
412410,2016,0,0,1,1
412410,2019,0,0,3,3
412410,2021,1,0,0,1
412410,2022,0,0,3,3
412440,2022,1,0,0,1
412460,2022,1,0,0,1
412470,2018,1,0,0,1
412480,2017,4,0,1,5
412480,2018,0,0,1,1
412480,2019,1,0,0,1
412480,2022,0,0,1,1
412500,2017,1,0,0,1
412500,2018,2,0,1,3
412500,2022,0,1,0,1
412510,2019,1,0,0,1
412510,2020,1,0,0,1
412510,2022,1,0,0,1
412520,2016,1,0,0,1
412520,2018,1,0,0,1
412520,2021,1,0,1,2
412520,2022,0,0,1,1
412530,2016,1,1,0,2
412530,2018,1,0,0,1
412530,2020,1,0,0,1
412540,2018,0,0,2,2
412545,2021,2,0,0,2
412545,2022,1,0,0,1
412550,2015,16,2,11,29
412550,2016,19,1,15,35
412550,2017,25,1,13,39
412550,2018,12,3,7,22
412550,2019,17,4,14,35
412550,2020,20,2,7,29
412550,2021,8,6,8,22
412550,2022,13,4,7,24
412560,2015,1,0,1,2
412560,2016,1,0,0,1
412560,2017,1,0,0,1
412560,2018,1,0,1,2
412560,2019,3,0,1,4
412560,2020,2,1,1,4
412560,2021,1,0,0,1
412560,2022,4,0,0,4
412570,2015,1,0,3,4
412570,2016,1,0,4,5
412570,2017,3,1,2,6
412570,2018,2,0,4,6
412570,2019,0,1,1,2
412570,2020,2,0,0,2
412570,2021,3,0,0,3
412570,2022,2,0,2,4
412575,2016,0,1,0,1
412575,2018,2,0,1,3
412575,2022,0,0,1,1
412580,2015,0,0,1,1
412580,2016,1,0,0,1
412580,2017,1,0,1,2
412580,2018,1,0,0,1
412580,2022,1,0,2,3
412600,2020,0,0,1,1
412600,2022,0,0,1,1
412610,2016,1,0,0,1
412620,2018,1,0,0,1
412620,2019,1,0,0,1
412620,2021,0,0,1,1
412625,2015,4,0,4,8
412625,2016,8,0,7,15
412625,2017,2,1,3,6
412625,2018,6,0,1,7
412625,2019,9,3,7,19
412625,2020,4,0,1,5
412625,2021,4,0,6,10
412625,2022,2,1,3,6
412627,2020,1,0,0,1
412630,2017,1,0,0,1
412630,2020,1,0,0,1
412635,2018,0,0,1,1
412635,2022,1,0,0,1
412640,2020,1,1,0,2
412650,2015,1,0,0,1
412650,2017,2,0,0,2
412650,2018,4,1,1,6
412650,2019,1,1,0,2
412650,2020,2,0,1,3
412650,2022,2,0,0,2
412660,2021,1,0,0,1
412665,2018,0,0,1,1
412667,2016,0,0,1,1
412667,2017,1,0,0,1
412667,2019,1,0,0,1
412667,2021,0,0,1,1
412667,2022,0,0,1,1
412680,2016,2,0,1,3
412680,2017,2,0,1,3
412680,2018,0,1,0,1
412680,2021,1,1,0,2
412680,2022,0,0,1,1
412690,2021,1,0,0,1
412710,2015,4,1,7,12
412710,2016,4,1,8,13
412710,2017,8,2,9,19
412710,2018,9,2,9,20
412710,2019,16,0,4,20
412710,2020,4,2,5,11
412710,2021,6,1,5,12
412710,2022,4,1,6,11
412720,2022,0,1,0,1
412730,2018,1,1,1,3
412730,2019,0,0,1,1
412730,2020,0,0,1,1
412730,2022,1,0,0,1
412740,2017,1,0,0,1
412740,2018,0,0,1,1
412740,2019,1,1,1,3
412740,2020,1,1,2,4
412740,2021,0,0,1,1
412740,2022,1,0,1,2
412750,2015,0,0,1,1
412750,2016,0,0,1,1
412750,2017,0,0,1,1
412750,2018,1,0,1,2
412750,2019,2,1,0,3
412760,2015,1,0,0,1
412760,2016,1,0,0,1
412760,2018,0,0,1,1
412760,2019,0,0,2,2
412760,2020,1,0,0,1
412770,2015,7,1,10,18
412770,2016,10,0,9,19
412770,2017,7,4,9,20
412770,2018,4,0,5,9
412770,2019,5,2,3,10
412770,2020,5,2,8,15
412770,2021,9,8,0,17
412770,2022,3,1,3,7
412790,2018,0,0,1,1
412790,2020,1,0,0,1
412795,2020,0,0,1,1
412795,2022,0,0,1,1
412796,2019,1,0,1,2
412796,2020,0,0,1,1
412800,2015,1,0,1,2
412800,2016,4,1,1,6
412800,2017,2,0,1,3
412800,2018,1,0,3,4
412800,2019,4,0,0,4
412800,2020,1,0,1,2
412800,2021,6,1,1,8
412800,2022,3,0,2,5
412810,2015,4,0,5,9
412810,2016,3,0,5,8
412810,2017,0,0,3,3
412810,2018,5,0,1,6
412810,2019,8,1,2,11
412810,2020,2,2,2,6
412810,2021,6,3,3,12
412810,2022,6,0,4,10
412820,2015,2,0,1,3
412820,2016,4,2,3,9
412820,2017,2,0,0,2
412820,2018,1,0,1,2
412820,2019,5,0,0,5
412820,2020,0,1,4,5
412820,2021,4,0,4,8
412820,2022,3,0,1,4
412840,2018,1,0,0,1
412840,2019,1,0,0,1
412840,2022,1,0,0,1
412850,2015,1,0,0,1
412850,2017,0,0,1,1
412850,2018,1,0,0,1
412850,2022,1,0,0,1
412855,2015,1,0,0,1
412855,2016,1,0,0,1
412855,2017,1,0,0,1
412860,2018,1,0,2,3
412860,2019,0,0,3,3
412862,2022,1,0,0,1
412870,2015,0,0,1,1
412870,2016,0,0,1,1
412870,2017,4,0,0,4
412870,2018,1,0,1,2
412870,2021,1,0,0,1
412880,2018,1,0,0,1
420000,2015,3,1,1,5
420000,2016,4,1,1,6
420000,2017,3,1,0,4
420000,2018,4,0,0,4
420000,2019,4,2,0,6
420000,2020,3,1,0,4
420000,2021,3,0,1,4
420005,2017,1,0,0,1
420005,2021,0,0,1,1
420010,2016,1,0,1,2
420010,2018,0,0,1,1
420010,2019,0,0,1,1
420010,2020,0,0,2,2
420010,2021,1,0,1,2
420020,2021,0,0,1,1
420040,2015,0,1,0,1
420040,2022,1,0,0,1
420050,2015,2,0,0,2
420050,2020,1,0,0,1
420060,2015,0,0,1,1
420060,2016,1,0,0,1
420060,2017,1,0,0,1
420060,2022,1,0,0,1
420070,2015,1,0,1,2
420070,2016,1,0,0,1
420070,2018,1,0,0,1
420070,2019,0,0,1,1
420070,2021,1,0,0,1
420070,2022,0,0,1,1
420075,2018,0,0,1,1
420075,2020,0,0,3,3
420075,2021,1,0,0,1
420075,2022,1,0,0,1
420090,2016,1,0,0,1
420090,2021,1,0,0,1
420090,2022,1,0,0,1
420100,2021,1,0,0,1
420110,2021,0,0,1,1
420120,2015,1,1,0,2
420120,2016,0,0,2,2
420120,2017,0,2,1,3
420120,2018,0,0,1,1
420120,2019,1,0,1,2
420120,2020,1,0,2,3
420120,2022,1,0,0,1
420125,2017,1,0,0,1
420125,2018,0,1,0,1
420125,2021,0,1,0,1
420127,2016,1,0,0,1
420127,2019,1,0,0,1
420127,2020,0,0,1,1
420130,2015,0,0,2,2
420130,2016,4,0,3,7
420130,2017,4,0,0,4
420130,2018,2,0,1,3
420130,2019,2,3,2,7
420130,2020,2,0,2,4
420130,2021,3,0,1,4
420130,2022,2,0,1,3
420140,2015,5,1,1,7
420140,2016,5,1,0,6
420140,2017,3,0,2,5
420140,2018,4,0,2,6
420140,2019,7,0,0,7
420140,2020,2,0,0,2
420140,2021,4,0,1,5
420140,2022,2,1,2,5
420150,2019,1,0,0,1
420150,2020,1,0,0,1
420160,2021,1,0,0,1
420170,2019,1,0,0,1
420170,2022,1,0,0,1
420190,2018,0,0,1,1
420195,2015,1,0,0,1
420195,2022,1,1,0,2
420200,2015,8,1,6,15
420200,2016,8,0,3,11
420200,2017,9,0,3,12
420200,2018,9,3,3,15
420200,2019,2,0,0,2
420200,2020,8,3,1,12
420200,2021,2,5,0,7
420200,2022,6,3,5,14
420205,2015,1,0,0,1
420205,2022,0,0,1,1
420207,2017,0,0,1,1
420207,2022,1,0,0,1
420208,2022,1,0,0,1
420210,2015,1,0,1,2
420210,2017,0,0,1,1
420210,2018,2,0,0,2
420210,2020,1,1,1,3
420213,2020,1,0,0,1
420215,2017,1,0,0,1
420220,2016,0,0,1,1
420220,2020,0,0,1,1
420220,2022,1,0,0,1
420230,2015,12,1,7,20
420230,2016,7,2,4,13
420230,2017,10,1,5,16
420230,2018,3,0,3,6
420230,2019,3,5,3,11
420230,2020,4,2,5,11
420230,2021,7,2,2,11
420230,2022,6,2,3,11
420240,2015,20,0,5,25
420240,2016,19,1,9,29
420240,2017,21,5,13,39
420240,2018,20,0,14,34
420240,2019,22,5,11,38
420240,2020,34,8,10,52
420240,2021,28,8,13,49
420240,2022,38,12,20,70
420245,2015,0,0,1,1
420250,2018,1,0,1,2
420260,2020,0,0,1,1
420260,2021,0,0,1,1
420270,2019,1,0,0,1
420280,2015,1,0,1,2
420280,2016,3,0,2,5
420280,2018,6,0,3,9
420280,2019,4,1,0,5
420280,2020,4,1,1,6
420280,2021,6,0,6,12
420280,2022,2,2,2,6
420285,2020,0,1,0,1
420287,2021,1,0,0,1
420290,2015,3,0,0,3
420290,2016,2,0,2,4
420290,2017,3,0,2,5
420290,2018,5,2,0,7
420290,2019,8,1,2,11
420290,2020,8,0,2,10
420290,2021,5,2,1,8
420290,2022,7,1,1,9
420300,2015,2,1,5,8
420300,2016,6,0,3,9
420300,2017,5,1,5,11
420300,2018,4,2,6,12
420300,2019,1,2,2,5
420300,2020,11,0,1,12
420300,2021,3,0,0,3
420300,2022,3,0,2,5
420320,2015,2,0,4,6
420320,2016,2,0,1,3
420320,2017,2,0,2,4
420320,2018,4,1,0,5
420320,2019,0,0,1,1
420320,2020,0,2,0,2
420320,2021,2,0,0,2
420320,2022,1,1,2,4
420330,2015,1,0,0,1
420330,2017,1,0,0,1
420330,2018,1,1,0,2
420340,2020,1,0,0,1
420350,2015,0,1,0,1
420350,2017,1,0,0,1
420350,2018,1,0,0,1
420350,2019,0,1,0,1
420350,2022,0,0,1,1
420360,2015,0,0,2,2
420360,2016,2,0,2,4
420360,2017,0,1,2,3
420360,2018,2,2,1,5
420360,2019,5,1,0,6
420360,2020,1,0,0,1
420360,2021,0,0,3,3
420360,2022,2,0,4,6
420370,2015,0,0,1,1
420380,2015,4,0,3,7
420380,2016,1,1,2,4
420380,2017,2,1,4,7
420380,2018,2,0,4,6
420380,2019,5,2,2,9
420380,2020,5,0,0,5
420380,2021,5,0,3,8
420380,2022,5,2,5,12
420390,2015,0,1,2,3
420390,2016,2,0,0,2
420390,2017,3,1,1,5
420390,2018,4,1,2,7
420390,2019,2,1,1,4
420390,2020,1,2,3,6
420390,2021,7,2,3,12
420390,2022,3,0,0,3
420395,2015,1,0,3,4
420395,2016,2,0,3,5
420395,2017,8,0,0,8
420395,2018,3,1,1,5
420395,2019,2,0,2,4
420395,2020,2,0,0,2
420395,2021,2,0,1,3
420395,2022,3,1,2,6
420400,2015,1,0,1,2
420400,2016,1,0,0,1
420400,2019,1,0,0,1
420400,2020,2,0,1,3
420400,2021,0,0,1,1
420410,2021,0,0,1,1
420410,2022,1,0,0,1
420420,2015,21,1,16,38
420420,2016,12,3,12,27
420420,2017,17,3,10,30
420420,2018,6,1,6,13
420420,2019,11,1,11,23
420420,2020,31,4,8,43
420420,2021,19,5,11,35
420420,2022,22,0,11,33
420425,2015,1,1,1,3
420425,2016,1,0,0,1
420425,2017,3,0,2,5
420425,2018,2,1,0,3
420425,2019,2,0,3,5
420425,2020,2,0,0,2
420425,2021,0,1,1,2
420430,2015,7,2,2,11
420430,2016,6,1,3,10
420430,2017,6,1,4,11
420430,2018,7,2,6,15
420430,2019,12,1,4,17
420430,2020,12,6,11,29
420430,2021,12,5,9,26
420430,2022,20,6,8,34
420435,2021,1,0,0,1
420440,2015,0,1,0,1
420440,2016,0,0,1,1
420440,2019,0,1,0,1
420450,2016,0,0,1,1
420450,2017,1,0,0,1
420450,2018,1,0,1,2
420450,2019,1,0,0,1
420450,2022,2,0,0,2
420455,2015,0,0,1,1
420455,2017,1,0,0,1
420455,2021,0,0,1,1
420460,2015,32,4,25,61
420460,2016,19,2,16,37
420460,2017,15,2,8,25
420460,2018,17,4,14,35
420460,2019,22,3,6,31
420460,2020,12,3,11,26
420460,2021,16,2,2,20
420460,2022,11,2,7,20
420470,2017,1,0,0,1
420470,2020,0,0,1,1
420480,2015,1,0,0,1
420480,2017,0,0,2,2
420480,2018,0,0,1,1
420480,2020,1,0,3,4
420480,2022,1,3,1,5
420490,2018,0,0,1,1
420490,2019,2,0,0,2
420500,2016,1,0,1,2
420500,2017,0,0,1,1
420500,2018,0,0,1,1
420500,2020,2,0,0,2
420520,2018,2,0,0,2
420520,2019,0,0,1,1
420520,2021,1,0,0,1
420530,2015,2,0,0,2
420530,2016,1,0,0,1
420530,2017,1,0,0,1
420530,2019,0,0,1,1
420530,2022,0,0,1,1
420535,2017,0,0,1,1
420535,2022,0,0,1,1
420540,2015,107,19,36,162
420540,2016,105,22,31,158
420540,2017,116,15,29,160
420540,2018,78,21,36,135
420540,2019,67,25,26,118
420540,2020,81,28,18,127
420540,2021,80,26,17,123
420540,2022,88,22,22,132
420543,2022,0,1,0,1
420545,2015,2,0,2,4
420545,2016,1,1,1,3
420545,2017,0,1,0,1
420545,2018,2,0,3,5
420545,2019,0,0,3,3
420545,2022,2,0,0,2
420550,2015,1,0,1,2
420550,2016,1,0,0,1
420550,2017,0,0,1,1
420550,2018,3,0,1,4
420550,2019,2,2,2,6
420550,2020,2,1,1,4
420550,2021,1,0,0,1
420550,2022,2,1,1,4
420570,2016,1,0,0,1
420570,2017,1,1,0,2
420570,2018,1,0,0,1
420570,2019,0,0,1,1
420570,2020,3,0,1,4
420570,2021,0,1,0,1
420570,2022,1,0,0,1
420580,2015,0,0,1,1
420580,2017,2,0,1,3
420580,2018,1,0,0,1
420580,2020,1,0,1,2
420580,2021,1,0,0,1
420580,2022,0,0,1,1
420590,2015,4,0,5,9
420590,2016,4,0,2,6
420590,2017,4,0,1,5
420590,2018,0,1,0,1
420590,2019,3,0,3,6
420590,2020,1,0,0,1
420590,2021,5,0,4,9
420590,2022,4,3,2,9
420600,2015,0,0,1,1
420600,2016,2,0,2,4
420600,2017,2,0,0,2
420600,2018,1,0,0,1
420600,2020,0,1,1,2
420600,2021,0,1,0,1
420610,2018,0,0,2,2
420620,2017,1,0,1,2
420620,2018,1,1,1,3
420620,2019,1,0,1,2
420620,2020,1,0,1,2
420620,2022,1,0,0,1
420630,2017,1,0,2,3
420630,2018,0,0,1,1
420630,2019,2,0,0,2
420630,2020,0,0,1,1
420630,2021,1,0,1,2
420640,2016,1,0,0,1
420640,2018,1,0,0,1
420640,2019,1,0,0,1
420640,2021,2,0,0,2
420650,2015,3,1,2,6
420650,2016,1,1,3,5
420650,2017,3,1,2,6
420650,2018,4,2,0,6
420650,2019,10,0,2,12
420650,2020,4,2,2,8
420650,2021,11,4,3,18
420650,2022,12,1,2,15
420660,2020,1,0,0,1
420665,2016,0,0,1,1
420665,2017,0,0,1,1
420665,2018,0,0,1,1
420665,2019,0,0,1,1
420670,2015,1,0,0,1
420670,2017,2,0,0,2
420670,2019,3,1,1,5
420670,2020,0,0,2,2
420670,2021,2,0,0,2
420670,2022,1,1,0,2
420675,2022,1,0,0,1
420680,2016,0,1,0,1
420680,2018,0,1,0,1
420690,2019,1,0,0,1
420700,2015,5,0,6,11
420700,2016,9,1,8,18
420700,2017,4,1,2,7
420700,2018,7,0,1,8
420700,2019,3,0,2,5
420700,2020,3,1,1,5
420700,2021,7,0,0,7
420700,2022,4,0,0,4
420710,2017,1,0,1,2
420720,2016,0,0,1,1
420720,2017,0,0,2,2
420720,2022,0,0,1,1
420730,2016,3,0,0,3
420730,2017,1,0,1,2
420730,2018,1,0,1,2
420730,2019,2,0,1,3
420730,2020,3,0,1,4
420730,2021,2,1,2,5
420730,2022,4,1,2,7
420750,2015,5,0,6,11
420750,2016,2,0,1,3
420750,2017,4,0,2,6
420750,2018,5,1,2,8
420750,2019,7,0,3,10
420750,2020,4,0,3,7
420750,2021,5,1,2,8
420750,2022,3,0,2,5
420757,2020,1,0,0,1
420760,2019,1,0,0,1
420765,2015,1,0,0,1
420765,2017,1,0,0,1
420765,2019,3,0,0,3
420765,2021,2,0,1,3
420765,2022,1,0,0,1
420768,2017,1,0,0,1
420770,2015,0,1,1,2
420770,2016,0,1,0,1
420770,2019,1,0,0,1
420770,2022,2,0,0,2
420775,2016,1,0,0,1
420775,2017,0,0,1,1
420780,2015,1,0,0,1
420780,2019,2,0,0,2
420780,2020,1,0,0,1
420790,2015,0,0,1,1
420790,2018,1,0,1,2
420790,2019,1,0,0,1
420790,2020,1,0,0,1
420790,2021,4,0,0,4
420800,2017,0,0,2,2
420800,2018,0,0,2,2
420800,2022,0,1,0,1
420810,2020,1,0,0,1
420820,2015,13,2,3,18
420820,2016,10,0,3,13
420820,2017,9,2,4,15
420820,2018,9,3,4,16
420820,2019,3,1,4,8
420820,2020,7,0,4,11
420820,2021,1,3,4,8
420820,2022,9,2,4,15
420830,2015,3,1,1,5
420830,2016,0,0,1,1
420830,2017,0,2,0,2
420830,2018,1,1,0,2
420830,2020,2,0,1,3
420830,2021,1,1,0,2
420840,2015,2,0,1,3
420840,2017,1,0,1,2
420840,2019,1,0,1,2
420840,2020,1,0,2,3
420840,2021,0,0,2,2
420840,2022,1,0,0,1
420845,2015,1,0,0,1
420845,2016,0,1,1,2
420845,2017,1,0,0,1
420845,2019,3,1,1,5
420845,2020,1,0,1,2
420845,2021,0,0,1,1
420845,2022,1,0,1,2
420850,2017,2,0,0,2
420850,2019,1,0,0,1
420850,2021,2,0,0,2
420850,2022,2,0,0,2
420870,2022,1,1,0,2
420880,2016,0,0,1,1
420880,2017,1,0,0,1
420880,2018,0,0,1,1
420880,2019,2,0,0,2
420880,2020,2,1,0,3
420880,2021,1,0,0,1
420880,2022,2,0,1,3
420890,2015,5,1,6,12
420890,2016,10,2,6,18
420890,2017,19,3,5,27
420890,2018,34,5,16,55
420890,2019,18,2,9,29
420890,2020,24,6,11,41
420890,2021,24,9,13,46
420890,2022,24,7,18,49
420900,2015,3,1,3,7
420900,2016,4,0,1,5
420900,2017,2,0,1,3
420900,2018,1,1,0,2
420900,2020,2,2,0,4
420900,2021,3,0,1,4
420900,2022,4,1,0,5
420910,2015,59,7,39,105
420910,2016,65,7,46,118
420910,2017,35,9,22,66
420910,2018,57,9,24,90
420910,2019,39,12,25,76
420910,2020,33,8,29,70
420910,2021,32,14,27,73
420910,2022,56,9,29,94
420920,2021,0,1,0,1
420930,2015,3,0,1,4
420930,2016,3,0,2,5
420930,2017,7,0,2,9
420930,2018,4,1,4,9
420930,2019,6,2,0,8
420930,2020,6,2,2,10
420930,2021,7,0,3,10
420930,2022,9,1,1,11
420940,2016,3,0,1,4
420940,2017,2,1,2,5
420940,2018,3,1,0,4
420940,2019,1,0,0,1
420940,2020,5,0,2,7
420940,2021,1,0,1,2
420940,2022,1,0,2,3
420945,2017,1,0,0,1
420950,2018,0,0,1,1
420950,2019,0,0,1,1
420960,2018,1,0,0,1
420960,2022,1,0,0,1
420970,2021,0,0,1,1
420985,2016,1,0,0,1
420985,2017,0,1,0,1
420985,2018,0,1,0,1
420985,2019,0,0,1,1
421000,2017,1,0,1,2
421000,2019,3,0,0,3
421000,2020,4,0,2,6
421000,2021,2,0,0,2
421000,2022,2,0,2,4
421003,2015,1,0,0,1
421003,2017,1,0,0,1
421003,2019,1,0,0,1
421003,2021,1,0,0,1
421010,2018,1,0,0,1
421010,2019,1,0,1,2
421010,2021,1,0,1,2
421020,2016,1,0,0,1
421020,2017,1,0,0,1
421020,2018,0,0,1,1
421030,2015,0,0,1,1
421040,2015,1,0,0,1
421040,2016,1,0,2,3
421040,2017,2,0,0,2
421040,2019,1,0,0,1
421040,2021,0,0,1,1
421040,2022,3,0,0,3
421050,2015,4,0,1,5
421050,2016,2,1,1,4
421050,2017,5,1,3,9
421050,2018,4,0,0,4
421050,2019,1,0,2,3
421050,2020,1,1,2,4
421050,2021,0,0,2,2
421050,2022,3,1,5,9
421060,2016,0,0,1,1
421060,2019,1,1,0,2
421060,2021,6,0,0,6
421080,2018,1,0,0,1
421100,2015,1,0,0,1
421100,2017,1,0,0,1
421100,2018,1,0,0,1
421100,2020,1,0,0,1
421100,2022,1,0,2,3
421105,2016,0,0,1,1
421105,2020,0,0,1,1
421105,2021,0,0,1,1
421105,2022,0,0,1,1
421120,2015,2,0,0,2
421120,2016,1,0,1,2
421120,2017,0,1,0,1
421120,2018,0,0,1,1
421120,2019,1,0,0,1
421120,2020,3,1,0,4
421120,2021,0,1,1,2
421120,2022,2,0,0,2
421130,2015,1,0,1,2
421130,2016,1,0,1,2
421130,2017,0,1,2,3
421130,2018,2,1,2,5
421130,2019,1,0,2,3
421130,2020,2,0,0,2
421130,2021,1,3,0,4
421130,2022,3,0,2,5
421150,2017,1,0,0,1
421150,2022,1,0,0,1
421160,2015,3,0,0,3
421160,2016,2,0,1,3
421160,2021,1,0,0,1
421160,2022,0,0,1,1
421165,2018,1,0,0,1
421170,2015,0,0,1,1
421170,2017,0,1,1,2
421170,2018,1,0,0,1
421170,2019,1,0,0,1
421170,2021,2,0,1,3
421170,2022,2,0,3,5
421175,2015,0,0,1,1
421175,2016,1,0,0,1
421175,2017,2,0,4,6
421175,2018,1,0,0,1
421175,2019,1,0,2,3
421175,2020,1,1,4,6
421180,2022,0,0,1,1
421185,2016,1,0,0,1
421190,2015,24,3,10,37
421190,2016,24,6,6,36
421190,2017,23,2,10,35
421190,2018,16,3,10,29
421190,2019,17,3,6,26
421190,2020,28,3,6,37
421190,2021,22,7,7,36
421190,2022,23,4,5,32
421200,2022,1,0,0,1
421210,2018,1,0,1,2
421210,2020,2,0,2,4
421220,2015,0,0,2,2
421220,2016,2,0,0,2
421220,2017,1,0,0,1
421220,2018,1,0,1,2
421220,2019,1,0,0,1
421220,2020,1,0,1,2
421220,2021,1,0,0,1
421225,2016,2,0,0,2
421227,2017,0,0,1,1
421230,2015,1,0,0,1
421240,2017,1,0,0,1
421240,2018,1,0,0,1
421240,2021,1,0,0,1
421250,2015,1,0,2,3
421250,2017,1,0,0,1
421250,2018,2,0,0,2
421250,2019,1,0,0,1
421250,2021,0,0,1,1
421260,2022,0,0,1,1
421265,2022,1,0,0,1
421270,2021,1,0,0,1
421280,2015,1,0,0,1
421280,2017,1,0,0,1
421280,2018,0,1,1,2
421290,2015,0,0,1,1
421290,2016,0,1,0,1
421290,2019,2,0,1,3
421290,2020,2,0,0,2
421290,2022,1,0,1,2
421300,2016,0,0,1,1
421300,2018,2,0,0,2
421300,2019,1,0,0,1
421300,2021,0,0,1,1
421300,2022,2,0,0,2
421310,2015,2,0,0,2
421310,2017,0,0,1,1
421310,2019,1,0,0,1
421310,2020,0,0,1,1
421310,2021,1,0,0,1
421310,2022,1,0,0,1
421320,2015,2,0,1,3
421320,2016,0,0,3,3
421320,2017,3,0,2,5
421320,2018,2,1,1,4
421320,2020,1,0,1,2
421320,2021,2,1,1,4
421320,2022,1,2,0,3
421335,2019,0,0,1,1
421340,2015,0,1,1,2
421340,2017,1,1,0,2
421340,2018,0,0,1,1
421340,2019,2,0,0,2
421350,2015,0,0,1,1
421350,2022,1,0,0,1
421360,2015,0,3,0,3
421360,2016,1,2,0,3
421360,2017,1,0,0,1
421360,2018,1,1,1,3
421360,2020,3,0,1,4
421360,2021,3,0,0,3
421360,2022,2,0,1,3
421380,2016,0,0,1,1
421400,2019,1,0,0,1
421415,2017,1,0,0,1
421420,2015,0,0,1,1
421420,2016,1,0,1,2
421420,2017,1,0,0,1
421420,2021,1,0,0,1
421430,2017,1,0,0,1
421430,2019,0,0,1,1
421430,2021,2,0,0,2
421440,2019,1,0,0,1
421440,2020,2,0,1,3
421440,2022,1,0,1,2
421460,2018,0,0,1,1
421470,2017,1,0,0,1
421470,2018,0,1,0,1
421470,2019,0,1,1,2
421470,2021,1,0,0,1
421480,2015,4,0,0,4
421480,2019,5,0,0,5
421480,2020,1,0,0,1
421480,2021,0,1,0,1
421480,2022,1,0,4,5
421490,2017,1,0,0,1
421490,2018,1,0,0,1
421490,2020,1,0,0,1
421500,2015,2,1,1,4
421500,2016,2,0,0,2
421500,2017,0,1,2,3
421500,2018,2,1,1,4
421500,2019,3,0,2,5
421500,2020,2,0,1,3
421500,2021,1,0,1,2
421500,2022,1,0,1,2
421510,2016,1,0,0,1
421510,2018,1,0,0,1
421510,2020,1,0,0,1
421510,2021,3,0,0,3
421510,2022,1,0,1,2
421520,2018,1,0,0,1
421520,2019,1,0,0,1
421520,2022,1,0,0,1
421535,2020,2,0,0,2
421540,2015,1,0,0,1
421540,2017,1,0,1,2
421540,2018,1,0,0,1
421540,2020,1,0,1,2
421540,2022,1,0,1,2
421545,2017,0,0,1,1
421545,2018,0,0,1,1
421545,2019,0,0,1,1
421545,2022,2,0,0,2
421550,2016,1,0,0,1
421550,2022,1,0,0,1
421555,2018,1,0,0,1
421565,2015,1,0,0,1
421568,2021,0,1,0,1
421569,2015,0,0,1,1
421570,2015,1,0,1,2
421570,2016,1,2,0,3
421570,2017,0,0,1,1
421570,2018,3,0,0,3
421570,2019,3,0,2,5
421570,2020,1,0,0,1
421570,2021,1,1,0,2
421570,2022,3,0,0,3
421580,2015,1,2,1,4
421580,2016,4,0,2,6
421580,2017,1,0,0,1
421580,2018,1,1,0,2
421580,2019,1,0,1,2
421580,2021,2,0,0,2
421590,2019,0,0,1,1
421590,2022,1,0,0,1
421600,2015,1,0,0,1
421600,2018,0,0,1,1
421600,2021,0,1,0,1
421610,2015,1,0,1,2
421610,2017,1,0,0,1
421610,2019,1,0,0,1
421610,2020,0,0,1,1
421610,2021,0,0,1,1
421620,2016,2,0,1,3
421620,2017,0,1,1,2
421620,2018,3,0,2,5
421620,2019,2,0,0,2
421620,2020,2,0,0,2
421620,2022,1,0,0,1
421625,2017,0,0,1,1
421625,2019,0,0,1,1
421630,2015,1,0,0,1
421630,2018,1,1,0,2
421630,2019,1,0,0,1
421630,2020,3,0,0,3
421650,2019,0,1,0,1
421650,2021,0,1,0,1
421650,2022,0,1,0,1
421660,2015,38,12,16,66
421660,2016,32,5,9,46
421660,2017,33,6,11,50
421660,2018,25,7,11,43
421660,2019,25,5,8,38
421660,2020,21,7,11,39
421660,2021,23,7,6,36
421660,2022,24,4,7,35
421670,2019,1,0,0,1
421670,2020,0,0,1,1
421680,2015,0,0,1,1
421690,2015,1,2,0,3
421690,2016,7,0,2,9
421690,2017,3,1,3,7
421690,2018,2,0,0,2
421690,2019,3,0,1,4
421690,2020,1,0,0,1
421690,2021,1,0,0,1
421690,2022,0,0,1,1
421700,2015,2,0,1,3
421700,2016,0,0,1,1
421700,2017,1,0,0,1
421700,2019,0,1,1,2
421700,2020,0,0,2,2
421710,2019,0,1,0,1
421710,2020,1,0,0,1
421710,2022,1,0,0,1
421720,2015,5,0,2,7
421720,2016,3,1,1,5
421720,2017,4,2,2,8
421720,2018,5,0,0,5
421720,2019,2,0,0,2
421720,2020,6,1,4,11
421720,2021,6,0,1,7
421720,2022,6,2,4,12
421725,2019,0,0,1,1
421725,2020,0,0,1,1
421725,2021,2,0,0,2
421730,2019,1,0,0,1
421740,2015,0,0,1,1
421740,2017,0,2,2,4
421740,2018,0,0,2,2
421740,2019,1,0,1,2
421740,2020,2,0,2,4
421750,2015,5,0,1,6
421750,2016,1,2,1,4
421750,2017,1,0,1,2
421750,2018,1,0,2,3
421750,2019,1,1,1,3
421750,2020,0,1,0,1
421750,2021,1,2,3,6
421750,2022,2,1,0,3
421755,2017,1,0,0,1
421755,2022,0,0,1,1
421760,2015,3,0,1,4
421760,2017,0,0,2,2
421760,2018,2,0,0,2
421760,2019,1,0,1,2
421760,2020,0,0,1,1
421760,2021,2,0,0,2
421770,2015,0,1,0,1
421770,2016,1,0,0,1
421770,2017,3,1,2,6
421770,2018,1,0,1,2
421770,2019,1,1,2,4
421770,2022,1,0,0,1
421775,2017,0,0,1,1
421780,2020,0,0,1,1
421790,2018,0,0,2,2
421790,2022,0,0,1,1
421795,2020,1,0,0,1
421800,2015,7,1,2,10
421800,2016,6,0,0,6
421800,2017,3,1,2,6
421800,2018,2,0,1,3
421800,2019,1,0,1,2
421800,2020,6,1,0,7
421800,2021,2,0,2,4
421800,2022,3,0,0,3
421810,2016,0,0,1,1
421820,2015,1,0,1,2
421820,2016,4,1,0,5
421820,2017,1,0,1,2
421820,2018,1,2,1,4
421820,2019,2,0,1,3
421820,2020,0,1,1,2
421820,2021,4,0,2,6
421820,2022,2,1,0,3
421830,2018,3,0,1,4
421830,2019,0,0,2,2
421830,2020,0,0,2,2
421830,2021,0,0,1,1
421835,2017,0,0,1,1
421840,2017,2,1,0,3
421840,2018,2,0,0,2
421840,2019,1,0,0,1
421840,2020,1,0,0,1
421840,2021,1,0,1,2
421840,2022,3,0,0,3
421850,2017,1,0,0,1
421850,2018,1,0,0,1
421850,2020,1,1,1,3
421850,2021,1,0,1,2
421850,2022,1,0,0,1
421860,2017,0,0,1,1
421860,2018,0,0,1,1
421870,2015,9,1,6,16
421870,2016,11,0,9,20
421870,2017,8,2,9,19
421870,2018,16,4,10,30
421870,2019,13,2,9,24
421870,2020,10,7,4,21
421870,2021,6,0,4,10
421870,2022,9,2,1,12
421875,2015,1,0,0,1
421875,2020,1,0,0,1
421875,2021,1,0,0,1
421875,2022,1,0,0,1
421880,2015,1,0,0,1
421880,2016,0,0,1,1
421880,2017,1,0,0,1
421880,2019,1,0,0,1
421880,2022,0,1,0,1
421890,2017,1,0,0,1
421895,2016,1,0,0,1
421895,2018,0,0,1,1
421895,2021,1,0,0,1
421900,2015,3,0,2,5
421900,2016,3,0,0,3
421900,2017,3,0,0,3
421900,2018,0,1,0,1
421900,2019,1,0,0,1
421900,2020,1,0,0,1
421900,2022,4,0,0,4
421917,2015,0,1,0,1
421917,2016,1,0,0,1
421917,2020,0,0,1,1
421920,2016,0,0,1,1
421930,2015,8,0,1,9
421930,2016,3,2,4,9
421930,2017,0,2,4,6
421930,2018,3,0,3,6
421930,2019,2,0,1,3
421930,2020,5,1,5,11
421930,2021,5,0,4,9
421930,2022,5,1,3,9
421950,2015,3,2,2,7
421950,2016,3,0,1,4
421950,2017,1,0,0,1
421950,2018,4,0,1,5
421950,2019,1,1,2,4
421950,2020,3,1,1,5
421950,2021,1,1,2,4
421950,2022,2,0,2,4
421970,2016,0,0,1,1
421970,2019,4,0,1,5
421970,2020,1,2,0,3
421970,2022,3,0,0,3
421985,2015,1,0,0,1
421985,2018,0,0,1,1
421985,2020,1,0,2,3
421985,2022,1,0,1,2
422000,2015,2,0,0,2
422000,2016,1,0,0,1
422000,2017,1,1,1,3
422000,2020,0,0,1,1
422000,2022,1,0,0,1
430000,2015,1,0,0,1
430000,2016,0,3,1,4
430000,2017,0,1,1,2
430000,2018,1,0,0,1
430000,2019,0,1,1,2
430000,2020,1,0,0,1
430000,2022,1,1,0,2
430010,2018,1,0,0,1
430030,2016,0,0,1,1
430030,2018,0,1,0,1
430040,2016,1,0,1,2
430040,2017,1,0,0,1
430040,2018,3,0,0,3
430040,2019,0,0,1,1
430040,2020,1,2,0,3
430040,2021,2,0,0,2
430040,2022,2,0,1,3
430060,2015,3,2,2,7
430060,2016,5,0,2,7
430060,2017,1,2,1,4
430060,2018,1,0,5,6
430060,2019,4,0,3,7
430060,2020,0,1,0,1
430060,2021,1,1,3,5
430060,2022,1,0,0,1
430063,2016,1,0,0,1
430070,2015,1,0,0,1
430070,2018,1,0,0,1
430070,2019,4,0,0,4
430070,2020,3,0,2,5
430070,2022,1,1,0,2
430080,2015,1,0,2,3
430080,2017,1,0,1,2
430080,2019,1,0,0,1
430080,2021,3,0,0,3
430080,2022,1,0,0,1
430085,2016,1,0,0,1
430087,2018,2,0,0,2
430087,2020,0,0,1,1
430087,2021,0,0,1,1
430090,2015,1,0,0,1
430090,2020,0,1,0,1
430090,2021,0,0,1,1
430100,2015,2,0,0,2
430100,2016,1,0,2,3
430100,2019,1,1,0,2
430100,2020,1,0,0,1
430100,2021,1,0,0,1
430105,2017,0,1,0,1
430110,2017,1,0,0,1
430110,2018,1,0,0,1
430110,2020,0,0,2,2
430110,2022,1,0,0,1
430120,2015,0,1,0,1
430120,2017,1,1,0,2
430120,2018,1,0,0,1
430120,2019,0,0,1,1
430120,2020,0,0,1,1
430140,2016,1,0,0,1
430140,2017,0,0,1,1
430140,2018,0,1,0,1
430140,2019,0,0,1,1
430140,2020,2,0,2,4
430140,2021,1,0,0,1
430140,2022,0,0,1,1
430150,2017,0,0,1,1
430160,2015,2,0,1,3
430160,2017,0,0,1,1
430160,2018,2,1,0,3
430160,2019,1,1,0,2
430160,2020,2,0,1,3
430160,2021,2,0,0,2
430160,2022,1,0,0,1
430163,2015,0,0,1,1
430165,2021,0,1,0,1
430170,2017,2,0,0,2
430170,2018,0,1,0,1
430170,2020,0,0,1,1
430170,2021,1,0,2,3
430170,2022,3,0,0,3
430180,2017,1,0,0,1
430185,2016,1,0,0,1
430185,2018,1,0,0,1
430185,2019,1,0,0,1
430190,2015,1,0,2,3
430210,2015,8,2,4,14
430210,2016,6,3,3,12
430210,2017,5,1,2,8
430210,2018,7,2,3,12
430210,2019,5,0,2,7
430210,2020,6,2,2,10
430210,2021,5,0,2,7
430210,2022,2,1,1,4
430220,2018,0,0,3,3
430220,2019,0,1,1,2
430220,2021,1,0,0,1
430225,2019,2,0,0,2
430230,2016,1,0,0,1
430230,2017,2,0,0,2
430235,2015,2,0,0,2
430235,2017,1,0,0,1
430235,2018,1,0,0,1
430235,2021,2,1,0,3
430235,2022,2,0,1,3
430240,2015,1,0,0,1
430240,2017,1,1,0,2
430240,2019,2,0,0,2
430240,2020,0,1,0,1
430240,2022,0,1,0,1
430245,2019,1,0,0,1
430260,2017,0,0,1,1
430265,2022,1,0,0,1
430270,2018,1,0,0,1
430270,2021,0,0,1,1
430270,2022,1,0,0,1
430280,2015,0,0,1,1
430280,2017,0,0,1,1
430280,2018,1,0,0,1
430280,2019,0,0,1,1
430280,2020,0,1,0,1
430280,2021,0,1,0,1
430300,2016,2,1,0,3
430300,2017,4,0,4,8
430300,2018,0,1,1,2
430300,2019,1,1,0,2
430300,2020,5,2,0,7
430300,2021,3,0,0,3
430300,2022,1,0,0,1
430310,2015,5,2,2,9
430310,2016,6,2,4,12
430310,2017,3,0,3,6
430310,2018,3,0,3,6
430310,2019,5,1,4,10
430310,2020,4,0,1,5
430310,2021,7,1,5,13
430310,2022,4,0,2,6
430350,2015,3,0,1,4
430350,2017,1,0,0,1
430350,2018,1,1,0,2
430350,2019,1,0,0,1
430350,2020,3,0,0,3
430350,2021,1,0,1,2
430350,2022,0,0,1,1
430355,2020,0,1,0,1
430360,2018,0,0,1,1
430367,2016,1,0,0,1
430380,2020,1,0,0,1
430380,2022,1,0,0,1
430390,2015,1,0,2,3
430390,2016,4,0,0,4
430390,2017,4,0,1,5
430390,2018,4,1,1,6
430390,2019,6,2,1,9
430390,2020,1,0,1,2
430390,2021,2,0,4,6
430390,2022,4,0,0,4
430400,2020,2,0,0,2
430400,2021,0,0,1,1
430420,2015,1,0,0,1
430420,2017,0,0,1,1
430420,2020,1,0,0,1
430420,2021,1,0,0,1
430430,2016,1,0,0,1
430430,2018,0,0,1,1
430435,2017,0,1,0,1
430435,2019,0,0,1,1
430435,2021,1,0,0,1
430440,2015,1,0,2,3
430440,2016,1,2,0,3
430440,2017,3,0,3,6
430440,2018,2,0,1,3
430440,2019,1,0,0,1
430440,2020,1,0,0,1
430440,2021,1,1,0,2
430440,2022,0,0,1,1
430460,2015,18,3,8,29
430460,2016,13,2,13,28
430460,2017,13,2,5,20
430460,2018,16,0,2,18
430460,2019,7,1,4,12
430460,2020,9,4,7,20
430460,2021,15,0,8,23
430460,2022,10,2,3,15
430463,2015,2,0,0,2
430463,2016,1,1,0,2
430463,2017,0,0,1,1
430463,2018,1,0,0,1
430463,2019,0,0,2,2
430463,2020,1,1,0,2
430463,2021,2,0,0,2
430463,2022,2,0,0,2
430466,2017,0,0,1,1
430466,2018,1,0,0,1
430467,2017,1,0,0,1
430468,2022,0,0,2,2
430470,2015,2,1,0,3
430470,2016,2,0,0,2
430470,2017,1,0,0,1
430470,2018,7,1,3,11
430470,2019,2,0,0,2
430470,2020,4,0,0,4
430470,2021,3,1,0,4
430470,2022,1,1,0,2
430480,2015,3,1,0,4
430480,2016,3,0,0,3
430480,2017,2,1,0,3
430480,2018,1,0,0,1
430480,2019,2,0,2,4
430480,2020,2,0,0,2
430480,2021,0,2,1,3
430480,2022,1,0,0,1
430485,2018,1,0,0,1
430490,2015,1,0,1,2
430490,2018,0,0,1,1
430490,2019,0,0,1,1
430490,2020,2,0,0,2
430495,2022,0,0,1,1
430500,2022,1,0,0,1
430510,2015,12,3,6,21
430510,2016,6,2,8,16
430510,2017,5,0,6,11
430510,2018,14,1,6,21
430510,2019,7,3,3,13
430510,2020,12,5,6,23
430510,2021,9,2,1,12
430510,2022,8,2,3,13
430520,2015,2,0,1,3
430520,2016,1,0,2,3
430520,2017,1,0,0,1
430520,2018,0,0,2,2
430520,2019,1,0,0,1
430530,2018,1,0,0,1
430530,2021,1,0,0,1
430535,2015,3,0,4,7
430535,2016,0,0,1,1
430535,2017,2,0,1,3
430535,2019,1,2,0,3
430535,2020,2,0,0,2
430535,2021,2,2,1,5
430535,2022,2,0,0,2
430545,2015,0,0,1,1
430545,2016,1,0,0,1
430545,2020,0,0,1,1
430558,2015,0,0,1,1
430558,2022,1,0,0,1
430560,2022,0,0,1,1
430570,2018,1,0,0,1
430580,2020,0,0,1,1
430580,2022,1,0,0,1
430585,2016,1,0,0,1
430585,2017,1,0,0,1
430585,2018,1,0,0,1
430585,2019,1,0,0,1
430590,2019,0,1,0,1
430595,2018,1,0,0,1
430595,2020,1,0,0,1
430597,2017,1,0,0,1
430600,2015,0,0,2,2
430600,2017,2,0,0,2
430600,2019,2,0,0,2
430600,2021,1,0,0,1
430607,2021,0,0,1,1
430610,2015,1,0,1,2
430610,2016,1,0,0,1
430610,2017,2,1,0,3
430610,2018,2,0,4,6
430610,2019,3,0,0,3
430610,2021,2,1,0,3
430610,2022,2,1,0,3
430613,2020,0,0,1,1
430620,2015,0,0,1,1
430640,2015,3,0,2,5
430640,2017,3,0,0,3
430640,2018,1,0,1,2
430640,2019,0,1,1,2
430640,2020,3,0,1,4
430640,2021,1,1,0,2
430640,2022,1,0,3,4
430645,2018,1,0,0,1
430645,2022,0,0,1,1
430660,2015,1,0,1,2
430660,2016,2,0,0,2
430660,2017,1,0,0,1
430673,2018,1,0,0,1
430673,2022,1,0,0,1
430676,2015,1,0,0,1
430676,2016,0,1,0,1
430676,2018,2,0,1,3
430676,2019,5,0,1,6
430676,2020,1,0,0,1
430676,2021,2,0,0,2
430676,2022,1,0,0,1
430680,2015,5,0,1,6
430680,2016,3,1,2,6
430680,2017,8,0,0,8
430680,2018,4,1,2,7
430680,2019,2,0,0,2
430680,2020,4,2,1,7
430680,2021,1,0,4,5
430680,2022,3,2,3,8
430693,2015,0,0,1,1
430693,2018,0,0,1,1
430693,2019,0,0,1,1
430693,2022,1,0,0,1
430695,2018,0,0,1,1
430695,2019,1,0,0,1
430700,2015,12,1,2,15
430700,2016,5,1,4,10
430700,2017,3,2,1,6
430700,2018,6,1,0,7
430700,2019,4,2,1,7
430700,2020,9,3,2,14
430700,2021,10,3,3,16
430700,2022,8,2,2,12
430705,2021,1,0,0,1
430730,2015,1,0,0,1
430730,2020,0,0,1,1
430730,2021,1,0,0,1
430740,2015,0,0,1,1
430740,2019,1,0,0,1
430750,2015,1,0,0,1
430750,2017,2,0,0,2
430750,2020,0,0,2,2
430750,2022,0,0,1,1
430755,2015,1,0,1,2
430755,2022,1,1,0,2
430760,2015,2,1,1,4
430760,2016,3,1,2,6
430760,2017,1,1,2,4
430760,2018,1,0,2,3
430760,2019,3,1,0,4
430760,2020,1,0,1,2
430760,2021,1,0,0,1
430760,2022,2,1,0,3
430770,2015,5,0,0,5
430770,2016,3,1,1,5
430770,2017,3,0,2,5
430770,2018,3,0,2,5
430770,2019,4,0,2,6
430770,2020,5,0,0,5
430770,2021,2,0,0,2
430770,2022,2,0,1,3
430780,2015,0,0,2,2
430780,2016,3,0,0,3
430780,2017,3,0,1,4
430780,2018,1,0,0,1
430780,2019,3,2,0,5
430780,2020,3,2,1,6
430780,2021,0,1,2,3
430780,2022,2,0,2,4
430781,2018,0,0,1,1
430783,2016,1,0,0,1
430786,2018,0,0,1,1
430790,2015,4,1,3,8
430790,2016,3,1,1,5
430790,2017,1,0,0,1
430790,2018,2,2,1,5
430790,2019,5,1,1,7
430790,2020,2,1,0,3
430790,2021,2,0,2,4
430790,2022,3,0,1,4
430800,2017,0,1,0,1
430800,2019,0,1,0,1
430800,2020,1,1,0,2
430800,2021,1,0,0,1
430805,2021,1,0,0,1
430807,2015,2,0,0,2
430807,2019,0,0,1,1
430807,2022,0,0,1,1
430810,2015,1,0,0,1
430810,2022,1,0,0,1
430820,2015,1,0,1,2
430820,2016,1,1,0,2
430820,2017,1,0,0,1
430820,2018,1,0,0,1
430850,2016,0,1,1,2
430850,2017,2,0,0,2
430850,2018,0,0,1,1
430850,2019,1,0,0,1
430850,2021,1,0,2,3
430850,2022,1,0,0,1
430860,2015,1,0,3,4
430860,2016,3,0,1,4
430860,2017,2,1,0,3
430860,2018,3,0,0,3
430860,2019,2,1,0,3
430860,2020,1,1,1,3
430860,2021,2,1,0,3
430860,2022,2,1,1,4
430865,2021,1,0,0,1
430870,2015,1,0,0,1
430870,2016,1,0,0,1
430870,2017,0,1,0,1
430870,2020,1,0,0,1
430870,2021,0,0,2,2
430870,2022,1,0,0,1
430880,2016,2,0,0,2
430880,2017,1,0,0,1
430880,2018,0,0,1,1
430890,2016,1,0,0,1
430890,2020,1,0,0,1
430890,2021,1,0,0,1
430890,2022,2,0,0,2
430900,2016,2,0,0,2
430900,2021,0,1,0,1
430910,2015,2,0,2,4
430910,2016,3,0,0,3
430910,2017,7,0,0,7
430910,2018,2,0,0,2
430910,2019,0,0,1,1
430910,2021,1,1,1,3
430910,2022,2,0,1,3
430920,2015,11,0,8,19
430920,2016,8,7,9,24
430920,2017,9,4,2,15
430920,2018,8,0,2,10
430920,2019,4,1,3,8
430920,2020,6,2,5,13
430920,2021,7,1,3,11
430920,2022,3,4,2,9
430930,2015,1,0,0,1
430930,2016,3,0,1,4
430930,2017,2,1,4,7
430930,2018,2,1,0,3
430930,2019,1,1,2,4
430930,2020,1,0,1,2
430930,2021,2,0,1,3
430930,2022,0,0,1,1
430940,2015,3,0,0,3
430940,2016,5,0,5,10
430940,2017,3,0,2,5
430940,2018,1,0,0,1
430940,2019,6,1,2,9
430940,2020,2,0,1,3
430940,2021,5,0,1,6
430940,2022,4,0,1,5
430950,2016,1,0,0,1
430955,2017,1,1,0,2
430955,2020,0,0,1,1
430955,2021,1,0,0,1
430955,2022,2,0,0,2
430957,2016,0,0,1,1
430960,2016,0,0,3,3
430960,2017,1,0,1,2
430960,2018,1,2,1,4
430960,2019,1,1,4,6
430960,2020,5,0,2,7
430960,2021,2,0,1,3
430960,2022,3,1,1,5
430970,2016,0,0,1,1
430970,2017,0,1,0,1
430990,2021,1,0,0,1
430995,2019,0,0,1,1
430995,2021,0,0,1,1
430995,2022,0,0,1,1
431000,2015,1,0,3,4
431000,2016,0,2,3,5
431000,2018,1,0,0,1
431000,2019,2,0,1,3
431000,2020,1,0,0,1
431000,2021,0,0,1,1
431000,2022,2,0,1,3
431010,2016,2,0,0,2
431010,2018,0,1,0,1
431010,2019,1,0,1,2
431010,2021,0,1,0,1
431020,2015,1,0,1,2
431020,2016,3,0,1,4
431020,2017,10,4,6,20
431020,2018,0,0,2,2
431020,2019,3,1,1,5
431020,2021,2,0,2,4
431020,2022,4,0,1,5
431030,2015,2,0,0,2
431030,2016,1,0,0,1
431030,2017,0,0,1,1
431030,2019,1,0,0,1
431030,2020,1,0,1,2
431030,2021,1,0,1,2
431030,2022,1,0,0,1
431033,2021,1,0,0,1
431040,2019,0,1,0,1
431043,2019,1,0,0,1
431053,2019,1,0,0,1
431053,2020,0,0,1,1
431057,2018,0,0,1,1
431057,2021,0,0,1,1
431060,2016,1,0,1,2
431060,2017,2,0,0,2
431060,2020,1,1,0,2
431060,2021,0,0,1,1
431060,2022,1,0,1,2
431075,2021,1,0,0,1
431080,2015,1,1,0,2
431080,2016,3,0,0,3
431080,2017,3,0,0,3
431080,2018,1,0,0,1
431080,2021,1,1,0,2
431080,2022,2,0,0,2
431085,2017,0,0,1,1
431090,2018,1,0,0,1
431090,2019,2,0,0,2
431090,2021,1,0,0,1
431090,2022,1,0,0,1
431100,2017,1,0,0,1
431110,2022,0,1,0,1
431120,2015,1,0,0,1
431120,2018,0,1,1,2
431120,2020,1,0,0,1
431123,2022,1,0,0,1
431127,2015,0,0,1,1
431127,2017,1,0,0,1
431127,2020,0,1,0,1
431130,2016,1,0,0,1
431130,2017,0,1,0,1
431130,2019,1,0,1,2
431130,2021,1,0,0,1
431130,2022,0,0,1,1
431140,2015,2,1,3,6
431140,2016,1,1,3,5
431140,2017,5,0,1,6
431140,2018,8,1,1,10
431140,2019,1,0,2,3
431140,2020,3,3,1,7
431140,2021,7,1,3,11
431140,2022,4,1,0,5
431160,2016,0,0,1,1
431162,2019,1,0,0,1
431170,2020,0,0,1,1
431170,2021,1,0,0,1
431175,2019,0,1,0,1
431179,2019,1,0,0,1
431180,2015,1,1,1,3
431180,2016,2,0,1,3
431180,2017,6,0,0,6
431180,2018,2,0,1,3
431180,2019,1,1,2,4
431180,2020,5,1,1,7
431180,2021,2,0,0,2
431180,2022,2,3,2,7
431215,2016,1,0,0,1
431215,2018,1,0,0,1
431225,2020,1,0,0,1
431225,2021,0,2,0,2
431235,2021,1,0,0,1
431240,2015,2,0,0,2
431240,2016,3,0,1,4
431240,2017,5,1,2,8
431240,2018,2,0,0,2
431240,2019,2,0,2,4
431240,2020,4,0,0,4
431240,2021,5,2,5,12
431240,2022,4,1,3,8
431242,2022,0,0,1,1
431247,2020,1,0,0,1
431247,2021,1,0,0,1
431260,2016,0,0,1,1
431260,2017,0,0,1,1
431260,2019,1,0,0,1
431260,2020,1,0,0,1
431260,2022,2,0,0,2
431262,2022,1,0,0,1
431265,2015,0,0,1,1
431265,2016,1,0,0,1
431265,2018,1,0,0,1
431265,2019,2,0,0,2
431265,2020,1,1,1,3
431265,2021,1,1,0,2
431265,2022,3,0,3,6
431270,2017,1,1,1,3
431280,2015,1,0,0,1
431280,2016,1,0,0,1
431280,2018,1,0,0,1
431280,2019,1,0,0,1
431280,2022,1,0,0,1
431290,2016,1,0,0,1
431290,2018,0,1,1,2
431290,2019,1,0,2,3
431290,2021,0,0,1,1
431300,2019,1,0,0,1
431306,2017,0,0,1,1
431306,2022,0,0,1,1
431310,2019,1,0,0,1
431320,2016,1,1,0,2
431320,2017,1,0,0,1
431320,2018,0,0,1,1
431320,2019,0,1,0,1
431330,2015,0,2,3,5
431330,2016,1,0,2,3
431330,2017,1,0,1,2
431330,2018,3,0,1,4
431330,2020,4,1,0,5
431330,2021,1,0,1,2
431330,2022,3,1,0,4
431337,2015,0,1,0,1
431337,2016,1,0,0,1
431337,2017,1,0,0,1
431337,2021,0,1,0,1
431337,2022,1,1,0,2
431339,2017,1,0,1,2
431340,2015,7,1,5,13
431340,2016,10,1,3,14
431340,2017,13,2,3,18
431340,2018,7,2,6,15
431340,2019,18,4,6,28
431340,2020,3,1,2,6
431340,2021,8,1,3,12
431340,2022,6,4,1,11
431350,2015,0,0,1,1
431350,2019,1,1,1,3
431350,2020,2,0,0,2
431350,2021,0,1,0,1
431350,2022,0,0,1,1
431365,2018,1,0,0,1
431365,2020,1,0,0,1
431370,2016,1,0,1,2
431370,2017,0,0,1,1
431370,2019,3,0,0,3
431380,2020,1,0,0,1
431390,2015,0,0,1,1
431390,2016,0,0,1,1
431390,2017,1,0,0,1
431390,2018,1,1,0,2
431390,2019,0,0,1,1
431390,2020,0,0,2,2
431390,2021,2,0,0,2
431390,2022,4,3,1,8
431395,2018,1,0,0,1
431400,2015,0,0,1,1
431400,2016,1,0,0,1
431400,2017,0,1,0,1
431400,2018,0,0,3,3
431400,2019,2,0,0,2
431400,2021,1,0,0,1
431403,2017,0,1,0,1
431403,2021,1,1,0,2
431405,2015,5,0,1,6
431405,2016,2,0,0,2
431405,2017,1,0,1,2
431405,2019,0,0,1,1
431405,2020,1,0,0,1
431407,2021,1,0,2,3
431407,2022,1,0,0,1
431410,2015,4,1,5,10
431410,2016,6,2,4,12
431410,2017,5,2,2,9
431410,2018,9,2,2,13
431410,2019,7,0,5,12
431410,2020,5,0,2,7
431410,2021,7,0,0,7
431410,2022,12,2,3,17
431415,2018,0,0,1,1
431415,2021,1,1,0,2
431430,2016,1,0,0,1
431440,2015,2,2,2,6
431440,2016,2,3,3,8
431440,2017,2,0,3,5
431440,2018,4,2,0,6
431440,2019,4,2,1,7
431440,2020,8,3,0,11
431440,2021,2,1,0,3
431440,2022,2,2,1,5
431442,2016,1,0,0,1
431445,2017,1,0,0,1
431445,2019,1,0,0,1
431446,2016,0,0,1,1
431447,2020,1,0,0,1
431449,2021,1,0,0,1
431450,2019,1,0,0,1
431450,2020,0,0,1,1
431460,2019,1,0,0,1
431460,2022,1,0,0,1
431475,2015,1,0,0,1
431478,2020,0,0,1,1
431480,2019,2,0,1,3
431480,2021,0,0,2,2
431490,2015,61,11,36,108
431490,2016,67,14,22,103
431490,2017,49,10,23,82
431490,2018,57,11,17,85
431490,2019,61,22,23,106
431490,2020,52,13,4,69
431490,2021,79,24,20,123
431490,2022,55,19,10,84
431514,2018,0,1,0,1
431514,2022,1,0,0,1
431515,2019,0,0,1,1
431515,2021,0,0,1,1
431517,2022,0,0,1,1
431520,2015,0,0,1,1
431535,2018,1,0,0,1
431535,2022,0,1,0,1
431540,2016,0,0,1,1
431550,2017,2,0,1,3
431550,2018,1,0,0,1
431550,2020,1,1,0,2
431560,2015,6,0,4,10
431560,2016,1,0,0,1
431560,2017,1,0,0,1
431560,2018,1,0,0,1
431560,2019,1,1,0,2
431560,2020,4,0,2,6
431560,2021,3,3,3,9
431560,2022,1,1,1,3
431570,2015,1,0,0,1
431570,2016,1,0,1,2
431570,2020,0,0,1,1
431570,2021,1,0,0,1
431580,2015,0,3,1,4
431580,2016,3,1,0,4
431580,2021,0,2,0,2
431580,2022,3,0,0,3
431600,2018,1,0,0,1
431600,2019,1,0,0,1
431600,2022,0,0,1,1
431620,2017,1,0,1,2
431630,2015,1,0,0,1
431630,2019,0,1,0,1
431640,2016,2,0,0,2
431645,2017,1,0,1,2
431645,2022,0,1,0,1
431650,2017,1,0,1,2
431650,2020,0,0,1,1
431650,2021,0,0,1,1
431650,2022,1,0,0,1
431660,2015,0,0,1,1
431660,2016,1,0,0,1
431660,2018,1,0,0,1
431670,2015,1,0,0,1
431670,2021,1,0,0,1
431670,2022,1,0,0,1
431675,2016,1,0,0,1
431675,2017,0,0,1,1
431680,2015,14,3,3,20
431680,2016,8,2,3,13
431680,2017,15,3,3,21
431680,2018,6,3,2,11
431680,2019,7,2,1,10
431680,2020,6,1,2,9
431680,2021,4,1,0,5
431680,2022,3,1,4,8
431690,2015,2,0,1,3
431690,2016,4,1,0,5
431690,2017,17,4,6,27
431690,2018,15,4,6,25
431690,2019,23,8,2,33
431690,2020,11,3,7,21
431690,2021,13,5,4,22
431690,2022,11,7,4,22
431695,2017,1,0,0,1
431710,2015,1,0,1,2
431710,2017,2,0,0,2
431710,2018,1,0,1,2
431710,2019,1,0,0,1
431710,2020,0,1,0,1
431710,2022,0,0,1,1
431720,2015,0,1,0,1
431720,2016,1,0,0,1
431720,2017,3,1,1,5
431720,2018,1,0,0,1
431720,2019,1,1,0,2
431720,2020,1,0,0,1
431720,2021,1,0,0,1
431720,2022,1,0,0,1
431725,2017,1,0,0,1
431730,2015,1,0,0,1
431730,2018,1,0,0,1
431730,2019,1,0,0,1
431730,2020,1,0,0,1
431740,2016,3,1,0,4
431740,2017,3,1,1,5
431740,2018,1,2,0,3
431740,2019,2,0,2,4
431740,2020,1,0,1,2
431740,2021,2,1,0,3
431750,2015,5,0,0,5
431750,2016,0,2,1,3
431750,2017,2,3,3,8
431750,2018,4,1,2,7
431750,2019,7,0,3,10
431750,2020,1,0,1,2
431750,2021,0,1,1,2
431750,2022,2,0,1,3
431755,2021,1,0,0,1
431760,2015,1,0,0,1
431760,2016,1,0,0,1
431760,2017,0,1,0,1
431760,2021,0,0,1,1
431770,2019,0,0,1,1
431770,2021,1,0,0,1
431780,2016,1,0,1,2
431780,2017,0,0,1,1
431780,2019,0,1,0,1
431790,2020,1,0,0,1
431790,2021,1,0,0,1
431800,2016,0,0,1,1
431800,2017,1,0,1,2
431800,2018,1,0,0,1
431800,2019,1,0,0,1
431800,2020,2,0,0,2
431800,2021,0,0,1,1
431800,2022,1,1,2,4
431820,2015,1,0,0,1
431830,2019,1,0,0,1
431830,2022,1,0,0,1
431840,2016,0,0,1,1
431840,2018,1,0,0,1
431840,2020,1,0,0,1
431840,2021,0,0,1,1
431840,2022,1,0,0,1
431842,2017,0,1,0,1
431843,2020,0,0,1,1
431849,2021,0,1,0,1
431850,2015,1,0,0,1
431861,2020,1,0,0,1
431861,2022,0,1,0,1
431870,2015,6,1,6,13
431870,2016,7,3,2,12
431870,2017,3,0,6,9
431870,2018,7,0,2,9
431870,2019,7,1,2,10
431870,2020,5,1,3,9
431870,2021,8,1,2,11
431870,2022,5,1,3,9
431880,2015,1,0,0,1
431880,2016,0,1,0,1
431880,2018,1,0,0,1
431880,2019,1,0,0,1
431880,2020,1,0,0,1
431880,2021,0,1,0,1
431880,2022,1,0,1,2
431890,2016,1,0,0,1
431890,2019,1,0,1,2
431900,2017,2,1,1,4
431900,2018,0,0,1,1
431900,2021,0,0,1,1
431910,2019,2,0,0,2
431910,2021,1,0,1,2
431910,2022,0,1,0,1
431935,2021,0,0,1,1
431937,2018,1,0,0,1
431937,2020,0,0,1,1
431940,2017,1,0,0,1
431940,2018,0,1,0,1
431940,2021,0,1,0,1
431950,2015,3,0,0,3
431950,2016,1,0,0,1
431950,2017,1,0,0,1
431950,2019,3,0,0,3
431950,2020,1,0,1,2
431950,2021,1,2,0,3
431960,2017,0,1,0,1
431960,2018,2,0,0,2
431960,2019,0,1,0,1
431960,2020,1,1,0,2
431970,2018,1,0,0,1
431970,2020,1,0,0,1
431973,2018,1,0,0,1
431973,2019,2,0,0,2
431980,2020,1,0,0,1
431990,2015,1,0,0,1
431990,2016,1,0,1,2
431990,2017,0,0,1,1
431990,2018,3,0,1,4
431990,2019,2,0,0,2
431990,2020,1,0,0,1
431990,2021,1,0,0,1
431990,2022,1,0,0,1
432000,2015,3,1,2,6
432000,2016,2,1,1,4
432000,2017,4,1,2,7
432000,2018,2,0,1,3
432000,2020,0,2,2,4
432000,2021,3,1,3,7
432000,2022,3,0,2,5
432010,2021,1,0,0,1
432020,2017,1,0,0,1
432020,2018,1,0,0,1
432026,2019,1,0,0,1
432030,2021,1,0,0,1
432040,2015,2,0,1,3
432040,2016,2,0,0,2
432040,2017,0,0,1,1
432040,2018,1,0,0,1
432040,2019,1,0,0,1
432040,2021,0,1,0,1
432040,2022,2,0,0,2
432045,2020,0,1,0,1
432050,2016,1,0,0,1
432055,2016,1,0,0,1
432060,2022,0,0,1,1
432067,2019,1,1,0,2
432070,2015,0,0,1,1
432070,2019,1,0,1,2
432070,2020,3,0,0,3
432070,2022,1,0,0,1
432080,2018,1,0,0,1
432080,2019,2,0,0,2
432080,2022,1,0,1,2
432090,2015,0,0,2,2
432090,2018,3,0,0,3
432090,2019,1,0,1,2
432090,2020,1,0,0,1
432090,2022,0,0,1,1
432100,2015,2,0,0,2
432100,2016,0,0,1,1
432100,2020,0,0,1,1
432110,2019,1,0,0,1
432120,2015,1,0,1,2
432120,2016,2,0,1,3
432120,2017,1,0,0,1
432120,2018,2,0,0,2
432120,2021,1,0,0,1
432120,2022,1,0,0,1
432130,2015,1,0,0,1
432130,2016,0,1,0,1
432130,2018,1,0,1,2
432130,2019,1,0,0,1
432130,2020,1,1,0,2
432130,2021,2,0,1,3
432130,2022,1,2,0,3
432132,2019,0,0,2,2
432140,2016,1,0,0,1
432140,2018,1,0,0,1
432140,2019,1,0,1,2
432140,2020,1,0,1,2
432140,2021,2,0,1,3
432145,2015,1,0,0,1
432145,2016,2,0,5,7
432145,2017,4,0,2,6
432145,2018,4,0,3,7
432145,2019,8,0,0,8
432145,2020,3,0,4,7
432145,2021,1,0,2,3
432145,2022,1,0,0,1
432147,2017,0,1,0,1
432147,2021,1,0,0,1
432147,2022,1,0,0,1
432150,2015,0,0,1,1
432150,2018,2,0,0,2
432150,2019,1,0,2,3
432150,2020,2,0,0,2
432150,2022,1,0,0,1
432160,2019,1,1,1,3
432160,2020,1,0,0,1
432170,2015,0,0,1,1
432170,2016,1,0,0,1
432170,2017,2,0,0,2
432170,2018,1,0,1,2
432170,2020,1,0,0,1
432180,2015,1,0,0,1
432180,2016,1,0,1,2
432180,2017,2,0,1,3
432180,2018,1,0,4,5
432180,2019,3,1,0,4
432180,2020,5,0,0,5
432180,2021,3,0,2,5
432180,2022,0,1,1,2
432190,2015,2,0,0,2
432190,2016,2,0,1,3
432190,2017,4,0,1,5
432190,2019,3,0,3,6
432190,2020,6,0,2,8
432190,2021,2,1,0,3
432190,2022,3,1,1,5
432195,2018,1,0,0,1
432200,2017,0,1,0,1
432200,2021,1,0,1,2
432200,2022,1,0,1,2
432210,2017,0,1,0,1
432210,2019,0,0,1,1
432220,2019,1,0,0,1
432220,2022,1,0,0,1
432225,2017,0,0,1,1
432230,2016,1,0,0,1
432230,2017,1,0,0,1
432240,2015,0,2,0,2
432240,2016,1,0,1,2
432240,2017,3,1,0,4
432240,2018,0,1,2,3
432240,2019,4,1,3,8
432240,2020,0,1,0,1
432240,2021,1,1,1,3
432240,2022,1,0,0,1
432250,2015,2,0,2,4
432250,2016,2,1,2,5
432250,2017,3,1,1,5
432250,2018,0,0,1,1
432250,2019,3,0,0,3
432250,2021,1,0,0,1
432250,2022,2,1,3,6
432253,2020,1,0,0,1
432260,2015,8,1,0,9
432260,2016,9,2,4,15
432260,2017,6,0,0,6
432260,2018,4,0,1,5
432260,2019,0,1,0,1
432260,2020,6,0,0,6
432260,2021,4,0,1,5
432260,2022,3,1,0,4
432270,2015,2,0,1,3
432270,2016,1,0,1,2
432270,2017,2,0,0,2
432270,2018,0,1,0,1
432270,2020,0,0,1,1
432280,2015,1,1,1,3
432280,2017,1,0,0,1
432280,2019,2,0,0,2
432280,2020,1,0,1,2
432280,2022,1,1,0,2
432285,2017,1,0,0,1
432285,2019,1,0,0,1
432290,2022,0,0,1,1
432300,2015,1,0,2,3
432300,2016,1,0,2,3
432300,2017,7,0,3,10
432300,2018,1,0,3,4
432300,2019,2,2,1,5
432300,2020,4,1,1,6
432300,2021,1,0,1,2
432330,2016,1,1,0,2
432330,2022,1,0,0,1
432340,2015,2,0,0,2
432340,2021,1,0,0,1
432350,2017,0,0,1,1
432350,2021,0,0,1,1
432350,2022,1,0,0,1
432370,2017,0,1,0,1
432377,2015,1,0,0,1
5e+05,2015,0,1,0,1
5e+05,2016,1,0,1,2
5e+05,2019,2,0,0,2
5e+05,2022,2,1,0,3
500020,2017,0,1,0,1
500020,2018,1,0,1,2
500020,2019,0,0,1,1
500020,2021,0,0,2,2
500020,2022,3,0,0,3
500060,2015,1,0,0,1
500060,2016,4,0,0,4
500060,2017,1,1,0,2
500060,2018,7,0,1,8
500060,2019,3,0,3,6
500060,2020,5,4,1,10
500060,2021,3,1,3,7
500060,2022,3,0,2,5
500070,2017,0,1,0,1
500070,2018,1,0,1,2
500070,2020,1,1,0,2
500080,2017,1,0,0,1
500080,2019,1,2,0,3
500080,2020,0,0,1,1
500085,2015,0,0,2,2
500085,2016,1,0,0,1
500085,2017,1,0,0,1
500085,2018,1,0,0,1
500085,2020,1,0,0,1
500085,2022,0,1,0,1
500090,2015,1,0,0,1
500090,2018,1,0,0,1
500090,2021,1,1,0,2
500100,2015,0,0,1,1
500100,2017,4,0,1,5
500100,2018,1,0,2,3
500100,2019,0,0,2,2
500100,2020,3,0,0,3
500100,2021,0,0,3,3
500100,2022,0,0,2,2
500110,2017,3,0,0,3
500110,2018,1,1,1,3
500110,2019,1,0,0,1
500124,2016,0,0,1,1
500124,2017,1,0,0,1
500124,2020,1,0,0,1
500124,2022,1,0,1,2
500150,2017,0,0,1,1
500150,2018,0,1,0,1
500150,2019,0,0,1,1
500150,2020,0,0,2,2
500150,2021,0,1,0,1
500190,2015,6,0,0,6
500190,2016,2,0,1,3
500190,2017,2,1,0,3
500190,2018,3,0,1,4
500190,2019,2,0,0,2
500190,2020,3,0,0,3
500200,2019,1,0,0,1
500200,2020,1,0,0,1
500200,2022,0,1,0,1
500210,2018,1,0,0,1
500210,2019,1,0,0,1
500210,2020,1,0,0,1
500210,2021,1,0,0,1
500215,2017,1,0,0,1
500215,2019,1,0,2,3
500220,2015,0,1,2,3
500220,2016,0,0,1,1
500220,2017,1,0,1,2
500220,2018,2,2,0,4
500220,2019,0,0,1,1
500220,2021,1,0,0,1
500220,2022,1,0,0,1
500230,2017,0,0,1,1
500230,2018,2,0,1,3
500230,2020,2,0,1,3
500230,2022,1,0,0,1
500240,2016,1,0,0,1
500240,2017,1,0,0,1
500240,2018,4,0,2,6
500240,2019,3,0,1,4
500240,2020,3,0,1,4
500240,2021,2,0,2,4
500240,2022,1,0,0,1
500260,2015,2,0,1,3
500260,2017,1,0,0,1
500260,2018,0,1,1,2
500260,2019,2,0,0,2
500260,2020,1,0,1,2
500260,2021,3,0,0,3
500260,2022,0,0,1,1
500270,2015,57,24,41,122
500270,2016,74,12,47,133
500270,2017,80,16,53,149
500270,2018,89,20,48,157
500270,2019,124,22,41,187
500270,2020,74,22,32,128
500270,2021,73,21,37,131
500270,2022,103,34,47,184
500280,2021,1,0,0,1
500290,2016,1,0,1,2
500290,2017,2,0,0,2
500290,2018,0,0,1,1
500290,2019,1,1,0,2
500290,2020,2,0,1,3
500290,2021,2,1,2,5
500290,2022,2,0,0,2
500295,2015,2,0,0,2
500295,2017,4,0,2,6
500295,2018,1,0,1,2
500295,2019,3,1,1,5
500295,2020,1,0,0,1
500295,2021,4,0,1,5
500295,2022,3,1,1,5
500310,2019,0,0,1,1
500315,2022,1,0,0,1
500320,2015,3,0,5,8
500320,2016,3,0,0,3
500320,2017,6,0,4,10
500320,2018,9,5,1,15
500320,2019,7,1,1,9
500320,2020,8,0,4,12
500320,2021,3,0,1,4
500320,2022,5,3,2,10
500325,2016,0,0,1,1
500325,2017,2,0,2,4
500325,2018,1,0,0,1
500325,2019,1,0,1,2
500325,2020,2,0,0,2
500330,2015,0,1,1,2
500330,2016,2,0,0,2
500330,2018,2,0,0,2
500330,2019,1,1,0,2
500330,2020,2,0,0,2
500330,2021,1,0,3,4
500330,2022,4,1,1,6
500345,2016,0,1,1,2
500345,2017,3,0,0,3
500345,2019,1,0,1,2
500345,2020,2,0,1,3
500345,2021,1,0,2,3
500345,2022,2,0,0,2
500348,2018,0,0,1,1
500350,2015,0,0,1,1
500350,2016,0,0,2,2
500350,2018,2,0,0,2
500350,2020,1,0,0,1
500350,2022,1,0,0,1
500370,2015,20,3,16,39
500370,2016,18,5,10,33
500370,2017,32,3,10,45
500370,2018,25,9,12,46
500370,2019,30,3,16,49
500370,2020,25,6,19,50
500370,2021,19,1,13,33
500370,2022,42,10,5,57
500375,2018,1,0,1,2
500375,2019,0,0,1,1
500375,2021,1,1,0,2
500380,2015,1,0,1,2
500380,2016,1,0,0,1
500380,2017,3,0,1,4
500380,2018,3,0,0,3
500380,2022,4,0,0,4
500390,2021,1,0,0,1
500390,2022,1,0,0,1
500400,2017,1,0,2,3
500400,2018,0,0,1,1
500400,2019,1,0,0,1
500400,2021,0,0,1,1
500410,2017,1,0,0,1
500410,2018,0,0,1,1
500410,2020,0,0,1,1
500430,2019,2,0,1,3
500440,2017,1,0,0,1
500440,2018,1,0,0,1
500440,2021,1,0,1,2
500450,2016,1,0,1,2
500450,2020,0,0,1,1
500450,2021,1,0,0,1
500450,2022,0,1,1,2
500460,2017,0,0,1,1
500460,2018,3,0,0,3
500460,2020,1,2,0,3
500460,2021,1,1,0,2
500460,2022,1,0,0,1
500470,2015,1,0,6,7
500470,2016,1,0,1,2
500470,2017,4,0,1,5
500470,2018,2,1,1,4
500470,2019,0,0,1,1
500470,2020,1,0,1,2
500470,2022,5,0,0,5
500480,2018,1,0,0,1
500480,2019,1,0,0,1
500490,2021,0,0,1,1
500500,2015,1,0,1,2
500500,2017,2,1,0,3
500500,2018,2,0,0,2
500500,2019,2,0,0,2
500500,2020,2,1,1,4
500510,2017,0,1,0,1
500510,2018,1,0,0,1
500515,2019,1,0,0,1
500520,2017,1,0,1,2
500520,2018,0,0,1,1
500520,2020,1,0,2,3
500520,2021,0,0,1,1
500520,2022,0,0,2,2
500525,2018,0,0,2,2
500525,2019,2,0,0,2
500525,2021,1,0,1,2
500525,2022,1,0,1,2
500540,2015,3,0,1,4
500540,2016,0,0,1,1
500540,2017,4,1,5,10
500540,2018,2,0,2,4
500540,2019,0,0,3,3
500540,2020,0,0,2,2
500540,2021,0,1,1,2
500540,2022,1,0,1,2
500560,2015,1,0,1,2
500560,2018,3,0,0,3
500560,2019,2,1,1,4
500560,2020,0,1,2,3
500568,2015,1,0,0,1
500568,2017,1,0,0,1
500570,2015,1,0,0,1
500570,2016,5,0,2,7
500570,2017,3,0,2,5
500570,2018,6,6,1,13
500570,2019,10,4,0,14
500570,2020,11,2,1,14
500570,2021,4,0,4,8
500570,2022,5,1,4,10
500580,2015,0,0,1,1
500580,2018,0,1,0,1
500600,2015,0,0,1,1
500600,2017,1,0,1,2
500600,2018,0,0,1,1
500600,2019,1,0,0,1
500600,2020,0,0,2,2
500600,2021,0,0,1,1
500620,2015,0,0,1,1
500620,2016,0,0,1,1
500620,2017,1,0,0,1
500620,2018,1,0,3,4
500620,2019,1,0,1,2
500620,2020,2,0,0,2
500620,2021,1,0,0,1
500620,2022,4,0,2,6
500625,2017,1,0,0,1
500625,2018,1,0,0,1
500625,2019,1,0,0,1
500625,2020,0,0,1,1
500630,2015,3,0,2,5
500630,2017,2,2,2,6
500630,2018,2,0,0,2
500630,2019,6,0,1,7
500630,2020,5,1,3,9
500630,2021,4,1,1,6
500630,2022,6,1,3,10
500635,2019,0,0,1,1
500635,2020,1,0,0,1
500635,2021,1,0,0,1
500640,2018,1,0,0,1
500640,2019,1,0,1,2
500640,2022,0,1,0,1
500660,2015,1,0,1,2
500660,2016,1,0,3,4
500660,2017,6,1,2,9
500660,2018,5,2,3,10
500660,2019,5,0,1,6
500660,2020,1,2,1,4
500660,2021,2,1,1,4
500660,2022,6,1,1,8
500690,2017,1,0,0,1
500710,2015,1,0,1,2
500710,2017,1,0,0,1
500710,2019,1,0,0,1
500710,2020,1,0,0,1
500710,2021,0,0,1,1
500710,2022,1,0,0,1
500720,2015,2,0,2,4
500720,2016,0,0,1,1
500720,2017,1,0,1,2
500720,2018,0,0,1,1
500720,2019,6,0,0,6
500720,2020,1,0,0,1
500720,2021,1,0,1,2
500720,2022,0,1,1,2
500730,2021,0,0,1,1
500740,2016,0,0,1,1
500740,2017,0,0,1,1
500740,2018,3,0,0,3
500740,2019,1,0,0,1
500740,2020,1,0,0,1
500740,2022,3,0,1,4
500750,2017,0,0,1,1
500750,2018,1,0,0,1
500769,2015,6,1,1,8
500769,2016,1,0,0,1
500769,2018,3,1,0,4
500769,2019,3,1,1,5
500769,2020,1,1,0,2
500769,2021,3,1,1,5
500769,2022,3,1,0,4
500770,2018,1,0,0,1
500780,2016,0,0,1,1
500780,2017,1,0,0,1
500780,2022,2,0,0,2
500790,2015,1,2,0,3
500790,2016,0,1,0,1
500790,2017,6,0,1,7
500790,2018,1,0,1,2
500790,2019,0,4,2,6
500790,2020,2,1,1,4
500790,2021,2,0,1,3
500793,2015,1,0,3,4
500793,2017,4,0,2,6
500793,2018,1,1,2,4
500793,2019,1,0,1,2
500793,2020,1,0,0,1
500793,2022,0,0,1,1
500795,2022,0,1,0,1
500797,2018,1,0,0,1
500797,2019,0,0,1,1
500800,2017,0,1,1,2
500800,2018,0,1,1,2
500800,2019,1,0,0,1
500800,2021,0,0,1,1
500800,2022,2,0,1,3
500830,2015,4,0,6,10
500830,2016,4,0,0,4
500830,2017,10,1,4,15
500830,2018,11,1,3,15
500830,2019,7,1,6,14
500830,2020,2,1,5,8
500830,2021,3,0,3,6
500830,2022,7,1,2,10
500840,2015,1,0,0,1
500840,2017,1,0,0,1
500840,2019,1,0,0,1
500840,2021,1,0,0,1
510000,2017,2,0,0,2
510000,2018,2,0,0,2
510000,2019,1,0,0,1
510000,2022,2,0,0,2
510010,2016,1,0,0,1
510010,2018,1,0,1,2
510010,2020,1,0,0,1
510010,2021,1,0,1,2
510020,2015,1,0,0,1
510020,2016,1,0,0,1
510020,2017,5,0,0,5
510020,2018,5,0,2,7
510020,2019,5,1,0,6
510020,2020,1,0,0,1
510020,2021,5,0,2,7
510020,2022,2,2,1,5
510025,2015,1,0,0,1
510025,2016,4,1,2,7
510025,2017,1,0,0,1
510025,2018,2,3,1,6
510025,2019,0,2,2,4
510025,2020,4,0,0,4
510025,2021,2,0,1,3
510025,2022,6,1,2,9
510030,2015,2,0,0,2
510030,2016,0,0,1,1
510030,2017,0,0,1,1
510030,2019,3,1,1,5
510030,2020,1,2,1,4
510030,2021,0,0,1,1
510035,2015,0,0,1,1
510040,2015,1,0,0,1
510040,2018,1,0,1,2
510040,2019,1,0,1,2
510040,2020,3,0,0,3
510040,2021,0,1,1,2
510050,2022,1,0,0,1
510060,2015,0,0,1,1
510060,2018,0,0,1,1
510060,2019,1,0,0,1
510060,2021,0,1,0,1
510060,2022,1,0,0,1
510125,2016,1,0,0,1
510125,2017,0,0,1,1
510125,2018,1,0,0,1
510125,2019,1,0,0,1
510125,2020,0,0,2,2
510125,2022,0,0,2,2
510130,2016,0,0,3,3
510130,2018,0,0,2,2
510130,2019,0,0,1,1
510130,2020,1,0,0,1
510130,2022,2,0,0,2
510140,2020,0,0,1,1
510140,2021,0,0,1,1
510140,2022,0,0,1,1
510170,2015,0,0,1,1
510170,2016,1,0,0,1
510170,2017,2,2,1,5
510170,2018,5,0,1,6
510170,2019,3,0,1,4
510170,2020,1,1,2,4
510170,2021,3,2,0,5
510170,2022,2,1,3,6
510180,2015,1,1,1,3
510180,2016,1,0,1,2
510180,2017,2,0,0,2
510180,2018,3,2,4,9
510180,2019,6,1,0,7
510180,2020,3,2,5,10
510180,2021,6,0,3,9
510180,2022,10,2,3,15
510185,2021,0,1,1,2
510190,2019,1,0,0,1
510190,2021,0,0,1,1
510190,2022,1,0,0,1
510250,2015,3,2,3,8
510250,2016,4,0,3,7
510250,2017,10,1,5,16
510250,2018,5,1,4,10
510250,2019,3,0,7,10
510250,2020,4,2,1,7
510250,2021,9,1,5,15
510250,2022,3,0,2,5
510260,2018,1,0,0,1
510263,2015,0,0,1,1
510263,2016,2,0,1,3
510263,2017,3,0,6,9
510263,2018,7,2,5,14
510263,2019,5,0,5,10
510263,2020,2,2,8,12
510263,2021,6,1,3,10
510263,2022,2,1,2,5
510267,2016,4,1,2,7
510267,2017,0,0,5,5
510267,2018,4,0,4,8
510267,2019,2,0,2,4
510267,2020,2,1,0,3
510267,2021,1,0,0,1
510267,2022,2,0,1,3
510268,2017,0,0,1,1
510268,2018,1,0,0,1
510268,2019,0,0,1,1
510268,2020,1,1,1,3
510268,2021,2,0,1,3
510268,2022,2,0,1,3
510270,2016,1,0,0,1
510270,2019,3,0,0,3
510270,2021,2,0,0,2
510270,2022,1,0,0,1
510285,2016,0,0,1,1
510300,2017,1,0,0,1
510300,2019,1,0,2,3
510300,2020,2,0,0,2
510300,2021,2,1,1,4
510300,2022,1,0,2,3
510305,2019,0,0,1,1
510305,2020,0,0,1,1
510305,2021,0,1,0,1
510305,2022,1,0,0,1
510320,2019,1,0,0,1
510320,2020,1,0,0,1
510320,2021,2,0,2,4
510330,2019,1,0,0,1
510330,2021,1,0,1,2
510330,2022,0,0,2,2
510335,2017,1,1,0,2
510337,2016,1,0,0,1
510340,2015,32,6,17,55
510340,2016,73,13,47,133
510340,2017,103,11,68,182
510340,2018,84,24,76,184
510340,2019,83,27,64,174
510340,2020,97,33,66,196
510340,2021,108,26,57,191
510340,2022,106,35,46,187
510343,2020,1,0,0,1
510345,2015,1,0,0,1
510345,2017,2,0,0,2
510345,2018,0,0,1,1
510345,2019,0,0,3,3
510345,2020,0,0,1,1
510345,2022,0,0,2,2
510350,2015,0,0,2,2
510350,2016,1,2,0,3
510350,2017,4,0,2,6
510350,2018,2,0,2,4
510350,2019,3,0,1,4
510350,2020,0,0,1,1
510350,2021,0,1,0,1
510350,2022,1,0,1,2
510370,2022,1,0,1,2
510385,2019,0,0,1,1
510390,2021,3,0,0,3
510410,2018,3,0,0,3
510410,2022,0,0,1,1
510420,2017,0,0,1,1
510452,2019,0,0,1,1
510452,2022,1,1,0,2
510454,2019,1,0,2,3
510454,2021,2,0,0,2
510455,2022,1,0,0,1
510460,2015,1,0,1,2
510460,2018,1,0,0,1
510460,2019,0,0,1,1
510480,2015,1,0,0,1
510480,2016,0,1,0,1
510480,2017,0,0,1,1
510480,2018,1,0,0,1
510480,2019,1,0,0,1
510480,2021,1,0,0,1
510480,2022,0,0,2,2
510490,2017,0,0,1,1
510490,2018,1,0,0,1
510490,2020,0,0,1,1
510500,2017,0,0,1,1
510510,2017,0,0,2,2
510510,2018,1,0,0,1
510510,2019,2,0,0,2
510510,2020,2,0,1,3
510510,2021,4,0,2,6
510510,2022,1,1,0,2
510515,2016,1,0,0,1
510515,2018,1,0,1,2
510515,2019,1,0,0,1
510515,2020,0,0,1,1
510515,2021,0,1,1,2
510515,2022,5,0,0,5
510520,2019,1,0,1,2
510520,2020,0,1,0,1
510525,2015,4,0,6,10
510525,2016,1,1,6,8
510525,2017,7,1,7,15
510525,2018,17,2,9,28
510525,2019,8,2,10,20
510525,2020,7,3,7,17
510525,2021,13,1,10,24
510525,2022,11,5,5,21
510550,2021,0,0,1,1
510558,2018,1,0,0,1
510558,2021,0,0,1,1
510558,2022,1,0,0,1
510560,2017,1,0,0,1
510560,2018,0,0,1,1
510560,2019,1,0,0,1
510560,2020,2,0,0,2
510560,2021,0,0,1,1
510562,2015,1,0,0,1
510562,2017,1,0,0,1
510562,2019,1,0,0,1
510562,2020,2,0,0,2
510562,2021,1,1,0,2
510562,2022,3,1,1,5
510590,2016,1,0,0,1
510590,2017,1,1,0,2
510590,2018,1,0,0,1
510590,2020,1,0,0,1
510590,2021,1,1,0,2
510590,2022,1,0,1,2
510600,2015,0,0,1,1
510610,2015,0,0,1,1
510610,2018,0,0,1,1
510610,2019,1,0,0,1
510610,2022,0,0,1,1
510615,2019,1,0,0,1
510615,2020,1,0,0,1
510615,2021,0,0,1,1
510617,2019,0,2,0,2
510617,2021,1,0,0,1
510620,2018,1,0,0,1
510621,2017,0,0,1,1
510621,2021,0,0,1,1
510621,2022,1,0,1,2
510622,2015,3,0,3,6
510622,2016,6,0,7,13
510622,2017,9,0,3,12
510622,2018,4,0,3,7
510622,2019,3,2,1,6
510622,2020,5,1,3,9
510622,2021,4,3,8,15
510622,2022,5,0,5,10
510623,2016,2,0,2,4
510623,2017,0,0,4,4
510623,2018,4,1,0,5
510623,2019,1,0,1,2
510623,2020,3,0,0,3
510623,2021,1,0,3,4
510623,2022,4,0,2,6
510624,2018,2,0,0,2
510624,2019,1,0,0,1
510624,2021,1,0,0,1
510624,2022,1,0,0,1
510625,2017,1,0,0,1
510625,2018,0,0,1,1
510625,2019,1,0,2,3
510625,2020,0,0,1,1
510625,2021,0,0,2,2
510625,2022,1,0,1,2
510629,2017,1,0,0,1
510629,2018,0,0,1,1
510629,2019,1,0,0,1
510630,2017,1,0,0,1
510630,2018,1,1,2,4
510637,2015,0,0,1,1
510637,2017,1,0,0,1
510637,2018,1,0,1,2
510637,2019,0,0,1,1
510637,2020,0,1,0,1
510637,2021,1,0,0,1
510642,2015,1,0,0,1
510650,2016,0,1,1,2
510650,2019,3,0,0,3
510650,2020,0,0,1,1
510650,2022,2,0,0,2
510665,2018,1,0,1,2
510665,2021,1,0,0,1
510675,2016,1,0,1,2
510675,2018,0,0,2,2
510675,2019,0,1,1,2
510675,2021,4,0,0,4
510675,2022,6,0,1,7
510680,2018,0,0,1,1
510682,2016,1,0,0,1
510682,2017,1,0,0,1
510685,2021,0,1,0,1
510700,2020,2,0,0,2
510700,2021,0,0,1,1
510704,2015,4,0,4,8
510704,2016,8,2,7,17
510704,2017,4,0,4,8
510704,2018,6,2,6,14
510704,2019,5,5,4,14
510704,2020,7,1,6,14
510704,2021,11,1,5,17
510704,2022,9,1,5,15
510706,2015,0,0,1,1
510706,2020,0,0,1,1
510706,2021,1,0,0,1
510710,2019,1,0,0,1
510718,2016,0,1,0,1
510719,2018,1,0,0,1
510720,2019,0,1,0,1
510724,2019,1,0,0,1
510724,2021,0,0,1,1
510726,2016,0,0,1,1
510726,2020,1,0,0,1
510726,2021,1,0,0,1
510730,2017,2,0,0,2
510730,2021,1,0,1,2
510735,2021,0,0,1,1
510740,2020,0,1,0,1
510760,2015,5,1,3,9
510760,2016,8,0,5,13
510760,2017,14,4,10,28
510760,2018,10,2,4,16
510760,2019,9,2,7,18
510760,2020,13,3,5,21
510760,2021,12,1,9,22
510760,2022,14,2,11,27
510770,2015,2,0,0,2
510770,2019,1,0,1,2
510770,2020,1,0,0,1
510770,2022,1,0,0,1
510774,2022,0,0,1,1
510776,2020,1,0,0,1
510780,2016,1,0,0,1
510780,2020,2,0,0,2
510780,2022,1,0,1,2
510787,2015,1,0,0,1
510787,2016,1,0,2,3
510787,2017,1,0,0,1
510787,2018,4,0,1,5
510787,2019,2,1,0,3
510787,2020,1,0,1,2
510787,2021,2,0,4,6
510787,2022,5,0,4,9
510790,2015,1,0,1,2
510790,2016,2,3,1,6
510790,2017,10,3,5,18
510790,2018,7,2,5,14
510790,2019,13,1,2,16
510790,2020,15,4,10,29
510790,2021,19,5,15,39
510790,2022,18,3,14,35
510792,2015,0,1,2,3
510792,2016,1,0,2,3
510792,2017,3,3,5,11
510792,2018,5,0,6,11
510792,2019,1,0,4,5
510792,2020,6,2,3,11
510792,2021,5,1,6,12
510792,2022,4,1,7,12
510794,2015,0,0,1,1
510794,2017,1,0,0,1
510794,2019,0,0,1,1
510795,2015,6,2,2,10
510795,2016,6,1,6,13
510795,2017,9,3,6,18
510795,2018,6,1,5,12
510795,2019,14,4,7,25
510795,2020,9,2,5,16
510795,2021,14,3,5,22
510795,2022,15,2,7,24
510800,2018,1,0,0,1
510800,2021,0,0,1,1
510800,2022,1,1,1,3
510805,2015,0,0,1,1
510805,2022,1,0,0,1
510820,2017,0,1,0,1
510820,2022,0,0,1,1
510840,2015,8,0,4,12
510840,2016,10,3,19,32
510840,2017,4,3,12,19
510840,2018,9,3,12,24
510840,2019,7,2,14,23
510840,2020,17,2,10,29
510840,2021,16,4,7,27
510840,2022,13,4,18,35
510850,2020,0,0,1,1
510860,2018,0,0,1,1
510880,2018,1,0,0,1
510880,2019,0,0,1,1
510880,2022,1,0,0,1
510885,2020,0,0,1,1
510885,2021,0,0,1,1
510890,2018,0,0,1,1
510895,2018,1,0,0,1
520000,2016,1,0,0,1
520000,2020,0,1,0,1
520000,2021,1,1,0,2
520005,2017,0,0,2,2
520005,2018,1,0,0,1
520005,2019,0,0,1,1
520005,2021,0,0,2,2
520005,2022,1,0,1,2
520010,2017,3,0,1,4
520010,2018,2,0,0,2
520010,2020,1,0,0,1
520010,2021,2,0,0,2
520013,2015,1,0,1,2
520013,2016,1,0,0,1
520013,2017,2,0,3,5
520013,2019,2,0,2,4
520013,2020,1,0,1,2
520013,2021,0,0,1,1
520013,2022,1,0,2,3
520025,2015,2,0,2,4
520025,2016,1,0,6,7
520025,2017,2,2,5,9
520025,2018,1,3,1,5
520025,2019,2,2,1,5
520025,2020,4,1,2,7
520025,2021,2,2,3,7
520025,2022,1,0,2,3
520030,2016,0,0,1,1
520030,2017,1,0,0,1
520030,2018,3,0,1,4
520030,2020,1,0,0,1
520030,2022,1,1,1,3
520055,2015,4,0,1,5
520055,2016,1,0,1,2
520055,2017,1,0,1,2
520055,2018,1,0,1,2
520055,2019,1,0,0,1
520055,2020,0,0,1,1
520055,2022,3,0,1,4
520060,2022,0,0,1,1
520080,2022,0,1,0,1
520085,2019,0,1,0,1
520110,2015,17,1,19,37
520110,2016,24,1,14,39
520110,2017,46,7,29,82
520110,2018,25,4,28,57
520110,2019,33,7,13,53
520110,2020,28,3,18,49
520110,2021,24,4,15,43
520110,2022,26,9,20,55
520130,2017,1,0,0,1
520130,2018,0,0,1,1
520130,2020,1,0,0,1
520130,2022,0,2,1,3
520140,2015,27,3,27,57
520140,2016,46,3,23,72
520140,2017,45,7,20,72
520140,2018,58,7,24,89
520140,2019,25,2,14,41
520140,2020,36,6,23,65
520140,2021,38,5,19,62
520140,2022,40,8,30,78
520145,2020,0,0,1,1
520145,2021,1,0,0,1
520160,2020,0,1,0,1
520170,2015,1,0,0,1
520170,2017,1,0,0,1
520170,2020,1,0,0,1
520170,2021,0,1,0,1
520170,2022,1,0,0,1
520180,2020,0,0,1,1
520215,2017,0,1,0,1
520250,2017,0,0,1,1
520260,2022,1,0,0,1
520320,2016,2,0,1,3
520320,2018,1,1,0,2
520320,2019,1,0,2,3
520320,2021,0,2,0,2
520320,2022,3,0,1,4
520330,2015,1,0,2,3
520330,2016,2,1,0,3
520330,2017,0,0,2,2
520330,2018,1,1,3,5
520330,2019,3,0,1,4
520330,2020,1,0,0,1
520330,2021,3,0,0,3
520330,2022,1,0,0,1
520340,2019,1,0,0,1
520350,2016,1,0,2,3
520350,2018,1,0,4,5
520350,2019,0,1,1,2
520350,2020,1,0,2,3
520350,2021,1,0,2,3
520350,2022,3,0,0,3
520355,2018,2,0,0,2
520380,2015,1,0,0,1
520380,2020,0,0,1,1
520390,2018,2,0,3,5
520390,2019,1,0,1,2
520390,2020,1,0,0,1
520390,2021,0,0,1,1
520390,2022,5,0,2,7
520410,2015,0,1,0,1
520410,2016,1,0,1,2
520410,2021,2,0,0,2
520425,2016,1,0,1,2
520425,2017,0,0,1,1
520425,2018,1,0,2,3
520425,2019,1,0,0,1
520425,2020,0,0,2,2
520425,2022,1,0,1,2
520430,2018,1,0,0,1
520430,2019,2,0,0,2
520430,2022,1,0,0,1
520440,2015,1,0,0,1
520440,2018,0,0,1,1
520450,2015,2,0,0,2
520450,2016,2,1,5,8
520450,2017,2,2,0,4
520450,2018,4,0,4,8
520450,2019,4,0,3,7
520450,2020,2,0,4,6
520450,2021,2,1,6,9
520450,2022,1,1,4,6
520470,2015,0,0,1,1
520470,2019,0,0,1,1
520470,2022,1,0,0,1
520485,2021,0,1,0,1
520490,2016,1,0,1,2
520490,2017,1,0,0,1
520490,2021,0,0,2,2
520500,2018,1,0,0,1
520505,2021,1,0,0,1
520505,2022,0,1,0,1
520510,2015,13,0,8,21
520510,2016,19,0,5,24
520510,2017,11,5,7,23
520510,2018,13,2,5,20
520510,2019,13,5,10,28
520510,2020,15,5,8,28
520510,2021,11,9,8,28
520510,2022,24,4,7,35
520520,2018,0,0,1,1
520520,2020,0,1,0,1
520540,2016,2,0,1,3
520540,2018,2,0,0,2
520540,2022,0,1,0,1
520545,2016,1,0,1,2
520545,2018,1,0,0,1
520545,2019,1,0,0,1
520547,2018,1,0,0,1
520547,2020,0,0,1,1
520547,2021,0,0,1,1
520547,2022,0,0,2,2
520549,2015,7,1,2,10
520549,2016,8,3,3,14
520549,2017,6,1,4,11
520549,2018,3,0,2,5
520549,2019,3,0,1,4
520549,2020,2,1,2,5
520549,2021,2,3,1,6
520549,2022,1,2,3,6
520552,2019,1,0,0,1
520590,2017,0,0,2,2
520590,2018,1,0,1,2
520590,2019,1,0,0,1
520590,2022,0,1,0,1
520620,2015,2,0,0,2
520620,2016,3,0,0,3
520620,2018,2,0,1,3
520620,2019,1,0,0,1
520620,2022,1,0,0,1
520640,2015,1,0,1,2
520640,2016,2,0,0,2
520640,2017,1,0,0,1
520640,2021,4,0,1,5
520640,2022,1,1,0,2
520650,2022,0,0,1,1
520660,2019,1,0,1,2
520660,2022,1,0,0,1
520680,2016,0,0,1,1
520740,2015,1,0,0,1
520740,2016,0,0,1,1
520740,2017,0,0,1,1
520740,2018,1,0,3,4
520740,2019,1,0,1,2
520740,2020,0,0,1,1
520740,2022,0,0,2,2
520750,2019,1,0,0,1
520753,2016,1,0,0,1
520760,2018,0,0,1,1
520760,2022,1,0,0,1
520780,2015,0,0,1,1
520780,2016,0,0,1,1
520780,2018,1,0,0,1
520800,2015,3,1,1,5
520800,2016,2,0,2,4
520800,2018,0,0,1,1
520800,2019,2,0,1,3
520800,2020,1,1,1,3
520800,2021,0,1,1,2
520800,2022,3,0,1,4
520815,2018,0,0,1,1
520815,2020,0,1,0,1
520830,2021,0,0,1,1
520830,2022,1,0,0,1
520840,2017,1,0,0,1
520840,2020,1,0,0,1
520850,2017,0,1,0,1
520850,2018,1,0,0,1
520850,2019,0,0,1,1
520850,2020,0,0,1,1
520860,2015,0,0,1,1
520860,2016,3,0,0,3
520860,2017,2,0,0,2
520860,2018,2,0,1,3
520860,2019,2,0,2,4
520860,2020,3,0,2,5
520860,2021,4,0,4,8
520860,2022,3,1,3,7
520870,2015,154,36,91,281
520870,2016,158,29,64,251
520870,2017,228,42,103,373
520870,2018,211,47,97,355
520870,2019,94,19,54,167
520870,2020,138,27,51,216
520870,2021,207,52,67,326
520870,2022,191,46,77,314
520880,2015,1,0,0,1
520880,2016,0,0,3,3
520880,2017,1,0,2,3
520880,2018,2,1,1,4
520880,2019,0,1,0,1
520880,2022,3,1,0,4
520890,2015,0,0,1,1
520890,2017,1,0,0,1
520890,2018,1,0,0,1
520890,2019,2,1,1,4
520890,2020,0,0,1,1
520890,2021,0,0,1,1
520890,2022,4,0,1,5
520910,2015,0,0,3,3
520910,2016,3,0,0,3
520910,2017,0,0,2,2
520910,2018,3,0,3,6
520910,2019,0,2,6,8
520910,2020,0,1,7,8
520910,2021,1,0,0,1
520910,2022,2,0,1,3
520915,2017,1,0,0,1
520915,2018,0,0,1,1
520915,2019,1,0,2,3
520915,2020,0,0,1,1
520920,2017,0,1,0,1
520920,2018,1,0,0,1
520920,2019,1,0,0,1
520920,2021,1,0,0,1
520920,2022,0,1,0,1
520970,2017,1,0,0,1
520970,2018,1,0,1,2
520970,2020,2,0,0,2
520970,2021,2,0,0,2
520970,2022,1,0,0,1
520990,2019,0,0,1,1
520993,2019,1,0,1,2
520995,2019,0,1,0,1
520995,2022,0,0,1,1
521000,2015,1,0,1,2
521000,2016,2,1,1,4
521000,2017,1,0,1,2
521000,2018,2,0,0,2
521000,2021,2,2,0,4
521000,2022,1,1,0,2
521010,2018,0,3,0,3
521010,2019,1,0,0,1
521010,2020,3,0,0,3
521010,2021,1,0,0,1
521010,2022,0,1,0,1
521020,2021,1,0,0,1
521020,2022,2,1,0,3
521040,2016,1,0,0,1
521040,2017,0,0,1,1
521040,2018,1,0,0,1
521056,2016,0,0,1,1
521090,2016,0,0,1,1
521090,2021,0,1,1,2
521120,2016,1,0,0,1
521120,2022,0,0,1,1
521150,2015,2,0,0,2
521150,2016,4,0,4,8
521150,2017,9,1,10,20
521150,2018,9,1,5,15
521150,2019,4,1,2,7
521150,2020,3,2,2,7
521150,2021,5,0,1,6
521150,2022,6,1,6,13
521170,2017,0,1,1,2
521180,2015,1,0,0,1
521180,2016,1,0,0,1
521180,2017,2,0,0,2
521180,2021,1,0,0,1
521190,2015,0,0,5,5
521190,2016,5,0,2,7
521190,2017,5,1,3,9
521190,2018,5,1,4,10
521190,2019,5,1,3,9
521190,2020,3,2,6,11
521190,2021,8,0,4,12
521190,2022,11,2,5,18
521210,2018,0,0,1,1
521210,2019,1,0,0,1
521210,2020,0,0,1,1
521210,2021,0,1,0,1
521220,2015,0,0,2,2
521220,2018,1,0,0,1
521220,2020,1,0,0,1
521220,2021,1,0,0,1
521250,2015,5,1,3,9
521250,2016,4,1,7,12
521250,2017,7,0,6,13
521250,2018,6,3,6,15
521250,2019,8,1,2,11
521250,2020,2,0,3,5
521250,2021,6,5,0,11
521250,2022,3,1,2,6
521300,2015,0,0,1,1
521300,2017,1,0,2,3
521300,2019,1,0,1,2
521300,2021,2,0,0,2
521308,2015,0,0,1,1
521308,2016,1,0,0,1
521308,2018,3,1,0,4
521308,2019,2,0,0,2
521308,2020,0,0,2,2
521308,2021,0,0,2,2
521308,2022,1,0,1,2
521310,2015,3,0,6,9
521310,2016,5,0,3,8
521310,2017,3,0,6,9
521310,2018,3,0,8,11
521310,2019,8,0,5,13
521310,2020,8,0,7,15
521310,2021,9,0,10,19
521310,2022,6,2,11,19
521370,2021,1,0,1,2
521375,2016,1,0,0,1
521375,2017,0,0,1,1
521375,2018,1,0,2,3
521375,2019,2,0,0,2
521375,2020,2,0,2,4
521375,2021,0,0,2,2
521375,2022,1,0,0,1
521380,2015,0,0,1,1
521380,2016,0,0,2,2
521380,2017,1,0,8,9
521380,2018,1,0,1,2
521380,2019,0,0,1,1
521380,2020,4,1,6,11
521380,2021,3,0,4,7
521380,2022,1,0,2,3
521390,2021,1,0,0,1
521400,2017,1,0,0,1
521400,2019,1,0,0,1
521440,2016,1,0,0,1
521440,2019,0,1,0,1
521440,2022,0,0,1,1
521450,2015,0,1,3,4
521450,2016,1,0,0,1
521450,2017,1,0,4,5
521450,2018,0,0,1,1
521450,2019,1,0,1,2
521450,2020,1,0,1,2
521450,2021,1,0,0,1
521450,2022,1,0,2,3
521460,2015,3,0,0,3
521460,2016,1,0,2,3
521460,2017,2,0,1,3
521460,2018,0,0,1,1
521460,2019,1,0,0,1
521460,2020,4,0,1,5
521460,2021,1,0,0,1
521460,2022,1,0,0,1
521483,2021,0,0,1,1
521490,2022,1,0,0,1
521500,2015,0,0,1,1
521500,2016,1,0,0,1
521500,2017,2,0,0,2
521500,2021,0,0,1,1
521520,2017,1,0,0,1
521523,2015,2,0,3,5
521523,2016,5,0,1,6
521523,2017,1,1,2,4
521523,2018,3,0,3,6
521523,2019,1,1,3,5
521523,2020,1,0,0,1
521523,2021,0,0,1,1
521523,2022,1,0,2,3
521530,2016,1,0,0,1
521530,2017,1,0,1,2
521550,2017,1,0,0,1
521550,2018,0,0,2,2
521550,2020,1,0,0,1
521550,2021,1,0,0,1
521550,2022,0,1,0,1
521560,2015,0,1,2,3
521560,2016,3,1,0,4
521560,2018,1,0,0,1
521570,2015,0,0,1,1
521570,2017,0,0,1,1
521570,2018,0,0,1,1
521570,2019,0,0,1,1
521570,2020,1,1,1,3
521600,2021,0,0,1,1
521630,2020,3,0,0,3
521640,2016,1,0,0,1
521640,2021,0,0,1,1
521645,2019,1,0,0,1
521645,2021,0,0,1,1
521690,2019,0,1,0,1
521710,2019,0,0,1,1
521710,2021,0,0,1,1
521710,2022,2,0,1,3
521720,2016,1,0,0,1
521720,2018,0,0,1,1
521730,2017,1,0,1,2
521740,2015,1,0,0,1
521740,2016,1,0,0,1
521740,2018,1,1,1,3
521740,2019,1,0,0,1
521740,2020,0,1,0,1
521740,2021,2,1,0,3
521740,2022,1,0,0,1
521760,2015,4,0,2,6
521760,2016,1,0,0,1
521760,2017,0,0,2,2
521760,2018,2,1,1,4
521760,2019,2,0,1,3
521760,2020,1,0,1,2
521760,2021,1,0,1,2
521760,2022,0,1,1,2
521770,2015,1,0,0,1
521770,2017,0,0,1,1
521800,2016,0,0,1,1
521800,2017,1,0,0,1
521800,2018,1,0,0,1
521800,2019,1,0,0,1
521800,2022,1,0,1,2
521805,2015,0,0,2,2
521805,2016,0,0,1,1
521805,2019,1,0,1,2
521810,2021,1,0,0,1
521830,2015,0,0,1,1
521830,2016,1,0,0,1
521830,2017,0,1,0,1
521830,2018,1,0,0,1
521830,2020,1,0,0,1
521839,2019,1,0,0,1
521850,2015,5,0,8,13
521850,2016,0,0,2,2
521850,2017,3,0,3,6
521850,2018,6,0,8,14
521850,2019,6,1,4,11
521850,2020,3,2,4,9
521850,2021,8,0,4,12
521850,2022,8,2,4,14
521860,2016,1,0,0,1
521878,2017,1,0,0,1
521878,2018,3,0,0,3
521878,2019,1,0,0,1
521878,2020,1,0,0,1
521880,2015,9,2,17,28
521880,2016,5,1,12,18
521880,2017,31,8,45,84
521880,2018,40,3,38,81
521880,2019,24,6,15,45
521880,2020,22,2,21,45
521880,2021,13,3,13,29
521880,2022,20,6,11,37
521890,2022,1,0,0,1
521900,2018,0,0,1,1
521900,2019,0,1,0,1
521910,2022,0,0,1,1
521930,2015,0,0,1,1
521930,2016,3,0,3,6
521930,2017,2,0,1,3
521930,2018,1,0,3,4
521930,2019,1,0,1,2
521930,2020,3,0,2,5
521930,2021,1,0,0,1
521930,2022,1,0,2,3
521935,2021,1,0,0,1
521940,2017,1,0,0,1
521970,2021,0,0,1,1
521971,2018,0,0,1,1
521971,2021,0,0,1,1
521973,2015,0,2,1,3
521975,2015,0,0,1,1
521975,2017,3,0,1,4
521975,2018,1,0,0,1
521975,2019,0,0,6,6
521975,2020,1,0,0,1
521975,2021,1,0,1,2
521975,2022,2,1,1,4
521980,2020,1,0,0,1
522005,2022,0,0,1,1
522010,2015,0,0,1,1
522010,2016,1,0,1,2
522010,2017,2,0,1,3
522010,2018,3,0,5,8
522010,2019,0,0,1,1
522010,2020,1,0,1,2
522010,2021,2,0,1,3
522010,2022,3,0,1,4
522020,2020,0,0,1,1
522020,2021,1,0,0,1
522026,2015,0,0,3,3
522026,2016,1,0,0,1
522040,2016,0,0,1,1
522040,2020,0,1,0,1
522045,2015,3,0,1,4
522045,2016,2,0,6,8
522045,2017,0,0,5,5
522045,2018,4,0,3,7
522045,2019,1,0,1,2
522045,2020,4,0,2,6
522045,2021,3,0,2,5
522045,2022,4,1,2,7
522050,2019,1,0,0,1
522050,2020,0,0,2,2
522050,2021,1,0,0,1
522050,2022,1,0,0,1
522060,2017,1,0,1,2
522060,2019,1,0,1,2
522060,2022,1,0,0,1
522130,2017,0,0,1,1
522140,2015,4,0,1,5
522140,2016,0,0,5,5
522140,2017,9,1,7,17
522140,2018,3,4,2,9
522140,2019,1,0,4,5
522140,2020,1,0,4,5
522140,2021,5,3,5,13
522140,2022,0,0,1,1
522160,2016,1,0,1,2
522160,2019,1,0,0,1
522160,2020,2,0,1,3
522160,2021,1,0,0,1
522170,2016,1,0,0,1
522170,2017,1,0,0,1
522170,2018,0,0,1,1
522180,2018,2,0,0,2
522185,2015,5,1,10,16
522185,2016,9,3,8,20
522185,2017,7,1,8,16
522185,2018,8,0,3,11
522185,2019,6,2,6,14
522185,2020,3,1,0,4
522185,2021,4,0,3,7
522185,2022,7,0,1,8
522190,2020,1,0,0,1
522205,2016,1,0,0,1
522205,2019,1,0,0,1
522205,2020,1,0,0,1
530010,2015,270,64,145,479
530010,2016,237,52,115,404
530010,2017,191,53,90,334
530010,2018,153,56,57,266
530010,2019,138,43,68,249
530010,2020,108,46,48,202
530010,2021,93,51,43,187
530010,2022,99,34,53,186
NA,2015,0,1,5,6
NA,2016,4,1,0,5
NA,2017,4,0,3,7
NA,2018,2,1,2,5
NA,2019,3,1,3,7
NA,2020,1,0,0,1
NA,2021,0,0,1,1
NA,2022,9,1,0,10
