"MUNIC_RES","ano","sih_30_a_39","sih_40_a_49","sih_menor_30","sih_total"
110001,"2015",5,0,3,8
110001,"2016",3,2,8,13
110001,"2017",1,0,4,5
110001,"2018",4,1,8,13
110001,"2019",8,0,7,15
110001,"2020",1,0,6,7
110001,"2021",8,1,3,12
110001,"2022",0,1,1,2
110001,"2023",3,1,3,7
110002,"2015",16,3,50,69
110002,"2016",18,0,54,72
110002,"2017",34,3,53,90
110002,"2018",20,3,45,68
110002,"2019",17,2,55,74
110002,"2020",17,6,45,68
110002,"2021",20,4,43,67
110002,"2022",11,2,35,48
110002,"2023",15,3,25,43
110003,"2015",0,0,4,4
110003,"2016",0,0,2,2
110003,"2017",0,1,0,1
110003,"2018",0,0,1,1
110003,"2021",0,1,2,3
110003,"2022",0,0,1,1
110003,"2023",1,0,2,3
110004,"2015",32,3,53,88
110004,"2016",29,3,73,105
110004,"2017",19,5,64,88
110004,"2018",38,6,70,114
110004,"2019",26,2,55,83
110004,"2020",28,5,54,87
110004,"2021",9,3,18,30
110004,"2022",19,5,24,48
110004,"2023",15,2,23,40
110005,"2015",5,2,10,17
110005,"2016",4,1,10,15
110005,"2017",1,0,3,4
110005,"2018",4,0,5,9
110005,"2019",3,1,3,7
110005,"2020",3,1,4,8
110005,"2021",5,1,6,12
110005,"2022",0,0,4,4
110005,"2023",1,0,4,5
110006,"2015",4,0,5,9
110006,"2016",3,0,7,10
110006,"2017",2,0,3,5
110006,"2018",8,1,5,14
110006,"2019",1,0,5,6
110006,"2020",2,1,6,9
110006,"2021",2,1,2,5
110006,"2022",3,0,2,5
110006,"2023",3,0,7,10
110007,"2015",2,0,8,10
110007,"2016",1,0,6,7
110007,"2017",0,0,3,3
110007,"2018",0,0,1,1
110007,"2019",0,0,1,1
110007,"2020",0,0,3,3
110007,"2021",2,0,3,5
110007,"2022",0,0,1,1
110007,"2023",0,0,2,2
110008,"2015",0,0,4,4
110008,"2016",0,1,2,3
110008,"2017",0,0,3,3
110008,"2018",3,1,4,8
110008,"2019",1,0,4,5
110008,"2020",3,0,2,5
110008,"2021",0,0,1,1
110008,"2022",0,0,1,1
110008,"2023",2,0,1,3
110009,"2015",2,0,6,8
110009,"2016",2,1,4,7
110009,"2017",2,0,6,8
110009,"2018",0,1,4,5
110009,"2019",5,0,12,17
110009,"2020",6,1,9,16
110009,"2021",2,0,7,9
110009,"2022",3,1,12,16
110009,"2023",2,1,7,10
110010,"2015",29,4,56,89
110010,"2016",35,4,57,96
110010,"2017",42,6,60,108
110010,"2018",16,7,55,78
110010,"2019",31,8,62,101
110010,"2020",30,7,42,79
110010,"2021",35,12,51,98
110010,"2022",24,8,57,89
110010,"2023",20,6,30,56
110011,"2015",15,6,28,49
110011,"2016",18,6,39,63
110011,"2017",13,4,32,49
110011,"2018",23,6,38,67
110011,"2019",16,6,49,71
110011,"2020",19,8,40,67
110011,"2021",11,5,21,37
110011,"2022",6,1,11,18
110011,"2023",4,0,2,6
110012,"2015",26,9,73,108
110012,"2016",29,7,65,101
110012,"2017",28,3,65,96
110012,"2018",23,4,56,83
110012,"2019",31,2,66,99
110012,"2020",22,3,43,68
110012,"2021",19,2,27,48
110012,"2022",21,9,49,79
110012,"2023",15,1,21,37
110013,"2015",1,0,11,12
110013,"2016",3,0,7,10
110013,"2017",3,0,7,10
110013,"2018",6,4,16,26
110013,"2019",13,1,17,31
110013,"2020",3,3,15,21
110013,"2021",7,1,19,27
110013,"2022",10,0,12,22
110013,"2023",7,2,14,23
110014,"2015",1,0,0,1
110014,"2016",0,0,1,1
110014,"2017",2,0,2,4
110014,"2018",1,0,1,2
110014,"2019",0,0,2,2
110014,"2020",4,0,6,10
110014,"2021",3,0,2,5
110014,"2022",1,0,2,3
110014,"2023",0,0,1,1
110015,"2015",8,1,17,26
110015,"2016",7,0,16,23
110015,"2017",10,1,17,28
110015,"2018",5,2,4,11
110015,"2019",3,0,10,13
110015,"2020",1,0,5,6
110015,"2021",0,0,7,7
110015,"2022",5,2,8,15
110015,"2023",3,0,4,7
110018,"2015",5,5,21,31
110018,"2016",3,0,9,12
110018,"2017",3,2,18,23
110018,"2018",8,1,25,34
110018,"2019",1,2,10,13
110018,"2020",2,1,16,19
110018,"2021",6,2,13,21
110018,"2022",4,0,12,16
110018,"2023",4,2,14,20
110020,"2015",193,39,447,679
110020,"2016",179,39,377,595
110020,"2017",149,24,370,543
110020,"2018",155,18,330,503
110020,"2019",174,30,292,496
110020,"2020",127,30,239,396
110020,"2021",124,27,260,411
110020,"2022",120,23,219,362
110020,"2023",102,32,205,339
110025,"2015",4,0,6,10
110025,"2016",5,0,3,8
110025,"2017",3,3,9,15
110025,"2018",5,3,4,12
110025,"2019",6,2,6,14
110025,"2020",3,0,6,9
110025,"2021",0,0,1,1
110025,"2022",0,1,0,1
110025,"2023",1,0,2,3
110026,"2016",1,0,0,1
110026,"2017",0,1,0,1
110026,"2018",0,0,1,1
110026,"2019",0,0,1,1
110026,"2020",0,0,2,2
110026,"2021",1,0,1,2
110026,"2023",1,0,0,1
110028,"2015",1,1,4,6
110028,"2016",1,0,4,5
110028,"2017",1,0,4,5
110028,"2018",3,0,4,7
110028,"2019",1,0,3,4
110028,"2020",1,0,3,4
110028,"2021",0,0,3,3
110028,"2022",2,3,4,9
110028,"2023",6,2,13,21
110029,"2015",0,1,1,2
110029,"2017",1,0,0,1
110029,"2018",0,0,1,1
110029,"2019",0,0,1,1
110029,"2020",0,0,2,2
110029,"2022",1,0,1,2
110029,"2023",0,0,2,2
110030,"2015",32,10,84,126
110030,"2016",36,5,70,111
110030,"2017",33,5,57,95
110030,"2018",33,5,68,106
110030,"2019",42,6,71,119
110030,"2020",33,9,55,97
110030,"2021",40,9,64,113
110030,"2022",27,6,39,72
110030,"2023",32,4,44,80
110032,"2015",3,0,7,10
110032,"2016",5,1,12,18
110032,"2017",5,1,17,23
110032,"2018",6,1,14,21
110032,"2019",9,2,22,33
110032,"2020",10,2,13,25
110032,"2021",10,2,17,29
110032,"2022",8,2,10,20
110032,"2023",6,3,9,18
110033,"2015",6,0,32,38
110033,"2016",4,1,12,17
110033,"2017",11,2,18,31
110033,"2018",9,1,9,19
110033,"2019",7,3,20,30
110033,"2020",7,2,16,25
110033,"2021",7,0,14,21
110033,"2022",6,1,24,31
110033,"2023",9,2,11,22
110034,"2015",4,0,5,9
110034,"2016",1,0,3,4
110034,"2017",2,0,4,6
110034,"2018",0,0,5,5
110034,"2019",2,0,2,4
110034,"2020",0,1,6,7
110034,"2021",2,0,3,5
110034,"2022",4,0,3,7
110034,"2023",1,0,2,3
110037,"2015",1,0,0,1
110037,"2018",0,0,2,2
110037,"2022",1,0,0,1
110037,"2023",1,0,1,2
110040,"2015",2,0,2,4
110040,"2016",0,0,2,2
110040,"2017",2,0,1,3
110040,"2018",1,0,5,6
110040,"2019",3,1,7,11
110040,"2020",8,0,3,11
110040,"2021",4,0,4,8
110040,"2022",1,0,0,1
110045,"2015",4,0,8,12
110045,"2016",1,0,8,9
110045,"2017",2,0,7,9
110045,"2018",1,0,2,3
110045,"2019",5,0,6,11
110045,"2020",4,1,7,12
110045,"2021",2,1,6,9
110045,"2022",0,0,2,2
110045,"2023",0,0,4,4
110050,"2015",0,0,1,1
110050,"2016",0,0,1,1
110050,"2018",1,0,0,1
110050,"2021",0,0,1,1
110050,"2022",0,0,1,1
110060,"2015",0,0,1,1
110060,"2016",2,0,1,3
110060,"2017",1,1,1,3
110060,"2018",1,0,2,3
110060,"2019",0,0,1,1
110060,"2020",0,0,2,2
110060,"2021",1,0,0,1
110060,"2022",1,0,1,2
110070,"2015",0,1,0,1
110070,"2016",2,0,2,4
110070,"2017",1,0,1,2
110070,"2019",2,0,1,3
110070,"2022",0,0,4,4
110070,"2023",0,0,2,2
110080,"2015",5,0,4,9
110080,"2016",3,0,7,10
110080,"2017",8,2,5,15
110080,"2018",7,1,1,9
110080,"2019",3,0,8,11
110080,"2020",2,1,7,10
110080,"2021",1,0,2,3
110080,"2022",1,0,2,3
110080,"2023",1,1,2,4
110090,"2016",1,0,1,2
110090,"2021",0,0,1,1
110090,"2022",0,0,1,1
110092,"2015",2,0,3,5
110092,"2016",1,0,2,3
110092,"2017",2,0,5,7
110092,"2018",3,1,2,6
110092,"2019",4,0,3,7
110092,"2020",1,0,4,5
110092,"2021",1,2,4,7
110092,"2022",4,0,4,8
110092,"2023",1,1,4,6
110094,"2015",1,0,3,4
110094,"2016",1,0,5,6
110094,"2017",0,0,11,11
110094,"2018",2,3,7,12
110094,"2019",3,1,2,6
110094,"2020",1,0,10,11
110094,"2021",4,0,8,12
110094,"2022",1,0,5,6
110094,"2023",1,0,4,5
110100,"2015",1,0,6,7
110100,"2016",1,0,4,5
110100,"2017",1,0,5,6
110100,"2018",3,0,3,6
110100,"2020",2,0,3,5
110100,"2021",1,0,1,2
110100,"2023",0,0,1,1
110110,"2015",1,0,3,4
110110,"2016",0,0,3,3
110110,"2017",0,0,2,2
110110,"2019",1,0,1,2
110110,"2020",0,2,2,4
110110,"2021",1,0,0,1
110110,"2022",0,0,1,1
110110,"2023",0,0,3,3
110120,"2015",1,0,3,4
110120,"2016",0,0,1,1
110120,"2017",0,0,3,3
110120,"2018",0,0,6,6
110120,"2019",0,0,2,2
110120,"2020",1,0,2,3
110120,"2022",1,0,0,1
110120,"2023",0,0,2,2
110130,"2015",3,0,4,7
110130,"2016",2,0,4,6
110130,"2017",2,0,4,6
110130,"2018",1,0,1,2
110130,"2019",3,0,4,7
110130,"2020",0,0,6,6
110130,"2023",0,0,1,1
110140,"2015",0,0,3,3
110140,"2016",0,0,3,3
110140,"2017",1,0,2,3
110140,"2018",2,0,2,4
110140,"2019",2,1,3,6
110140,"2020",2,4,5,11
110140,"2021",2,2,1,5
110140,"2022",4,2,0,6
110140,"2023",1,0,1,2
110143,"2015",0,0,1,1
110143,"2016",0,0,3,3
110143,"2017",3,0,3,6
110143,"2018",0,0,1,1
110143,"2019",1,0,1,2
110143,"2021",0,0,1,1
110143,"2023",1,0,0,1
110145,"2015",0,0,1,1
110145,"2017",0,0,1,1
110145,"2018",0,0,1,1
110145,"2019",1,0,0,1
110145,"2020",0,0,1,1
110145,"2021",0,0,1,1
110145,"2022",0,0,1,1
110146,"2015",1,1,1,3
110146,"2016",0,0,2,2
110146,"2019",2,1,1,4
110146,"2021",0,0,1,1
110146,"2023",1,0,0,1
110147,"2015",0,0,1,1
110147,"2016",0,0,1,1
110147,"2017",0,0,3,3
110147,"2018",0,0,1,1
110147,"2019",0,0,1,1
110147,"2020",1,0,0,1
110147,"2021",1,0,0,1
110147,"2023",0,0,1,1
110148,"2015",0,0,4,4
110148,"2016",0,0,1,1
110148,"2018",2,0,1,3
110148,"2019",2,0,1,3
110148,"2020",1,0,2,3
110148,"2021",1,1,1,3
110149,"2015",3,1,6,10
110149,"2016",1,0,3,4
110149,"2017",2,0,5,7
110149,"2018",2,0,8,10
110149,"2019",1,0,4,5
110149,"2020",1,0,4,5
110149,"2021",2,0,3,5
110149,"2022",6,0,7,13
110149,"2023",2,1,2,5
110150,"2015",0,0,3,3
110150,"2016",1,0,0,1
110150,"2017",0,0,1,1
110150,"2018",0,0,2,2
110150,"2019",2,0,2,4
110150,"2020",3,0,5,8
110150,"2021",4,0,5,9
110150,"2022",3,0,6,9
110150,"2023",1,0,2,3
110155,"2015",0,0,1,1
110155,"2016",1,0,1,2
110155,"2018",1,0,0,1
110155,"2019",0,0,1,1
110155,"2020",0,0,1,1
110160,"2015",1,0,6,7
110160,"2016",0,0,3,3
110160,"2017",2,0,3,5
110160,"2018",1,0,3,4
110160,"2019",1,1,4,6
110160,"2020",1,0,2,3
110160,"2022",1,0,0,1
110160,"2023",1,0,0,1
110170,"2015",1,0,2,3
110170,"2016",1,0,3,4
110170,"2017",1,0,3,4
110170,"2018",1,0,2,3
110170,"2019",0,1,2,3
110170,"2020",1,0,4,5
110170,"2022",1,0,0,1
110175,"2015",1,0,2,3
110175,"2016",4,0,2,6
110175,"2017",0,0,1,1
110175,"2018",4,1,6,11
110175,"2019",1,1,8,10
110175,"2020",0,0,3,3
110175,"2021",2,0,4,6
110175,"2023",2,0,1,3
110180,"2015",2,1,1,4
110180,"2016",0,0,1,1
110180,"2017",0,0,1,1
110180,"2018",1,0,0,1
110180,"2020",0,0,1,1
110180,"2021",0,0,1,1
110180,"2022",0,0,1,1
120001,"2015",2,0,7,9
120001,"2016",1,1,4,6
120001,"2017",3,0,4,7
120001,"2018",2,1,6,9
120001,"2019",2,0,4,6
120001,"2020",2,0,5,7
120001,"2021",1,0,1,2
120001,"2022",2,2,3,7
120001,"2023",1,1,3,5
120005,"2015",4,1,7,12
120005,"2016",2,0,5,7
120005,"2017",8,2,9,19
120005,"2018",3,1,7,11
120005,"2019",4,1,10,15
120005,"2020",5,0,7,12
120005,"2021",4,1,11,16
120005,"2022",4,2,16,22
120005,"2023",1,3,3,7
120010,"2015",14,2,56,72
120010,"2016",27,5,63,95
120010,"2017",16,4,57,77
120010,"2018",10,9,42,61
120010,"2019",22,1,57,80
120010,"2020",23,2,50,75
120010,"2021",17,3,46,66
120010,"2022",20,1,43,64
120010,"2023",16,3,26,45
120013,"2015",1,1,1,3
120013,"2016",0,0,1,1
120013,"2017",2,0,3,5
120013,"2018",0,1,4,5
120013,"2019",0,0,5,5
120013,"2020",0,1,4,5
120013,"2021",2,0,4,6
120013,"2022",1,0,0,1
120013,"2023",4,0,2,6
120017,"2015",2,0,0,2
120017,"2016",1,0,2,3
120017,"2017",0,0,5,5
120017,"2018",1,1,5,7
120017,"2019",3,0,0,3
120017,"2020",0,0,5,5
120017,"2021",2,0,8,10
120017,"2022",3,0,10,13
120017,"2023",1,0,4,5
120020,"2015",54,5,107,166
120020,"2016",29,8,81,118
120020,"2017",27,7,71,105
120020,"2018",33,8,60,101
120020,"2019",40,5,60,105
120020,"2020",44,12,60,116
120020,"2021",57,25,79,161
120020,"2022",24,13,60,97
120020,"2023",10,6,13,29
120025,"2015",13,5,35,53
120025,"2016",17,4,31,52
120025,"2017",13,0,40,53
120025,"2018",14,3,33,50
120025,"2019",9,3,37,49
120025,"2020",13,2,19,34
120025,"2021",9,9,34,52
120025,"2022",14,3,28,45
120025,"2023",7,2,15,24
120030,"2015",3,0,6,9
120030,"2016",3,0,0,3
120030,"2017",2,1,7,10
120030,"2018",8,1,7,16
120030,"2019",2,0,10,12
120030,"2020",6,0,10,16
120030,"2021",5,2,16,23
120030,"2022",5,1,5,11
120030,"2023",1,2,18,21
120032,"2015",0,0,3,3
120032,"2016",0,0,3,3
120032,"2017",0,0,1,1
120032,"2018",1,0,3,4
120032,"2019",1,0,2,3
120032,"2020",0,1,3,4
120032,"2021",1,0,2,3
120032,"2022",2,0,1,3
120032,"2023",0,0,1,1
120033,"2015",2,0,7,9
120033,"2016",6,2,13,21
120033,"2017",2,1,10,13
120033,"2018",7,2,13,22
120033,"2019",3,1,11,15
120033,"2020",7,3,16,26
120033,"2021",10,4,10,24
120033,"2022",3,2,11,16
120033,"2023",3,1,3,7
120034,"2015",1,0,0,1
120034,"2016",0,0,4,4
120034,"2017",2,1,0,3
120034,"2018",0,0,1,1
120034,"2019",2,0,1,3
120034,"2020",0,1,0,1
120034,"2021",1,0,1,2
120034,"2023",1,0,2,3
120035,"2015",1,1,2,4
120035,"2016",3,2,5,10
120035,"2017",7,0,2,9
120035,"2018",2,0,7,9
120035,"2019",2,0,10,12
120035,"2020",2,0,14,16
120035,"2021",7,2,7,16
120035,"2022",3,5,13,21
120035,"2023",2,2,4,8
120038,"2015",1,1,9,11
120038,"2016",4,1,2,7
120038,"2017",0,2,6,8
120038,"2018",2,2,5,9
120038,"2019",6,1,6,13
120038,"2020",2,1,1,4
120038,"2021",7,2,11,20
120038,"2022",1,0,7,8
120038,"2023",2,0,8,10
120039,"2015",4,0,5,9
120039,"2016",3,1,9,13
120039,"2017",7,0,3,10
120039,"2018",2,1,1,4
120039,"2019",2,0,2,4
120039,"2020",2,1,7,10
120039,"2021",6,1,6,13
120039,"2022",2,0,6,8
120039,"2023",0,3,5,8
120040,"2015",183,38,428,649
120040,"2016",224,60,400,684
120040,"2017",238,61,401,700
120040,"2018",213,58,335,606
120040,"2019",121,29,144,294
120040,"2020",115,36,198,349
120040,"2021",150,38,227,415
120040,"2022",150,49,222,421
120040,"2023",143,44,199,386
120042,"2015",7,0,8,15
120042,"2016",2,3,5,10
120042,"2017",2,1,8,11
120042,"2018",2,1,4,7
120042,"2019",6,2,10,18
120042,"2020",6,3,11,20
120042,"2021",1,1,12,14
120042,"2022",3,2,4,9
120042,"2023",1,1,4,6
120043,"2015",2,0,0,2
120043,"2016",1,0,3,4
120043,"2017",0,0,2,2
120043,"2018",1,1,1,3
120043,"2021",1,0,2,3
120043,"2022",1,0,2,3
120043,"2023",1,0,3,4
120045,"2015",4,1,4,9
120045,"2016",3,0,3,6
120045,"2017",3,0,14,17
120045,"2018",2,5,5,12
120045,"2019",3,0,3,6
120045,"2020",3,0,10,13
120045,"2021",7,0,11,18
120045,"2022",2,3,5,10
120045,"2023",5,3,7,15
120050,"2015",6,3,35,44
120050,"2016",9,1,21,31
120050,"2017",5,2,14,21
120050,"2018",6,0,10,16
120050,"2019",7,1,9,17
120050,"2020",6,0,23,29
120050,"2021",10,2,25,37
120050,"2022",6,0,5,11
120050,"2023",2,2,10,14
120060,"2015",12,8,34,54
120060,"2016",5,2,28,35
120060,"2017",16,5,43,64
120060,"2018",17,4,49,70
120060,"2019",16,3,42,61
120060,"2020",16,3,41,60
120060,"2021",6,4,9,19
120060,"2022",9,2,25,36
120060,"2023",11,6,26,43
120070,"2015",5,0,4,9
120070,"2016",5,1,7,13
120070,"2017",5,3,9,17
120070,"2018",4,3,13,20
120070,"2019",5,2,14,21
120070,"2020",6,0,12,18
120070,"2021",10,2,19,31
120070,"2022",6,0,19,25
120070,"2023",2,2,13,17
120080,"2015",1,0,1,2
120080,"2016",3,0,5,8
120080,"2017",0,3,9,12
120080,"2018",2,2,8,12
120080,"2019",0,0,2,2
120080,"2020",5,1,1,7
120080,"2021",1,1,10,12
120080,"2022",6,0,9,15
120080,"2023",0,2,10,12
130002,"2015",0,0,6,6
130002,"2016",2,0,9,11
130002,"2017",2,0,11,13
130002,"2018",3,2,14,19
130002,"2019",2,1,9,12
130002,"2020",3,0,13,16
130002,"2021",1,0,3,4
130002,"2022",0,1,6,7
130002,"2023",2,2,4,8
130006,"2017",2,0,2,4
130006,"2019",3,0,7,10
130006,"2020",4,0,8,12
130006,"2022",5,0,6,11
130006,"2023",2,2,5,9
130008,"2015",0,0,5,5
130008,"2017",3,0,3,6
130008,"2018",1,0,1,2
130008,"2019",1,0,0,1
130008,"2020",1,0,1,2
130008,"2021",1,0,2,3
130008,"2022",7,0,6,13
130008,"2023",0,1,8,9
130010,"2018",0,0,1,1
130010,"2019",0,0,2,2
130010,"2021",0,0,2,2
130010,"2022",0,0,4,4
130010,"2023",1,0,0,1
130014,"2015",2,0,5,7
130014,"2016",2,0,7,9
130014,"2017",1,0,4,5
130014,"2018",2,0,3,5
130014,"2019",4,0,7,11
130014,"2020",3,1,6,10
130014,"2021",5,0,6,11
130014,"2022",3,3,8,14
130014,"2023",1,1,2,4
130020,"2015",2,1,8,11
130020,"2016",4,0,9,13
130020,"2017",4,0,8,12
130020,"2018",0,1,0,1
130020,"2019",4,1,7,12
130020,"2020",0,0,2,2
130020,"2021",0,0,2,2
130020,"2022",2,1,0,3
130020,"2023",0,0,2,2
130030,"2015",8,5,30,43
130030,"2016",6,4,20,30
130030,"2017",1,0,11,12
130030,"2018",5,1,19,25
130030,"2019",8,2,23,33
130030,"2020",8,2,28,38
130030,"2021",3,4,29,36
130030,"2022",8,0,25,33
130030,"2023",3,1,8,12
130040,"2015",1,0,0,1
130040,"2016",0,0,2,2
130040,"2017",0,0,3,3
130040,"2018",0,2,7,9
130040,"2019",3,1,8,12
130040,"2020",0,0,1,1
130040,"2021",2,0,7,9
130040,"2022",2,0,3,5
130040,"2023",2,0,6,8
130050,"2015",5,1,12,18
130050,"2016",6,0,10,16
130050,"2017",5,3,15,23
130050,"2018",12,4,27,43
130050,"2019",7,3,22,32
130050,"2020",7,2,23,32
130050,"2021",10,3,31,44
130050,"2022",12,3,18,33
130050,"2023",4,0,17,21
130060,"2015",6,1,19,26
130060,"2016",2,0,3,5
130060,"2017",2,0,6,8
130060,"2018",0,0,5,5
130060,"2019",16,5,41,62
130060,"2020",19,4,32,55
130060,"2021",21,5,43,69
130060,"2022",2,1,6,9
130060,"2023",2,1,5,8
130063,"2015",3,0,9,12
130063,"2016",1,0,6,7
130063,"2017",2,0,8,10
130063,"2018",2,1,6,9
130063,"2019",7,1,9,17
130063,"2020",6,0,16,22
130063,"2021",4,1,16,21
130063,"2022",4,0,11,15
130063,"2023",0,2,9,11
130068,"2018",3,1,7,11
130068,"2019",3,0,10,13
130068,"2020",4,1,9,14
130068,"2021",2,0,15,17
130068,"2022",3,2,9,14
130068,"2023",3,0,7,10
130070,"2015",5,2,24,31
130070,"2016",6,1,16,23
130070,"2017",9,1,29,39
130070,"2018",5,3,25,33
130070,"2019",11,2,19,32
130070,"2020",9,0,22,31
130070,"2021",8,2,36,46
130070,"2022",10,1,30,41
130070,"2023",4,4,27,35
130080,"2015",1,1,17,19
130080,"2016",5,1,19,25
130080,"2017",3,1,14,18
130080,"2018",12,2,25,39
130080,"2019",12,1,27,40
130080,"2020",13,1,26,40
130080,"2021",14,3,30,47
130080,"2022",5,3,37,45
130080,"2023",9,1,12,22
130083,"2015",0,0,3,3
130083,"2016",2,1,10,13
130083,"2017",2,0,1,3
130083,"2019",0,1,1,2
130083,"2020",3,0,12,15
130083,"2021",1,1,9,11
130083,"2022",2,0,2,4
130083,"2023",3,0,3,6
130090,"2015",0,1,1,2
130090,"2016",3,1,1,5
130090,"2017",1,0,8,9
130090,"2018",1,0,8,9
130090,"2019",3,1,6,10
130090,"2020",0,0,5,5
130090,"2021",1,0,8,9
130090,"2022",1,0,9,10
130090,"2023",0,0,1,1
130100,"2015",0,0,3,3
130100,"2016",1,0,1,2
130100,"2017",2,0,4,6
130100,"2018",1,0,5,6
130100,"2019",6,2,25,33
130100,"2020",10,1,15,26
130100,"2021",5,4,14,23
130100,"2022",5,2,10,17
130100,"2023",9,1,8,18
130110,"2015",2,0,6,8
130110,"2016",3,1,8,12
130110,"2017",1,0,0,1
130110,"2019",6,1,7,14
130110,"2020",3,3,9,15
130110,"2021",11,0,15,26
130110,"2022",10,3,21,34
130110,"2023",5,2,7,14
130115,"2015",1,0,0,1
130115,"2016",1,1,1,3
130115,"2017",0,0,1,1
130115,"2018",0,0,1,1
130115,"2020",0,0,1,1
130115,"2022",0,1,1,2
130120,"2015",45,11,120,176
130120,"2016",31,6,94,131
130120,"2017",41,3,85,129
130120,"2018",56,12,139,207
130120,"2019",30,18,88,136
130120,"2020",32,4,76,112
130120,"2021",17,4,61,82
130120,"2022",17,6,41,64
130120,"2023",11,2,25,38
130130,"2015",4,0,8,12
130130,"2016",7,0,11,18
130130,"2017",5,2,15,22
130130,"2018",6,0,17,23
130130,"2019",8,2,22,32
130130,"2020",6,1,17,24
130130,"2021",10,2,19,31
130130,"2022",7,3,17,27
130130,"2023",4,1,10,15
130140,"2015",2,0,4,6
130140,"2016",1,0,2,3
130140,"2017",2,0,9,11
130140,"2018",3,0,12,15
130140,"2019",5,0,21,26
130140,"2020",1,1,10,12
130140,"2021",3,1,21,25
130140,"2022",1,1,7,9
130140,"2023",3,1,8,12
130150,"2015",0,0,3,3
130150,"2016",2,0,7,9
130150,"2017",5,1,5,11
130150,"2018",1,2,2,5
130150,"2019",1,0,1,2
130150,"2020",0,0,1,1
130150,"2021",1,0,3,4
130150,"2022",2,0,3,5
130150,"2023",0,1,4,5
130160,"2016",0,0,2,2
130160,"2017",0,0,1,1
130160,"2019",1,0,0,1
130160,"2020",0,0,1,1
130160,"2021",2,0,3,5
130160,"2022",2,0,9,11
130160,"2023",0,0,2,2
130165,"2015",3,1,5,9
130165,"2016",2,1,7,10
130165,"2017",2,0,3,5
130165,"2018",7,0,5,12
130165,"2019",2,0,9,11
130165,"2020",2,0,7,9
130165,"2021",1,0,14,15
130165,"2022",3,1,10,14
130165,"2023",2,0,3,5
130170,"2015",4,3,19,26
130170,"2016",11,0,33,44
130170,"2017",13,1,36,50
130170,"2018",12,0,31,43
130170,"2019",9,3,31,43
130170,"2020",6,1,31,38
130170,"2021",11,3,29,43
130170,"2022",6,2,18,26
130170,"2023",5,3,7,15
130180,"2015",4,1,15,20
130180,"2016",4,1,14,19
130180,"2017",5,1,10,16
130180,"2018",1,0,5,6
130180,"2019",3,1,10,14
130180,"2020",4,1,12,17
130180,"2021",9,1,6,16
130180,"2022",2,1,20,23
130180,"2023",15,3,20,38
130185,"2015",1,0,2,3
130185,"2016",2,1,0,3
130185,"2017",1,0,5,6
130185,"2019",1,0,5,6
130185,"2020",1,0,7,8
130185,"2021",5,2,6,13
130185,"2022",3,2,13,18
130185,"2023",0,0,5,5
130190,"2015",54,9,138,201
130190,"2016",42,13,108,163
130190,"2017",40,5,104,149
130190,"2018",65,13,109,187
130190,"2019",55,10,113,178
130190,"2020",45,13,86,144
130190,"2021",52,14,117,183
130190,"2022",66,22,127,215
130190,"2023",34,15,71,120
130195,"2015",3,0,5,8
130195,"2016",0,0,2,2
130195,"2017",0,0,1,1
130195,"2018",0,0,1,1
130195,"2021",0,0,2,2
130195,"2023",0,0,2,2
130200,"2017",0,0,4,4
130200,"2018",2,0,2,4
130200,"2019",2,1,1,4
130200,"2020",0,0,5,5
130200,"2021",1,0,3,4
130200,"2022",5,1,8,14
130200,"2023",3,0,3,6
130210,"2015",0,0,2,2
130210,"2016",1,1,2,4
130210,"2018",1,0,1,2
130210,"2019",1,0,3,4
130210,"2020",1,0,2,3
130210,"2021",4,0,9,13
130210,"2022",2,1,5,8
130220,"2015",0,0,3,3
130220,"2016",1,2,6,9
130220,"2017",7,0,11,18
130220,"2018",1,0,5,6
130220,"2020",3,0,4,7
130220,"2021",2,0,5,7
130220,"2022",0,0,4,4
130230,"2015",3,0,12,15
130230,"2016",0,1,17,18
130230,"2017",6,0,12,18
130230,"2018",6,0,3,9
130230,"2019",4,3,13,20
130230,"2020",7,8,5,20
130230,"2021",5,4,17,26
130230,"2022",7,5,12,24
130230,"2023",2,2,6,10
130240,"2015",0,0,3,3
130240,"2016",0,0,1,1
130240,"2018",5,1,10,16
130240,"2019",8,3,13,24
130240,"2020",6,2,20,28
130240,"2021",6,1,26,33
130240,"2022",10,5,28,43
130240,"2023",8,3,22,33
130250,"2015",1,0,9,10
130250,"2016",0,0,11,11
130250,"2017",3,2,7,12
130250,"2018",1,0,8,9
130250,"2019",5,0,10,15
130250,"2020",4,2,4,10
130250,"2021",11,1,29,41
130250,"2022",4,1,20,25
130250,"2023",1,0,8,9
130255,"2015",2,2,2,6
130255,"2016",1,0,2,3
130255,"2017",2,0,1,3
130255,"2018",0,0,2,2
130255,"2019",1,0,1,2
130255,"2020",1,1,3,5
130255,"2022",0,0,2,2
130255,"2023",0,0,2,2
130260,"2015",398,100,900,1398
130260,"2016",651,129,1271,2051
130260,"2017",711,172,1704,2587
130260,"2018",768,192,1583,2543
130260,"2019",672,149,1271,2092
130260,"2020",578,153,1116,1847
130260,"2021",501,124,922,1547
130260,"2022",459,135,856,1450
130260,"2023",301,82,590,973
130270,"2015",8,2,28,38
130270,"2016",6,1,25,32
130270,"2017",5,4,19,28
130270,"2018",13,3,38,54
130270,"2019",14,3,41,58
130270,"2020",9,1,29,39
130270,"2021",5,0,8,13
130270,"2022",1,0,5,6
130270,"2023",1,0,9,10
130280,"2015",1,0,5,6
130280,"2016",2,0,3,5
130280,"2017",2,0,4,6
130280,"2018",3,0,8,11
130280,"2019",1,0,2,3
130280,"2020",1,1,6,8
130280,"2021",2,2,7,11
130280,"2022",0,0,4,4
130280,"2023",1,1,8,10
130290,"2015",21,1,49,71
130290,"2016",11,4,77,92
130290,"2017",12,2,28,42
130290,"2018",20,10,41,71
130290,"2019",24,3,41,68
130290,"2020",26,7,56,89
130290,"2021",16,2,54,72
130290,"2022",10,5,45,60
130290,"2023",10,3,22,35
130300,"2015",6,0,8,14
130300,"2016",4,1,15,20
130300,"2017",2,2,7,11
130300,"2018",3,1,14,18
130300,"2019",5,2,16,23
130300,"2020",2,2,10,14
130300,"2021",3,0,15,18
130300,"2022",3,2,6,11
130300,"2023",1,0,0,1
130310,"2015",1,0,2,3
130310,"2016",0,0,1,1
130310,"2018",5,0,9,14
130310,"2019",6,0,20,26
130310,"2020",10,0,11,21
130310,"2021",13,1,19,33
130310,"2022",15,2,25,42
130310,"2023",9,3,19,31
130320,"2015",0,0,1,1
130320,"2017",2,0,3,5
130320,"2018",2,0,5,7
130320,"2020",3,3,7,13
130320,"2021",0,0,4,4
130320,"2022",1,0,4,5
130320,"2023",0,0,1,1
130330,"2015",1,0,1,2
130330,"2016",0,0,1,1
130330,"2017",0,0,1,1
130330,"2019",0,0,1,1
130330,"2022",1,0,2,3
130340,"2015",42,8,107,157
130340,"2016",35,11,111,157
130340,"2017",45,12,101,158
130340,"2018",50,22,112,184
130340,"2019",43,17,88,148
130340,"2020",44,10,134,188
130340,"2021",47,15,122,184
130340,"2022",36,9,86,131
130340,"2023",23,3,46,72
130350,"2015",1,1,7,9
130350,"2016",1,0,5,6
130350,"2020",0,1,0,1
130350,"2021",0,1,8,9
130350,"2022",0,1,4,5
130350,"2023",2,0,4,6
130353,"2015",1,1,6,8
130353,"2016",1,0,4,5
130353,"2017",1,0,2,3
130353,"2018",2,0,8,10
130353,"2019",3,0,7,10
130353,"2020",2,0,6,8
130353,"2021",5,1,10,16
130353,"2022",9,0,15,24
130353,"2023",2,0,7,9
130356,"2015",1,0,2,3
130356,"2016",1,0,2,3
130356,"2017",0,0,1,1
130356,"2018",1,0,0,1
130356,"2019",1,0,1,2
130356,"2020",0,0,4,4
130356,"2021",0,0,2,2
130356,"2022",0,0,1,1
130356,"2023",1,0,0,1
130360,"2015",1,0,0,1
130360,"2017",1,1,1,3
130360,"2018",1,2,7,10
130360,"2019",5,2,6,13
130360,"2020",6,0,2,8
130360,"2021",2,0,1,3
130360,"2022",4,1,2,7
130360,"2023",0,0,1,1
130370,"2015",2,1,13,16
130370,"2016",2,0,22,24
130370,"2017",7,4,21,32
130370,"2018",4,1,16,21
130370,"2019",4,2,14,20
130370,"2020",7,0,19,26
130370,"2021",12,0,23,35
130370,"2022",16,4,21,41
130370,"2023",7,1,11,19
130380,"2015",1,0,0,1
130380,"2016",3,1,11,15
130380,"2017",18,4,36,58
130380,"2018",2,1,20,23
130380,"2019",3,0,5,8
130380,"2020",5,2,15,22
130380,"2021",8,6,25,39
130380,"2022",16,1,19,36
130380,"2023",4,2,7,13
130390,"2015",9,4,18,31
130390,"2016",3,0,16,19
130390,"2017",10,0,11,21
130390,"2018",11,1,17,29
130390,"2019",17,3,23,43
130390,"2020",13,3,28,44
130390,"2021",7,2,22,31
130390,"2022",9,2,25,36
130390,"2023",11,2,25,38
130395,"2015",0,0,4,4
130395,"2016",1,0,0,1
130395,"2017",1,0,5,6
130395,"2018",0,0,3,3
130395,"2019",4,0,8,12
130395,"2020",2,1,6,9
130395,"2021",4,1,11,16
130395,"2022",1,1,4,6
130395,"2023",2,1,4,7
130400,"2015",4,0,5,9
130400,"2016",1,0,2,3
130400,"2017",2,0,1,3
130400,"2019",1,0,3,4
130400,"2020",1,1,7,9
130400,"2021",5,1,6,12
130400,"2022",1,2,3,6
130400,"2023",1,2,2,5
130406,"2015",47,8,90,145
130406,"2016",17,1,37,55
130406,"2017",4,1,11,16
130406,"2018",9,4,23,36
130406,"2019",21,4,56,81
130406,"2020",25,6,52,83
130406,"2021",24,10,31,65
130406,"2022",16,5,40,61
130406,"2023",3,0,9,12
130410,"2015",1,0,8,9
130410,"2016",1,0,0,1
130410,"2017",0,0,2,2
130410,"2020",1,0,6,7
130410,"2021",2,0,17,19
130410,"2022",2,0,11,13
130410,"2023",2,2,10,14
130420,"2015",38,8,104,150
130420,"2016",30,7,110,147
130420,"2017",37,8,99,144
130420,"2018",52,10,117,179
130420,"2019",54,13,127,194
130420,"2020",31,7,105,143
130420,"2021",24,10,89,123
130420,"2022",22,8,68,98
130420,"2023",26,8,50,84
130423,"2019",3,2,3,8
130423,"2020",5,4,10,19
130423,"2021",9,0,27,36
130423,"2022",7,1,20,28
130423,"2023",6,2,8,16
130426,"2015",0,0,1,1
130426,"2016",0,0,1,1
130426,"2017",1,0,8,9
130426,"2018",2,0,9,11
130426,"2019",4,1,7,12
130426,"2020",2,1,10,13
130426,"2021",6,0,9,15
130426,"2022",2,2,8,12
130426,"2023",2,0,19,21
130430,"2015",1,0,1,2
130430,"2018",2,2,3,7
130430,"2019",1,0,9,10
130430,"2020",3,1,4,8
130430,"2021",5,1,17,23
130430,"2022",3,2,6,11
130430,"2023",0,4,3,7
130440,"2019",2,0,1,3
130440,"2020",1,0,2,3
130440,"2021",2,1,8,11
130440,"2022",2,3,7,12
130440,"2023",0,0,5,5
140002,"2015",5,2,10,17
140002,"2016",0,2,18,20
140002,"2017",3,0,9,12
140002,"2018",4,2,16,22
140002,"2019",2,3,4,9
140002,"2020",0,1,11,12
140002,"2021",6,1,7,14
140002,"2022",0,0,6,6
140002,"2023",5,1,3,9
140005,"2015",11,0,12,23
140005,"2016",3,3,12,18
140005,"2017",6,2,14,22
140005,"2018",8,2,9,19
140005,"2019",3,0,12,15
140005,"2020",3,3,6,12
140005,"2021",4,1,11,16
140005,"2022",6,3,15,24
140005,"2023",1,1,2,4
140010,"2015",221,41,486,748
140010,"2016",209,38,461,708
140010,"2017",250,36,439,725
140010,"2018",261,51,457,769
140010,"2019",224,44,440,708
140010,"2020",189,51,340,580
140010,"2021",180,52,337,569
140010,"2022",169,40,344,553
140010,"2023",115,32,219,366
140015,"2015",7,1,7,15
140015,"2016",6,1,20,27
140015,"2017",7,2,8,17
140015,"2018",3,0,10,13
140015,"2019",9,2,7,18
140015,"2020",1,0,10,11
140015,"2021",5,2,6,13
140015,"2022",2,1,13,16
140015,"2023",2,0,4,6
140017,"2015",7,1,13,21
140017,"2016",6,1,11,18
140017,"2017",10,1,15,26
140017,"2018",6,4,9,19
140017,"2019",5,0,10,15
140017,"2020",6,3,15,24
140017,"2021",9,1,5,15
140017,"2022",4,0,8,12
140017,"2023",6,4,7,17
140020,"2015",6,0,13,19
140020,"2016",6,0,5,11
140020,"2017",3,0,13,16
140020,"2018",11,1,21,33
140020,"2019",9,4,13,26
140020,"2020",6,0,17,23
140020,"2021",5,0,9,14
140020,"2022",2,1,15,18
140020,"2023",3,0,4,7
140023,"2015",2,0,3,5
140023,"2016",4,0,3,7
140023,"2017",1,0,3,4
140023,"2018",4,2,6,12
140023,"2019",2,0,6,8
140023,"2020",5,2,4,11
140023,"2021",2,1,8,11
140023,"2022",2,0,6,8
140023,"2023",4,0,2,6
140028,"2015",1,0,4,5
140028,"2016",2,1,5,8
140028,"2017",5,1,8,14
140028,"2018",1,0,5,6
140028,"2019",2,2,7,11
140028,"2020",2,0,2,4
140028,"2021",3,0,6,9
140028,"2022",4,1,6,11
140028,"2023",2,0,5,7
140030,"2015",7,1,11,19
140030,"2016",3,0,22,25
140030,"2017",3,1,19,23
140030,"2018",8,1,8,17
140030,"2019",5,0,13,18
140030,"2020",1,2,14,17
140030,"2021",6,2,5,13
140030,"2022",5,0,13,18
140030,"2023",8,0,7,15
140040,"2015",1,0,10,11
140040,"2016",7,0,6,13
140040,"2017",10,5,12,27
140040,"2018",6,1,9,16
140040,"2019",7,0,10,17
140040,"2020",6,1,9,16
140040,"2021",6,1,10,17
140040,"2022",7,1,9,17
140040,"2023",3,0,4,7
140045,"2015",3,2,20,25
140045,"2016",17,3,42,62
140045,"2017",11,2,36,49
140045,"2018",10,4,31,45
140045,"2019",15,1,30,46
140045,"2020",6,5,16,27
140045,"2021",8,3,11,22
140045,"2022",10,3,13,26
140045,"2023",3,1,9,13
140047,"2015",2,0,13,15
140047,"2016",7,0,16,23
140047,"2017",9,2,32,43
140047,"2018",19,1,28,48
140047,"2019",14,5,44,63
140047,"2020",15,2,30,47
140047,"2021",9,5,33,47
140047,"2022",9,2,32,43
140047,"2023",9,0,16,25
140050,"2015",0,0,1,1
140050,"2016",0,0,2,2
140050,"2017",3,1,5,9
140050,"2018",2,0,6,8
140050,"2019",3,0,10,13
140050,"2020",3,0,9,12
140050,"2021",6,0,8,14
140050,"2022",2,0,6,8
140050,"2023",1,0,3,4
140060,"2015",0,0,5,5
140060,"2016",1,0,2,3
140060,"2017",2,0,4,6
140060,"2018",1,0,8,9
140060,"2019",1,1,6,8
140060,"2020",0,2,2,4
140060,"2021",1,0,1,2
140060,"2022",4,1,5,10
140060,"2023",1,1,0,2
140070,"2015",9,2,13,24
140070,"2016",6,2,19,27
140070,"2017",5,4,11,20
140070,"2018",5,1,14,20
140070,"2019",9,1,14,24
140070,"2020",6,0,16,22
140070,"2021",4,1,14,19
140070,"2022",2,1,10,13
140070,"2023",2,1,5,8
150010,"2015",30,6,132,168
150010,"2016",40,6,124,170
150010,"2017",23,2,104,129
150010,"2018",37,3,87,127
150010,"2019",33,6,85,124
150010,"2020",13,2,57,72
150010,"2021",28,5,57,90
150010,"2022",10,7,51,68
150010,"2023",25,1,41,67
150013,"2015",0,1,11,12
150013,"2016",3,0,11,14
150013,"2017",1,0,3,4
150013,"2018",3,1,2,6
150013,"2020",1,0,2,3
150013,"2021",2,0,6,8
150013,"2022",1,2,3,6
150013,"2023",2,0,3,5
150020,"2015",9,5,32,46
150020,"2016",8,1,33,42
150020,"2017",8,2,31,41
150020,"2018",7,2,29,38
150020,"2019",4,2,34,40
150020,"2020",6,1,21,28
150020,"2021",10,0,29,39
150020,"2022",1,2,23,26
150020,"2023",4,2,16,22
150030,"2015",10,2,34,46
150030,"2016",17,3,24,44
150030,"2017",14,1,22,37
150030,"2018",10,3,35,48
150030,"2019",5,4,21,30
150030,"2020",6,1,32,39
150030,"2021",5,0,17,22
150030,"2022",11,2,15,28
150030,"2023",7,0,9,16
150034,"2015",0,0,2,2
150034,"2016",0,0,3,3
150034,"2017",0,0,1,1
150034,"2018",0,0,2,2
150034,"2019",2,0,2,4
150034,"2020",2,1,11,14
150034,"2021",1,0,11,12
150034,"2022",1,1,15,17
150034,"2023",4,0,4,8
150040,"2015",6,1,15,22
150040,"2016",1,0,3,4
150040,"2017",0,0,2,2
150040,"2018",5,2,8,15
150040,"2019",0,0,6,6
150040,"2020",2,1,2,5
150040,"2021",1,0,7,8
150040,"2022",1,0,7,8
150040,"2023",0,0,2,2
150050,"2015",6,1,7,14
150050,"2016",4,0,14,18
150050,"2017",1,0,16,17
150050,"2018",4,2,6,12
150050,"2019",1,0,17,18
150050,"2020",1,1,15,17
150050,"2021",0,0,3,3
150050,"2022",4,1,10,15
150050,"2023",0,0,7,7
150060,"2015",43,6,158,207
150060,"2016",44,8,99,151
150060,"2017",56,9,132,197
150060,"2018",51,5,109,165
150060,"2019",48,7,121,176
150060,"2020",41,7,121,169
150060,"2021",54,15,119,188
150060,"2022",63,8,146,217
150060,"2023",47,13,118,178
150070,"2015",5,1,15,21
150070,"2016",5,0,17,22
150070,"2017",4,0,19,23
150070,"2018",8,1,14,23
150070,"2019",4,3,18,25
150070,"2020",6,0,12,18
150070,"2021",5,3,11,19
150070,"2022",8,0,25,33
150070,"2023",8,1,12,21
150080,"2015",107,26,299,432
150080,"2016",101,14,232,347
150080,"2017",85,26,274,385
150080,"2018",94,21,248,363
150080,"2019",62,15,207,284
150080,"2020",84,13,200,297
150080,"2021",90,23,187,300
150080,"2022",115,28,216,359
150080,"2023",70,11,159,240
150085,"2015",11,2,24,37
150085,"2016",4,1,22,27
150085,"2017",15,1,47,63
150085,"2018",5,0,39,44
150085,"2019",14,2,35,51
150085,"2020",19,3,38,60
150085,"2021",8,2,37,47
150085,"2022",12,5,51,68
150085,"2023",4,1,21,26
150090,"2015",6,0,9,15
150090,"2016",5,0,9,14
150090,"2017",4,0,8,12
150090,"2018",3,2,14,19
150090,"2019",5,0,12,17
150090,"2020",4,1,13,18
150090,"2021",3,0,13,16
150090,"2022",5,2,9,16
150090,"2023",4,3,8,15
150095,"2015",3,1,15,19
150095,"2016",3,1,11,15
150095,"2017",2,1,16,19
150095,"2018",7,3,13,23
150095,"2019",7,0,19,26
150095,"2020",1,2,9,12
150095,"2021",3,0,15,18
150095,"2022",4,0,9,13
150095,"2023",5,0,9,14
150100,"2015",0,0,4,4
150100,"2016",0,1,2,3
150100,"2017",0,0,1,1
150100,"2018",2,1,6,9
150100,"2019",1,0,4,5
150100,"2020",0,0,1,1
150100,"2021",0,0,2,2
150100,"2022",0,0,3,3
150100,"2023",0,0,1,1
150110,"2015",1,0,2,3
150110,"2016",1,0,4,5
150110,"2017",2,3,7,12
150110,"2018",5,2,10,17
150110,"2019",4,2,9,15
150110,"2020",0,2,8,10
150110,"2021",0,1,8,9
150110,"2022",2,0,5,7
150110,"2023",3,0,8,11
150120,"2015",6,1,27,34
150120,"2016",6,0,17,23
150120,"2017",3,1,16,20
150120,"2018",4,1,11,16
150120,"2019",0,0,2,2
150120,"2020",0,0,3,3
150120,"2021",2,0,6,8
150120,"2022",4,2,9,15
150120,"2023",4,0,12,16
150125,"2017",0,0,1,1
150125,"2019",0,1,2,3
150125,"2020",0,0,1,1
150125,"2022",0,0,1,1
150130,"2015",4,2,27,33
150130,"2016",3,0,22,25
150130,"2017",5,1,21,27
150130,"2018",5,2,12,19
150130,"2019",10,3,16,29
150130,"2020",19,2,30,51
150130,"2021",13,3,45,61
150130,"2022",27,8,38,73
150130,"2023",16,7,29,52
150140,"2015",339,57,866,1262
150140,"2016",298,62,727,1087
150140,"2017",372,62,856,1290
150140,"2018",332,69,786,1187
150140,"2019",246,48,586,880
150140,"2020",275,61,614,950
150140,"2021",312,85,648,1045
150140,"2022",265,62,616,943
150140,"2023",187,41,428,656
150145,"2015",1,1,8,10
150145,"2016",3,0,3,6
150145,"2017",4,0,2,6
150145,"2018",1,0,3,4
150145,"2019",0,0,6,6
150145,"2020",2,0,2,4
150145,"2021",1,0,3,4
150145,"2022",3,1,3,7
150145,"2023",1,0,0,1
150150,"2015",12,0,38,50
150150,"2016",10,3,29,42
150150,"2017",11,3,31,45
150150,"2018",11,3,28,42
150150,"2019",9,1,37,47
150150,"2020",7,2,33,42
150150,"2021",13,2,33,48
150150,"2022",17,4,27,48
150150,"2023",6,3,19,28
150157,"2015",1,0,6,7
150157,"2016",2,0,7,9
150157,"2017",1,1,5,7
150157,"2018",0,0,5,5
150157,"2019",0,0,9,9
150157,"2020",0,0,5,5
150157,"2021",3,0,9,12
150157,"2022",7,0,3,10
150157,"2023",3,0,6,9
150160,"2016",0,0,1,1
150160,"2017",0,0,1,1
150160,"2018",1,0,5,6
150160,"2019",5,1,5,11
150160,"2020",3,0,7,10
150160,"2021",2,0,9,11
150160,"2022",2,0,7,9
150160,"2023",1,0,3,4
150170,"2015",21,3,47,71
150170,"2016",20,4,51,75
150170,"2017",17,4,43,64
150170,"2018",12,3,56,71
150170,"2019",14,1,53,68
150170,"2020",24,8,60,92
150170,"2021",28,4,47,79
150170,"2022",25,8,70,103
150170,"2023",18,2,41,61
150172,"2015",1,0,9,10
150172,"2016",3,0,11,14
150172,"2017",4,2,25,31
150172,"2018",5,0,20,25
150172,"2019",12,0,16,28
150172,"2020",10,0,13,23
150172,"2021",10,2,19,31
150172,"2022",4,2,14,20
150172,"2023",0,2,19,21
150175,"2015",1,0,2,3
150175,"2016",2,0,0,2
150175,"2017",1,0,3,4
150175,"2018",1,0,1,2
150175,"2019",0,0,2,2
150175,"2020",0,1,2,3
150175,"2021",1,0,4,5
150175,"2022",0,1,1,2
150175,"2023",1,0,0,1
150178,"2015",3,2,27,32
150178,"2016",4,0,18,22
150178,"2017",4,1,20,25
150178,"2018",10,0,27,37
150178,"2019",10,0,19,29
150178,"2020",5,0,13,18
150178,"2021",5,1,11,17
150178,"2022",3,1,11,15
150178,"2023",5,2,12,19
150180,"2015",30,12,86,128
150180,"2016",35,6,90,131
150180,"2017",40,9,113,162
150180,"2018",48,8,86,142
150180,"2019",49,13,92,154
150180,"2020",44,16,97,157
150180,"2021",38,19,82,139
150180,"2022",46,20,86,152
150180,"2023",34,21,79,134
150190,"2015",0,2,14,16
150190,"2016",2,0,7,9
150190,"2017",1,0,13,14
150190,"2018",3,0,8,11
150190,"2019",3,1,11,15
150190,"2020",2,0,7,9
150190,"2021",2,0,16,18
150190,"2022",5,0,9,14
150190,"2023",2,2,12,16
150195,"2015",0,0,4,4
150195,"2016",0,0,3,3
150195,"2017",1,0,3,4
150195,"2018",0,2,9,11
150195,"2019",3,0,7,10
150195,"2020",2,0,9,11
150195,"2021",1,0,11,12
150195,"2022",2,0,3,5
150195,"2023",0,0,3,3
150200,"2015",2,0,7,9
150200,"2016",2,1,7,10
150200,"2017",4,1,4,9
150200,"2018",5,1,5,11
150200,"2019",0,1,6,7
150200,"2020",1,0,5,6
150200,"2021",3,0,7,10
150200,"2022",0,0,6,6
150200,"2023",1,0,3,4
150210,"2015",33,13,128,174
150210,"2016",45,12,125,182
150210,"2017",45,15,145,205
150210,"2018",43,13,130,186
150210,"2019",40,9,120,169
150210,"2020",24,7,81,112
150210,"2021",37,10,93,140
150210,"2022",36,7,84,127
150210,"2023",16,5,72,93
150215,"2015",7,1,38,46
150215,"2016",9,0,22,31
150215,"2017",4,0,24,28
150215,"2018",5,2,20,27
150215,"2019",6,1,20,27
150215,"2020",6,1,19,26
150215,"2021",4,0,9,13
150215,"2022",4,1,3,8
150215,"2023",2,0,7,9
150220,"2015",3,0,7,10
150220,"2016",4,0,4,8
150220,"2017",9,4,13,26
150220,"2018",14,0,22,36
150220,"2019",12,1,46,59
150220,"2020",14,6,42,62
150220,"2021",21,2,29,52
150220,"2022",13,2,27,42
150220,"2023",8,0,10,18
150230,"2015",3,1,11,15
150230,"2016",3,1,16,20
150230,"2017",2,0,4,6
150230,"2018",2,0,4,6
150230,"2019",3,0,10,13
150230,"2020",4,0,9,13
150230,"2021",1,1,11,13
150230,"2022",1,0,6,7
150230,"2023",4,0,5,9
150240,"2015",43,6,96,145
150240,"2016",47,7,93,147
150240,"2017",48,10,107,165
150240,"2018",37,13,102,152
150240,"2019",53,9,94,156
150240,"2020",40,6,101,147
150240,"2021",69,22,109,200
150240,"2022",38,11,90,139
150240,"2023",47,15,79,141
150250,"2015",1,1,3,5
150250,"2016",2,0,3,5
150250,"2017",1,1,3,5
150250,"2018",2,1,4,7
150250,"2019",2,0,7,9
150250,"2020",1,0,6,7
150250,"2021",0,0,4,4
150250,"2022",0,0,3,3
150250,"2023",0,0,3,3
150260,"2015",0,0,2,2
150260,"2016",5,0,4,9
150260,"2017",2,1,4,7
150260,"2018",4,1,3,8
150260,"2019",1,0,5,6
150260,"2020",3,1,5,9
150260,"2021",0,0,7,7
150260,"2022",2,0,0,2
150260,"2023",5,0,2,7
150270,"2015",2,0,2,4
150270,"2016",1,0,4,5
150270,"2017",1,0,1,2
150270,"2018",1,0,2,3
150270,"2019",2,0,9,11
150270,"2020",3,0,2,5
150270,"2023",0,0,1,1
150275,"2015",1,2,14,17
150275,"2016",1,0,11,12
150275,"2017",5,0,15,20
150275,"2018",5,1,12,18
150275,"2019",9,0,11,20
150275,"2020",7,2,10,19
150275,"2021",4,0,7,11
150275,"2022",0,1,9,10
150275,"2023",4,0,8,12
150276,"2015",0,0,2,2
150276,"2016",0,0,1,1
150276,"2017",0,0,2,2
150276,"2020",0,0,2,2
150276,"2021",0,0,1,1
150276,"2022",0,0,1,1
150276,"2023",0,0,1,1
150277,"2015",3,0,26,29
150277,"2016",11,0,19,30
150277,"2017",4,1,10,15
150277,"2018",1,0,7,8
150277,"2019",5,0,9,14
150277,"2020",2,0,8,10
150277,"2021",3,0,9,12
150277,"2022",9,1,13,23
150277,"2023",5,0,6,11
150280,"2015",0,2,13,15
150280,"2016",4,0,16,20
150280,"2017",6,1,7,14
150280,"2018",5,1,9,15
150280,"2019",5,2,27,34
150280,"2020",7,0,19,26
150280,"2021",8,1,22,31
150280,"2022",7,4,23,34
150280,"2023",4,2,30,36
150285,"2015",2,0,0,2
150285,"2017",0,0,1,1
150285,"2018",1,0,1,2
150285,"2021",0,1,0,1
150285,"2022",0,0,2,2
150290,"2015",3,0,7,10
150290,"2016",3,1,11,15
150290,"2017",5,0,17,22
150290,"2018",4,0,15,19
150290,"2019",3,3,16,22
150290,"2020",8,1,11,20
150290,"2021",10,0,10,20
150290,"2022",8,1,18,27
150290,"2023",4,4,7,15
150293,"2015",3,0,27,30
150293,"2016",3,1,12,16
150293,"2017",5,3,23,31
150293,"2018",7,2,23,32
150293,"2019",8,0,15,23
150293,"2020",7,3,14,24
150293,"2021",2,0,16,18
150293,"2022",6,4,24,34
150293,"2023",6,1,20,27
150295,"2015",6,2,28,36
150295,"2016",4,1,14,19
150295,"2017",6,2,17,25
150295,"2018",12,0,22,34
150295,"2019",2,0,19,21
150295,"2020",6,0,10,16
150295,"2021",3,1,8,12
150295,"2022",5,0,9,14
150295,"2023",0,0,1,1
150300,"2015",0,0,4,4
150300,"2016",0,0,4,4
150300,"2017",2,0,7,9
150300,"2018",2,0,6,8
150300,"2019",3,0,3,6
150300,"2020",1,0,3,4
150300,"2021",0,0,3,3
150300,"2022",0,1,5,6
150300,"2023",1,0,1,2
150304,"2015",1,0,2,3
150304,"2016",0,0,1,1
150304,"2018",0,0,1,1
150304,"2019",0,0,1,1
150304,"2020",2,0,2,4
150304,"2021",0,0,5,5
150304,"2022",1,0,2,3
150307,"2015",1,0,7,8
150307,"2016",2,1,12,15
150307,"2017",2,0,5,7
150307,"2018",4,0,9,13
150307,"2019",4,1,9,14
150307,"2020",1,0,10,11
150307,"2021",4,1,4,9
150307,"2022",4,0,10,14
150307,"2023",2,2,9,13
150309,"2015",3,0,17,20
150309,"2016",3,0,13,16
150309,"2017",2,0,5,7
150309,"2018",4,0,3,7
150309,"2019",1,0,12,13
150309,"2020",2,1,3,6
150309,"2021",4,3,8,15
150309,"2022",0,0,8,8
150309,"2023",2,1,4,7
150310,"2015",11,1,15,27
150310,"2016",8,3,12,23
150310,"2017",7,4,18,29
150310,"2018",5,2,25,32
150310,"2019",9,1,16,26
150310,"2020",9,3,25,37
150310,"2021",13,1,20,34
150310,"2022",8,2,25,35
150310,"2023",5,1,19,25
150320,"2015",1,2,17,20
150320,"2016",1,0,16,17
150320,"2017",8,0,19,27
150320,"2018",10,3,19,32
150320,"2019",8,1,13,22
150320,"2020",4,1,12,17
150320,"2021",7,2,16,25
150320,"2022",8,2,13,23
150320,"2023",5,1,6,12
150330,"2015",4,1,41,46
150330,"2016",12,5,33,50
150330,"2017",14,3,50,67
150330,"2018",14,3,37,54
150330,"2019",13,2,30,45
150330,"2020",15,0,32,47
150330,"2021",13,1,34,48
150330,"2022",17,2,42,61
150330,"2023",9,0,23,32
150340,"2015",1,0,8,9
150340,"2016",0,0,7,7
150340,"2017",4,0,2,6
150340,"2018",1,1,7,9
150340,"2019",6,0,1,7
150340,"2020",2,0,3,5
150340,"2021",5,0,6,11
150340,"2022",3,2,5,10
150340,"2023",5,0,6,11
150345,"2015",3,1,9,13
150345,"2016",2,2,14,18
150345,"2017",5,0,8,13
150345,"2018",5,0,26,31
150345,"2019",10,0,15,25
150345,"2020",8,3,23,34
150345,"2021",12,1,23,36
150345,"2022",6,1,22,29
150345,"2023",6,0,11,17
150350,"2015",3,2,10,15
150350,"2016",3,0,10,13
150350,"2017",2,0,7,9
150350,"2018",6,3,6,15
150350,"2019",2,1,9,12
150350,"2020",1,0,12,13
150350,"2021",3,1,7,11
150350,"2022",3,0,5,8
150350,"2023",4,1,5,10
150360,"2015",20,4,98,122
150360,"2016",21,3,113,137
150360,"2017",33,9,149,191
150360,"2018",19,3,105,127
150360,"2019",20,1,34,55
150360,"2020",2,0,14,16
150360,"2021",10,1,10,21
150360,"2022",2,2,16,20
150360,"2023",7,3,28,38
150370,"2015",6,0,30,36
150370,"2016",4,1,21,26
150370,"2017",14,3,39,56
150370,"2018",12,4,29,45
150370,"2019",11,4,27,42
150370,"2020",4,0,28,32
150370,"2021",6,3,26,35
150370,"2022",7,0,22,29
150370,"2023",9,3,14,26
150375,"2017",2,0,0,2
150375,"2018",0,0,4,4
150375,"2019",1,0,1,2
150375,"2020",0,1,0,1
150375,"2022",0,0,4,4
150375,"2023",1,0,1,2
150380,"2015",8,1,35,44
150380,"2016",10,0,29,39
150380,"2017",12,2,43,57
150380,"2018",14,0,36,50
150380,"2019",15,2,32,49
150380,"2020",20,5,38,63
150380,"2021",9,1,29,39
150380,"2022",11,2,29,42
150380,"2023",10,1,32,43
150390,"2015",16,1,52,69
150390,"2016",19,3,33,55
150390,"2017",12,2,43,57
150390,"2018",18,8,33,59
150390,"2019",19,4,40,63
150390,"2020",15,6,32,53
150390,"2021",18,7,35,60
150390,"2022",18,4,42,64
150390,"2023",21,6,29,56
150400,"2015",2,1,12,15
150400,"2016",3,1,10,14
150400,"2017",5,1,20,26
150400,"2018",3,0,10,13
150400,"2019",3,1,7,11
150400,"2020",5,0,13,18
150400,"2021",2,2,13,17
150400,"2022",2,3,19,24
150400,"2023",2,2,12,16
150405,"2015",6,2,19,27
150405,"2016",7,3,28,38
150405,"2017",3,1,11,15
150405,"2018",13,1,22,36
150405,"2019",6,1,16,23
150405,"2020",12,1,35,48
150405,"2021",6,2,19,27
150405,"2022",11,0,11,22
150405,"2023",2,1,10,13
150410,"2015",3,0,4,7
150410,"2016",0,0,1,1
150410,"2017",1,0,4,5
150410,"2018",0,1,5,6
150410,"2019",0,0,5,5
150410,"2020",0,1,0,1
150410,"2021",2,0,0,2
150410,"2022",1,0,3,4
150410,"2023",2,0,4,6
150420,"2015",97,9,251,357
150420,"2016",68,12,162,242
150420,"2017",91,12,201,304
150420,"2018",108,15,241,364
150420,"2019",118,18,232,368
150420,"2020",86,18,203,307
150420,"2021",81,21,180,282
150420,"2022",65,20,198,283
150420,"2023",44,7,125,176
150430,"2015",2,1,10,13
150430,"2016",3,1,9,13
150430,"2017",4,0,12,16
150430,"2018",5,1,10,16
150430,"2019",4,0,12,16
150430,"2020",4,0,7,11
150430,"2021",2,1,7,10
150430,"2022",3,2,6,11
150430,"2023",1,1,5,7
150440,"2015",2,0,8,10
150440,"2016",2,0,5,7
150440,"2017",1,0,9,10
150440,"2018",1,1,6,8
150440,"2019",3,0,3,6
150440,"2020",2,1,5,8
150440,"2021",1,0,7,8
150440,"2022",4,0,7,11
150440,"2023",1,1,5,7
150442,"2015",22,5,71,98
150442,"2016",16,5,66,87
150442,"2017",32,2,66,100
150442,"2018",23,3,63,89
150442,"2019",18,4,50,72
150442,"2020",28,4,53,85
150442,"2021",19,6,51,76
150442,"2022",14,4,32,50
150442,"2023",16,2,20,38
150445,"2015",1,0,2,3
150445,"2016",0,0,1,1
150445,"2017",0,0,1,1
150445,"2018",1,0,1,2
150445,"2019",2,0,0,2
150445,"2021",3,0,5,8
150445,"2022",3,2,12,17
150445,"2023",2,4,8,14
150450,"2015",3,2,12,17
150450,"2016",5,3,14,22
150450,"2017",5,1,16,22
150450,"2018",9,2,16,27
150450,"2019",5,1,16,22
150450,"2020",5,3,14,22
150450,"2021",5,2,12,19
150450,"2022",10,3,15,28
150450,"2023",10,2,24,36
150460,"2015",1,0,12,13
150460,"2016",0,0,6,6
150460,"2017",1,2,4,7
150460,"2018",1,0,6,7
150460,"2019",1,0,3,4
150460,"2020",1,0,3,4
150460,"2021",2,0,8,10
150460,"2022",5,2,7,14
150460,"2023",1,0,2,3
150470,"2015",7,3,36,46
150470,"2016",16,0,28,44
150470,"2017",11,0,45,56
150470,"2018",17,4,38,59
150470,"2019",11,3,43,57
150470,"2020",13,3,48,64
150470,"2021",15,3,32,50
150470,"2022",10,1,30,41
150470,"2023",7,0,27,34
150475,"2015",0,0,1,1
150475,"2017",0,0,2,2
150475,"2018",1,0,1,2
150475,"2019",0,0,1,1
150475,"2020",2,0,4,6
150475,"2022",1,2,2,5
150475,"2023",3,2,3,8
150480,"2015",21,3,47,71
150480,"2016",21,2,58,81
150480,"2017",24,5,69,98
150480,"2018",30,9,63,102
150480,"2019",25,2,50,77
150480,"2020",23,2,53,78
150480,"2021",29,3,56,88
150480,"2022",20,3,33,56
150480,"2023",14,2,19,35
150490,"2015",2,1,12,15
150490,"2016",2,1,13,16
150490,"2017",1,1,13,15
150490,"2018",5,0,11,16
150490,"2019",8,1,9,18
150490,"2020",6,0,18,24
150490,"2021",7,0,21,28
150490,"2022",9,4,11,24
150490,"2023",4,2,14,20
150495,"2015",0,0,4,4
150495,"2016",1,1,7,9
150495,"2017",2,0,14,16
150495,"2018",2,0,5,7
150495,"2019",1,1,3,5
150495,"2020",0,1,5,6
150495,"2021",0,0,6,6
150495,"2022",3,0,6,9
150495,"2023",3,1,5,9
150497,"2015",3,0,2,5
150497,"2016",1,0,7,8
150497,"2017",3,0,5,8
150497,"2018",2,0,4,6
150497,"2019",1,1,7,9
150497,"2020",4,0,4,8
150497,"2021",2,2,7,11
150497,"2022",2,0,5,7
150497,"2023",2,0,5,7
150500,"2015",1,0,2,3
150500,"2016",0,0,2,2
150500,"2017",0,0,1,1
150500,"2018",3,0,4,7
150500,"2019",2,0,3,5
150500,"2020",2,0,8,10
150500,"2021",3,0,3,6
150500,"2022",5,0,3,8
150500,"2023",0,1,2,3
150503,"2015",0,0,13,13
150503,"2016",0,0,2,2
150503,"2017",5,0,11,16
150503,"2018",3,1,9,13
150503,"2019",1,1,1,3
150503,"2020",1,0,4,5
150503,"2021",1,0,7,8
150503,"2022",4,0,14,18
150503,"2023",0,0,2,2
150506,"2015",4,1,18,23
150506,"2016",6,1,17,24
150506,"2017",4,1,15,20
150506,"2018",6,0,15,21
150506,"2019",3,1,21,25
150506,"2020",5,1,13,19
150506,"2021",5,0,30,35
150506,"2022",9,0,32,41
150506,"2023",4,3,23,30
150510,"2015",1,0,5,6
150510,"2016",0,0,1,1
150510,"2017",0,1,1,2
150510,"2018",0,0,1,1
150510,"2019",0,1,1,2
150510,"2020",1,0,0,1
150510,"2021",0,0,2,2
150510,"2022",1,0,0,1
150520,"2015",1,3,18,22
150520,"2016",10,3,25,38
150520,"2017",4,2,26,32
150520,"2018",9,0,34,43
150520,"2019",5,2,12,19
150520,"2020",4,0,13,17
150520,"2021",8,2,12,22
150520,"2022",9,2,20,31
150520,"2023",3,1,17,21
150530,"2015",35,5,64,104
150530,"2016",18,6,64,88
150530,"2017",38,5,81,124
150530,"2018",37,9,78,124
150530,"2019",42,6,61,109
150530,"2020",23,8,43,74
150530,"2021",23,4,45,72
150530,"2022",23,2,41,66
150530,"2023",11,3,30,44
150540,"2015",0,0,3,3
150540,"2016",0,0,2,2
150540,"2017",1,0,8,9
150540,"2018",1,0,6,7
150540,"2019",4,1,3,8
150540,"2020",2,0,12,14
150540,"2021",4,1,8,13
150540,"2022",6,2,5,13
150540,"2023",1,0,0,1
150543,"2015",0,0,3,3
150543,"2016",0,0,2,2
150543,"2017",1,0,1,2
150543,"2019",0,0,2,2
150543,"2020",0,0,2,2
150543,"2021",0,0,1,1
150543,"2022",1,0,0,1
150543,"2023",0,0,1,1
150548,"2015",4,3,18,25
150548,"2016",4,1,13,18
150548,"2017",4,3,16,23
150548,"2018",3,0,25,28
150548,"2019",4,0,30,34
150548,"2020",9,0,23,32
150548,"2021",9,0,26,35
150548,"2022",6,2,20,28
150548,"2023",8,3,17,28
150549,"2015",0,0,1,1
150549,"2017",0,0,1,1
150549,"2018",1,0,1,2
150549,"2019",2,0,3,5
150549,"2020",2,0,1,3
150549,"2021",3,1,5,9
150549,"2022",2,0,8,10
150549,"2023",1,0,1,2
150550,"2015",30,5,100,135
150550,"2016",46,4,108,158
150550,"2017",49,1,113,163
150550,"2018",34,8,82,124
150550,"2019",38,10,76,124
150550,"2020",19,8,54,81
150550,"2021",26,1,71,98
150550,"2022",20,7,49,76
150550,"2023",15,2,36,53
150553,"2015",38,3,149,190
150553,"2016",42,4,97,143
150553,"2017",43,7,118,168
150553,"2018",59,5,132,196
150553,"2019",42,11,113,166
150553,"2020",56,8,114,178
150553,"2021",52,8,102,162
150553,"2022",56,8,97,161
150553,"2023",34,3,46,83
150555,"2016",0,0,1,1
150555,"2017",0,0,1,1
150555,"2018",0,1,3,4
150555,"2022",0,0,1,1
150560,"2016",1,0,0,1
150560,"2017",0,0,1,1
150560,"2018",0,0,4,4
150560,"2019",0,0,2,2
150560,"2020",0,1,6,7
150560,"2021",1,0,5,6
150560,"2022",0,0,2,2
150560,"2023",1,1,3,5
150563,"2015",2,0,4,6
150563,"2016",4,0,2,6
150563,"2017",1,0,4,5
150563,"2018",3,1,6,10
150563,"2019",3,0,4,7
150563,"2020",1,0,11,12
150563,"2021",0,0,5,5
150563,"2022",1,0,2,3
150563,"2023",1,0,1,2
150565,"2015",5,0,4,9
150565,"2016",2,0,5,7
150565,"2017",3,1,10,14
150565,"2018",6,0,6,12
150565,"2019",1,0,2,3
150565,"2020",0,0,1,1
150565,"2021",0,1,1,2
150565,"2022",1,0,3,4
150565,"2023",1,0,1,2
150570,"2015",4,0,5,9
150570,"2016",2,1,7,10
150570,"2017",1,0,12,13
150570,"2018",5,1,14,20
150570,"2019",1,0,7,8
150570,"2020",2,2,9,13
150570,"2021",3,1,10,14
150570,"2022",0,3,6,9
150570,"2023",2,0,6,8
150580,"2015",17,1,43,61
150580,"2016",17,2,32,51
150580,"2017",13,3,36,52
150580,"2018",13,5,41,59
150580,"2019",19,5,54,78
150580,"2020",17,8,57,82
150580,"2021",6,6,47,59
150580,"2022",18,6,37,61
150580,"2023",12,7,26,45
150590,"2015",5,1,39,45
150590,"2016",5,3,23,31
150590,"2017",7,0,28,35
150590,"2018",10,1,24,35
150590,"2019",10,1,28,39
150590,"2020",6,1,47,54
150590,"2021",6,2,31,39
150590,"2022",6,0,21,27
150590,"2023",7,0,26,33
150600,"2015",4,0,6,10
150600,"2016",4,1,14,19
150600,"2017",5,1,39,45
150600,"2018",8,0,17,25
150600,"2019",5,2,10,17
150600,"2020",7,2,25,34
150600,"2021",10,2,22,34
150600,"2022",12,3,18,33
150600,"2023",5,0,25,30
150610,"2017",1,0,4,5
150610,"2018",0,0,9,9
150610,"2019",0,0,5,5
150610,"2020",1,0,3,4
150610,"2021",0,0,3,3
150610,"2022",0,0,3,3
150610,"2023",1,0,1,2
150611,"2015",1,0,1,2
150611,"2017",1,0,4,5
150611,"2018",2,0,4,6
150611,"2020",1,0,5,6
150611,"2021",2,0,7,9
150611,"2022",0,0,2,2
150611,"2023",0,0,2,2
150613,"2015",1,0,3,4
150613,"2016",0,1,1,2
150613,"2017",1,1,0,2
150613,"2018",4,1,3,8
150613,"2019",0,0,3,3
150613,"2020",3,0,2,5
150613,"2021",3,0,6,9
150613,"2022",1,0,2,3
150613,"2023",2,0,2,4
150616,"2015",4,0,4,8
150616,"2016",3,0,6,9
150616,"2017",1,0,4,5
150616,"2018",1,0,4,5
150616,"2019",1,0,10,11
150616,"2020",0,0,3,3
150616,"2021",1,0,3,4
150616,"2022",0,1,0,1
150616,"2023",0,0,1,1
150618,"2015",4,0,21,25
150618,"2016",5,0,16,21
150618,"2017",6,0,17,23
150618,"2018",10,1,28,39
150618,"2019",8,1,31,40
150618,"2020",7,2,16,25
150618,"2021",8,1,25,34
150618,"2022",5,2,24,31
150618,"2023",6,0,21,27
150619,"2015",2,0,8,10
150619,"2016",1,0,5,6
150619,"2017",2,0,8,10
150619,"2018",7,0,16,23
150619,"2019",7,1,19,27
150619,"2020",5,1,9,15
150619,"2021",12,1,6,19
150619,"2022",5,2,10,17
150619,"2023",1,0,2,3
150620,"2015",3,1,17,21
150620,"2016",5,3,23,31
150620,"2017",5,1,21,27
150620,"2018",8,0,30,38
150620,"2019",10,0,20,30
150620,"2020",7,3,22,32
150620,"2021",9,0,24,33
150620,"2022",6,0,18,24
150620,"2023",7,2,15,24
150630,"2015",2,2,14,18
150630,"2016",8,1,16,25
150630,"2017",8,0,21,29
150630,"2018",5,0,17,22
150630,"2019",6,1,12,19
150630,"2020",3,2,4,9
150630,"2021",3,1,12,16
150630,"2022",0,1,2,3
150630,"2023",2,0,3,5
150635,"2015",6,0,6,12
150635,"2016",1,1,13,15
150635,"2017",1,0,12,13
150635,"2018",2,0,16,18
150635,"2019",3,0,9,12
150635,"2020",2,0,10,12
150635,"2021",2,1,13,16
150635,"2022",5,2,11,18
150635,"2023",5,2,5,12
150640,"2015",0,0,1,1
150640,"2016",0,0,3,3
150640,"2017",0,0,6,6
150640,"2018",2,0,1,3
150640,"2019",0,0,2,2
150640,"2020",0,1,1,2
150640,"2021",0,0,1,1
150640,"2022",0,0,1,1
150640,"2023",0,0,1,1
150650,"2015",8,0,32,40
150650,"2016",6,1,21,28
150650,"2017",11,0,31,42
150650,"2018",9,1,42,52
150650,"2019",8,1,26,35
150650,"2020",3,1,29,33
150650,"2021",4,2,37,43
150650,"2022",6,1,17,24
150650,"2023",8,0,21,29
150655,"2015",2,0,3,5
150655,"2016",2,1,5,8
150655,"2017",2,0,4,6
150655,"2018",2,1,8,11
150655,"2019",4,0,3,7
150655,"2020",5,0,11,16
150655,"2021",4,0,4,8
150655,"2022",4,0,5,9
150655,"2023",2,0,7,9
150658,"2016",0,0,1,1
150658,"2017",0,0,1,1
150658,"2018",1,0,1,2
150658,"2021",1,0,3,4
150658,"2022",2,0,0,2
150658,"2023",1,0,3,4
150660,"2015",8,1,11,20
150660,"2016",1,1,11,13
150660,"2017",7,0,15,22
150660,"2018",4,2,10,16
150660,"2019",5,0,7,12
150660,"2020",3,1,5,9
150660,"2021",6,2,17,25
150660,"2022",8,1,13,22
150660,"2023",5,0,9,14
150670,"2016",0,0,1,1
150670,"2017",0,0,1,1
150670,"2018",0,0,1,1
150670,"2019",1,0,1,2
150670,"2020",0,0,1,1
150670,"2021",0,0,1,1
150680,"2015",65,13,196,274
150680,"2016",105,13,171,289
150680,"2017",56,10,103,169
150680,"2018",57,13,97,167
150680,"2019",60,5,133,198
150680,"2020",65,26,141,232
150680,"2021",47,15,112,174
150680,"2022",60,19,128,207
150680,"2023",56,9,90,155
150690,"2015",0,1,2,3
150690,"2016",2,1,0,3
150690,"2017",1,0,3,4
150690,"2018",1,0,0,1
150690,"2019",0,0,1,1
150690,"2020",0,0,3,3
150690,"2021",2,0,2,4
150690,"2022",0,0,2,2
150690,"2023",2,0,1,3
150700,"2015",1,0,7,8
150700,"2016",3,1,9,13
150700,"2017",5,0,11,16
150700,"2018",7,1,12,20
150700,"2019",2,1,18,21
150700,"2020",5,2,8,15
150700,"2021",3,2,4,9
150700,"2022",6,2,4,12
150700,"2023",2,2,6,10
150710,"2015",0,0,8,8
150710,"2016",0,0,5,5
150710,"2017",3,0,3,6
150710,"2018",2,0,5,7
150710,"2019",1,0,4,5
150710,"2020",0,0,6,6
150710,"2021",6,0,1,7
150710,"2022",1,0,2,3
150710,"2023",0,0,4,4
150715,"2015",0,0,4,4
150715,"2016",1,0,4,5
150715,"2017",2,0,7,9
150715,"2018",3,0,15,18
150715,"2019",4,1,12,17
150715,"2020",1,1,8,10
150715,"2021",1,0,16,17
150715,"2022",5,1,11,17
150715,"2023",2,0,1,3
150720,"2015",1,1,7,9
150720,"2016",2,1,8,11
150720,"2017",5,1,15,21
150720,"2018",3,3,15,21
150720,"2019",5,1,12,18
150720,"2020",0,0,13,13
150720,"2021",4,1,8,13
150720,"2022",1,0,13,14
150720,"2023",5,0,7,12
150730,"2015",12,3,45,60
150730,"2016",6,1,35,42
150730,"2017",16,2,37,55
150730,"2018",14,1,70,85
150730,"2019",20,1,64,85
150730,"2020",14,1,54,69
150730,"2021",16,5,47,68
150730,"2022",8,4,14,26
150730,"2023",9,1,27,37
150740,"2015",3,0,6,9
150740,"2016",3,0,2,5
150740,"2017",2,0,9,11
150740,"2018",1,2,7,10
150740,"2019",6,0,5,11
150740,"2020",2,0,4,6
150740,"2021",2,1,5,8
150740,"2022",3,0,6,9
150740,"2023",0,0,2,2
150745,"2015",7,2,21,30
150745,"2016",6,1,23,30
150745,"2017",14,0,30,44
150745,"2018",14,2,39,55
150745,"2019",7,1,20,28
150745,"2020",2,0,16,18
150745,"2021",7,0,28,35
150745,"2022",8,2,22,32
150745,"2023",5,1,19,25
150746,"2015",3,0,0,3
150746,"2016",0,0,1,1
150746,"2018",2,0,1,3
150746,"2019",0,1,2,3
150746,"2020",1,0,3,4
150746,"2021",1,0,0,1
150746,"2022",2,0,1,3
150746,"2023",4,0,1,5
150747,"2015",0,0,5,5
150747,"2016",0,0,6,6
150747,"2017",2,1,8,11
150747,"2018",3,0,8,11
150747,"2019",1,0,15,16
150747,"2020",2,1,9,12
150747,"2021",3,0,10,13
150747,"2022",2,1,8,11
150747,"2023",1,0,3,4
150750,"2015",1,0,1,2
150750,"2016",0,0,1,1
150750,"2017",0,1,2,3
150750,"2018",1,0,6,7
150750,"2019",0,0,4,4
150750,"2020",0,0,5,5
150750,"2021",1,0,7,8
150750,"2022",2,1,13,16
150750,"2023",1,0,1,2
150760,"2015",4,0,22,26
150760,"2016",2,1,14,17
150760,"2017",9,1,22,32
150760,"2018",9,4,21,34
150760,"2019",5,4,16,25
150760,"2020",11,4,15,30
150760,"2021",20,2,35,57
150760,"2022",8,5,32,45
150760,"2023",7,2,13,22
150770,"2015",2,0,1,3
150770,"2016",1,0,4,5
150770,"2017",1,0,3,4
150770,"2018",3,0,12,15
150770,"2019",0,0,13,13
150770,"2020",1,0,9,10
150770,"2021",5,1,15,21
150770,"2022",4,0,11,15
150770,"2023",5,0,5,10
150775,"2020",0,0,2,2
150775,"2021",0,0,1,1
150775,"2022",0,0,1,1
150780,"2015",1,0,5,6
150780,"2016",2,0,4,6
150780,"2017",4,0,5,9
150780,"2018",1,1,9,11
150780,"2019",2,0,8,10
150780,"2020",1,1,5,7
150780,"2021",1,0,5,6
150780,"2022",2,1,9,12
150780,"2023",6,0,6,12
150790,"2015",6,0,26,32
150790,"2016",3,1,28,32
150790,"2017",2,1,27,30
150790,"2018",4,1,13,18
150790,"2019",1,2,15,18
150790,"2020",3,1,11,15
150790,"2021",9,0,25,34
150790,"2022",2,1,18,21
150790,"2023",2,2,8,12
150795,"2015",5,4,59,68
150795,"2016",13,5,43,61
150795,"2017",16,4,60,80
150795,"2018",19,4,64,87
150795,"2019",14,4,41,59
150795,"2020",11,1,35,47
150795,"2021",9,1,17,27
150795,"2022",11,1,25,37
150795,"2023",8,2,7,17
150796,"2015",2,0,6,8
150796,"2016",2,1,3,6
150796,"2017",3,0,5,8
150796,"2018",1,0,3,4
150796,"2019",3,0,5,8
150796,"2020",2,0,5,7
150796,"2021",2,0,9,11
150796,"2022",0,0,4,4
150796,"2023",0,0,4,4
150797,"2015",0,4,4,8
150797,"2016",2,0,6,8
150797,"2017",3,0,11,14
150797,"2018",2,0,13,15
150797,"2019",2,0,10,12
150797,"2020",1,0,5,6
150797,"2021",3,1,2,6
150797,"2022",2,2,9,13
150797,"2023",5,1,8,14
150800,"2015",10,1,56,67
150800,"2016",13,0,30,43
150800,"2017",6,1,27,34
150800,"2018",4,0,33,37
150800,"2019",12,4,26,42
150800,"2020",12,4,27,43
150800,"2021",9,0,45,54
150800,"2022",21,2,37,60
150800,"2023",18,4,40,62
150803,"2015",4,1,15,20
150803,"2016",5,0,9,14
150803,"2017",3,0,9,12
150803,"2018",2,1,6,9
150803,"2019",3,0,8,11
150803,"2020",0,1,11,12
150803,"2021",3,0,6,9
150803,"2022",5,2,11,18
150803,"2023",6,0,4,10
150805,"2015",1,0,9,10
150805,"2016",4,0,12,16
150805,"2017",1,0,16,17
150805,"2018",2,0,15,17
150805,"2019",0,0,5,5
150805,"2020",2,0,3,5
150805,"2021",4,1,4,9
150805,"2022",3,2,10,15
150805,"2023",1,0,4,5
150808,"2015",5,0,12,17
150808,"2016",4,2,14,20
150808,"2019",1,0,1,2
150810,"2015",28,4,101,133
150810,"2016",32,4,68,104
150810,"2017",28,4,72,104
150810,"2018",33,7,93,133
150810,"2019",59,9,86,154
150810,"2020",32,13,87,132
150810,"2021",42,10,97,149
150810,"2022",31,6,81,118
150810,"2023",42,9,75,126
150812,"2015",3,0,15,18
150812,"2016",3,2,27,32
150812,"2017",4,1,26,31
150812,"2018",6,3,24,33
150812,"2019",4,1,19,24
150812,"2020",7,0,19,26
150812,"2021",4,2,27,33
150812,"2022",7,1,30,38
150812,"2023",5,0,14,19
150815,"2015",11,3,34,48
150815,"2016",22,5,44,71
150815,"2017",15,7,44,66
150815,"2018",10,3,29,42
150815,"2019",14,4,33,51
150815,"2020",7,1,41,49
150815,"2021",22,3,42,67
150815,"2022",6,2,22,30
150815,"2023",2,0,1,3
150820,"2015",3,1,10,14
150820,"2016",3,0,11,14
150820,"2017",5,2,29,36
150820,"2018",8,3,17,28
150820,"2019",7,0,17,24
150820,"2020",4,2,25,31
150820,"2021",9,1,16,26
150820,"2022",6,1,22,29
150820,"2023",3,1,10,14
150830,"2015",5,0,10,15
150830,"2016",5,0,11,16
150830,"2017",6,2,12,20
150830,"2018",8,0,14,22
150830,"2019",7,3,11,21
150830,"2020",2,3,18,23
150830,"2021",5,1,16,22
150830,"2022",4,2,21,27
150830,"2023",2,2,10,14
150835,"2015",3,0,10,13
150835,"2016",1,0,7,8
150835,"2017",6,0,7,13
150835,"2018",8,1,22,31
150835,"2019",13,3,32,48
150835,"2020",12,4,25,41
150835,"2021",12,0,21,33
150835,"2022",15,6,34,55
150835,"2023",6,1,17,24
150840,"2015",0,0,3,3
150840,"2016",0,1,1,2
150840,"2018",1,0,1,2
150840,"2019",0,0,2,2
150840,"2020",1,0,3,4
150840,"2021",0,0,1,1
150840,"2022",2,0,0,2
150840,"2023",0,0,2,2
160005,"2015",1,0,2,3
160005,"2016",1,0,4,5
160005,"2017",1,0,3,4
160005,"2018",2,0,5,7
160005,"2019",1,2,2,5
160005,"2020",1,1,0,2
160005,"2022",1,0,1,2
160005,"2023",1,0,2,3
160010,"2015",3,0,3,6
160010,"2016",1,1,2,4
160010,"2017",3,0,3,6
160010,"2018",1,0,4,5
160010,"2019",1,1,2,4
160010,"2020",0,0,2,2
160010,"2021",0,1,1,2
160010,"2022",1,1,5,7
160010,"2023",1,0,3,4
160015,"2015",6,2,5,13
160015,"2016",1,0,9,10
160015,"2017",4,1,5,10
160015,"2018",3,0,4,7
160015,"2019",1,0,9,10
160015,"2020",3,0,5,8
160015,"2021",3,1,0,4
160015,"2022",2,0,5,7
160015,"2023",3,0,3,6
160020,"2015",1,1,4,6
160020,"2016",2,0,9,11
160020,"2017",4,1,8,13
160020,"2018",4,1,5,10
160020,"2019",6,1,4,11
160020,"2020",2,1,6,9
160020,"2021",3,0,2,5
160020,"2022",1,1,3,5
160020,"2023",1,0,3,4
160021,"2015",1,1,5,7
160021,"2016",2,0,2,4
160021,"2017",2,0,2,4
160021,"2018",0,1,1,2
160021,"2019",1,1,2,4
160021,"2020",2,1,0,3
160021,"2021",1,1,1,3
160021,"2022",1,0,1,2
160021,"2023",1,0,2,3
160023,"2015",4,2,4,10
160023,"2016",2,0,5,7
160023,"2017",0,0,5,5
160023,"2018",1,0,7,8
160023,"2019",0,0,4,4
160023,"2020",0,0,2,2
160023,"2021",1,1,5,7
160023,"2022",1,0,3,4
160023,"2023",0,1,5,6
160025,"2015",2,0,3,5
160025,"2016",3,1,2,6
160025,"2017",4,0,2,6
160025,"2018",2,2,9,13
160025,"2019",2,1,3,6
160025,"2020",3,1,6,10
160025,"2021",0,0,3,3
160025,"2022",2,0,1,3
160025,"2023",0,0,1,1
160027,"2015",6,2,19,27
160027,"2016",7,0,13,20
160027,"2017",5,0,11,16
160027,"2018",2,0,1,3
160027,"2019",2,0,0,2
160027,"2020",1,0,3,4
160027,"2021",3,1,3,7
160027,"2023",1,0,0,1
160030,"2015",279,49,635,963
160030,"2016",291,69,483,843
160030,"2017",272,50,527,849
160030,"2018",260,71,498,829
160030,"2019",276,68,496,840
160030,"2020",296,58,512,866
160030,"2021",229,54,351,634
160030,"2022",183,55,280,518
160030,"2023",104,28,180,312
160040,"2015",9,1,22,32
160040,"2016",6,1,21,28
160040,"2017",8,4,19,31
160040,"2018",6,2,22,30
160040,"2019",4,5,13,22
160040,"2020",10,2,15,27
160040,"2021",4,2,20,26
160040,"2022",9,2,13,24
160040,"2023",8,2,13,23
160050,"2015",1,0,2,3
160050,"2016",0,0,1,1
160050,"2017",4,1,11,16
160050,"2018",4,1,9,14
160050,"2019",0,1,4,5
160050,"2020",0,0,2,2
160050,"2021",1,0,5,6
160050,"2022",1,1,7,9
160050,"2023",1,0,5,6
160053,"2015",11,2,10,23
160053,"2016",7,2,10,19
160053,"2017",7,1,8,16
160053,"2018",6,1,8,15
160053,"2019",5,1,5,11
160053,"2020",7,2,8,17
160053,"2021",5,0,8,13
160053,"2022",4,1,6,11
160053,"2023",0,1,3,4
160055,"2015",1,0,2,3
160055,"2016",0,0,3,3
160055,"2017",2,1,0,3
160055,"2018",2,0,4,6
160055,"2019",1,0,2,3
160055,"2020",2,0,3,5
160055,"2021",0,0,4,4
160055,"2022",1,1,1,3
160055,"2023",1,1,0,2
160060,"2015",103,18,205,326
160060,"2016",79,24,164,267
160060,"2017",66,11,137,214
160060,"2018",65,30,138,233
160060,"2019",68,10,92,170
160060,"2020",60,23,96,179
160060,"2021",39,12,98,149
160060,"2022",66,23,133,222
160060,"2023",53,12,78,143
160070,"2015",4,0,8,12
160070,"2016",3,1,8,12
160070,"2017",2,0,8,10
160070,"2018",1,1,5,7
160070,"2019",3,1,6,10
160070,"2020",5,0,1,6
160070,"2021",3,0,4,7
160070,"2022",3,0,2,5
160070,"2023",1,0,3,4
160080,"2015",2,0,0,2
160080,"2016",0,0,4,4
160080,"2017",1,0,0,1
160080,"2019",0,0,1,1
160080,"2020",1,0,0,1
160080,"2021",2,0,0,2
160080,"2022",0,0,1,1
160080,"2023",1,0,0,1
170025,"2017",1,0,1,2
170025,"2018",1,0,0,1
170025,"2019",0,0,1,1
170025,"2020",0,0,4,4
170025,"2021",1,0,1,2
170025,"2022",1,0,2,3
170030,"2015",0,0,2,2
170030,"2016",2,0,1,3
170030,"2017",0,0,3,3
170030,"2018",1,0,3,4
170030,"2019",3,0,2,5
170030,"2020",3,0,2,5
170030,"2021",0,0,1,1
170030,"2022",1,0,4,5
170030,"2023",2,0,2,4
170035,"2015",0,1,0,1
170035,"2016",4,0,3,7
170035,"2017",0,0,3,3
170035,"2018",0,0,1,1
170035,"2019",1,0,1,2
170035,"2020",2,0,2,4
170035,"2021",1,0,1,2
170035,"2022",2,0,0,2
170040,"2015",1,0,3,4
170040,"2016",2,0,3,5
170040,"2017",3,2,4,9
170040,"2019",0,0,1,1
170040,"2020",1,0,1,2
170040,"2023",1,0,2,3
170070,"2015",2,0,5,7
170070,"2016",2,0,5,7
170070,"2017",0,1,5,6
170070,"2018",1,0,0,1
170070,"2019",1,2,2,5
170070,"2020",1,0,3,4
170070,"2021",0,0,6,6
170070,"2022",5,0,2,7
170070,"2023",1,0,0,1
170100,"2015",2,0,11,13
170100,"2016",1,0,6,7
170100,"2017",1,2,6,9
170100,"2018",5,0,6,11
170100,"2019",1,0,9,10
170100,"2020",1,0,6,7
170100,"2021",2,0,5,7
170100,"2022",0,0,7,7
170100,"2023",2,0,4,6
170105,"2015",0,0,2,2
170105,"2016",1,0,1,2
170105,"2017",1,1,1,3
170105,"2018",1,0,1,2
170105,"2019",2,0,0,2
170105,"2020",0,1,1,2
170105,"2021",1,1,3,5
170105,"2022",0,2,3,5
170110,"2015",3,0,3,6
170110,"2016",0,0,1,1
170110,"2017",2,1,4,7
170110,"2018",1,0,1,2
170110,"2019",1,0,1,2
170110,"2020",4,0,1,5
170110,"2021",0,0,3,3
170110,"2022",0,0,1,1
170130,"2015",1,0,2,3
170130,"2016",0,0,3,3
170130,"2017",0,0,3,3
170130,"2018",0,0,1,1
170130,"2019",0,1,1,2
170130,"2020",0,0,3,3
170130,"2021",0,0,2,2
170130,"2022",0,0,5,5
170130,"2023",0,1,0,1
170190,"2015",0,0,6,6
170190,"2016",1,0,1,2
170190,"2017",0,1,2,3
170190,"2019",1,0,2,3
170190,"2020",0,0,4,4
170190,"2021",2,0,1,3
170190,"2022",0,0,3,3
170190,"2023",1,0,1,2
170200,"2015",0,0,2,2
170200,"2016",1,0,2,3
170200,"2017",1,1,0,2
170200,"2018",0,0,4,4
170200,"2019",1,0,3,4
170200,"2020",0,0,3,3
170200,"2021",0,0,2,2
170200,"2022",1,1,4,6
170200,"2023",1,0,1,2
170210,"2015",87,15,221,323
170210,"2016",85,10,180,275
170210,"2017",88,13,166,267
170210,"2018",75,11,149,235
170210,"2019",89,18,157,264
170210,"2020",64,8,109,181
170210,"2021",66,10,120,196
170210,"2022",68,15,109,192
170210,"2023",54,10,88,152
170215,"2015",0,0,1,1
170215,"2016",3,0,2,5
170215,"2017",0,0,3,3
170215,"2018",2,0,0,2
170215,"2019",0,0,3,3
170215,"2020",0,0,1,1
170215,"2021",1,0,4,5
170215,"2022",1,0,0,1
170215,"2023",0,1,0,1
170220,"2015",12,1,35,48
170220,"2016",7,1,14,22
170220,"2017",3,0,13,16
170220,"2018",1,2,3,6
170220,"2019",4,1,7,12
170220,"2020",3,0,22,25
170220,"2021",6,1,7,14
170220,"2022",5,3,5,13
170220,"2023",6,0,5,11
170230,"2015",1,0,3,4
170230,"2016",0,0,6,6
170230,"2017",5,2,4,11
170230,"2018",4,1,2,7
170230,"2019",2,0,1,3
170230,"2020",2,0,6,8
170230,"2021",0,1,3,4
170230,"2022",1,0,5,6
170230,"2023",0,1,2,3
170240,"2015",0,0,3,3
170240,"2017",2,0,0,2
170240,"2018",0,0,7,7
170240,"2019",2,0,1,3
170240,"2020",1,0,3,4
170240,"2021",3,0,4,7
170240,"2022",2,1,0,3
170255,"2015",12,2,25,39
170255,"2016",6,1,13,20
170255,"2017",3,0,9,12
170255,"2018",1,1,2,4
170255,"2019",7,1,7,15
170255,"2020",8,1,14,23
170255,"2021",5,0,3,8
170255,"2022",3,0,11,14
170255,"2023",0,1,1,2
170270,"2015",0,0,1,1
170270,"2019",0,0,2,2
170270,"2020",0,0,1,1
170270,"2021",1,0,0,1
170290,"2015",2,1,9,12
170290,"2016",0,2,8,10
170290,"2017",0,0,2,2
170290,"2018",3,0,3,6
170290,"2019",0,0,8,8
170290,"2020",3,1,4,8
170290,"2021",1,0,5,6
170290,"2022",1,1,3,5
170290,"2023",1,0,1,2
170300,"2015",1,0,5,6
170300,"2016",0,1,3,4
170300,"2017",0,0,7,7
170300,"2018",2,2,4,8
170300,"2019",2,2,2,6
170300,"2020",1,0,4,5
170300,"2021",4,0,3,7
170300,"2022",1,2,4,7
170300,"2023",1,1,2,4
170305,"2015",2,0,3,5
170305,"2016",2,0,0,2
170305,"2017",1,0,1,2
170305,"2018",1,0,1,2
170305,"2019",0,0,4,4
170305,"2020",4,0,0,4
170305,"2021",1,0,0,1
170305,"2022",1,0,2,3
170305,"2023",0,0,1,1
170307,"2015",2,0,3,5
170307,"2016",2,0,3,5
170307,"2017",3,0,5,8
170307,"2018",0,1,2,3
170307,"2019",1,1,6,8
170307,"2020",1,0,7,8
170307,"2021",1,0,2,3
170307,"2022",1,0,2,3
170307,"2023",1,0,2,3
170310,"2015",0,0,4,4
170310,"2016",1,0,5,6
170310,"2017",1,1,3,5
170310,"2019",0,1,2,3
170310,"2020",2,0,1,3
170310,"2021",0,0,2,2
170310,"2022",2,0,0,2
170310,"2023",1,0,1,2
170320,"2015",0,0,5,5
170320,"2017",1,1,3,5
170320,"2018",1,1,4,6
170320,"2019",1,1,1,3
170320,"2020",0,1,0,1
170320,"2022",1,0,2,3
170320,"2023",0,0,1,1
170330,"2015",0,0,1,1
170330,"2017",0,0,1,1
170330,"2019",0,0,1,1
170330,"2021",0,0,1,1
170360,"2015",0,0,2,2
170360,"2016",1,0,0,1
170360,"2018",0,0,2,2
170360,"2021",1,0,1,2
170360,"2023",0,1,1,2
170370,"2015",1,0,1,2
170370,"2016",1,1,3,5
170370,"2017",0,0,5,5
170370,"2018",0,0,4,4
170370,"2019",1,0,1,2
170370,"2020",0,0,2,2
170370,"2023",0,1,0,1
170380,"2015",3,0,8,11
170380,"2016",2,0,3,5
170380,"2017",1,0,4,5
170380,"2018",0,0,2,2
170380,"2019",0,1,3,4
170380,"2020",4,0,4,8
170380,"2021",1,2,2,5
170380,"2022",2,1,2,5
170380,"2023",0,0,1,1
170382,"2015",0,0,2,2
170382,"2016",1,0,0,1
170382,"2018",0,0,1,1
170382,"2019",1,1,1,3
170382,"2020",0,1,3,4
170382,"2021",1,0,0,1
170384,"2015",5,2,6,13
170384,"2016",3,0,6,9
170384,"2017",3,0,4,7
170384,"2018",2,0,5,7
170384,"2019",6,0,10,16
170384,"2020",3,0,6,9
170384,"2021",1,0,5,6
170384,"2022",3,0,8,11
170384,"2023",4,1,1,6
170386,"2015",2,0,2,4
170386,"2016",1,0,2,3
170386,"2017",3,0,5,8
170386,"2018",0,0,1,1
170386,"2019",1,0,0,1
170386,"2020",0,0,2,2
170386,"2022",0,0,2,2
170388,"2015",1,0,4,5
170388,"2016",2,0,1,3
170388,"2017",1,0,0,1
170388,"2018",1,0,2,3
170388,"2019",0,1,1,2
170388,"2020",2,0,0,2
170388,"2022",0,0,3,3
170388,"2023",1,0,1,2
170389,"2015",0,0,1,1
170389,"2016",1,0,1,2
170389,"2019",1,0,2,3
170389,"2020",1,0,3,4
170389,"2021",1,0,0,1
170389,"2022",2,0,1,3
170389,"2023",0,0,1,1
170390,"2016",1,0,2,3
170390,"2017",3,0,1,4
170390,"2018",0,0,1,1
170390,"2019",1,0,2,3
170390,"2020",0,0,3,3
170390,"2022",0,0,4,4
170390,"2023",0,1,1,2
170410,"2015",1,0,0,1
170410,"2016",1,0,0,1
170410,"2020",0,0,1,1
170410,"2022",1,0,0,1
170460,"2015",0,0,1,1
170460,"2018",1,0,0,1
170460,"2019",0,0,1,1
170460,"2023",1,0,0,1
170510,"2017",0,1,0,1
170510,"2018",2,0,0,2
170510,"2019",0,1,0,1
170510,"2020",0,0,1,1
170510,"2022",1,0,1,2
170510,"2023",0,0,1,1
170550,"2015",8,1,30,39
170550,"2016",9,3,18,30
170550,"2017",12,0,25,37
170550,"2018",5,2,23,30
170550,"2019",10,3,14,27
170550,"2020",5,0,8,13
170550,"2021",5,2,18,25
170550,"2022",5,1,19,25
170550,"2023",4,3,14,21
170555,"2015",0,0,1,1
170555,"2018",0,0,1,1
170555,"2019",0,0,1,1
170555,"2020",2,0,1,3
170555,"2021",0,0,1,1
170555,"2022",2,0,0,2
170555,"2023",0,0,1,1
170560,"2015",0,0,1,1
170560,"2016",2,0,3,5
170560,"2017",2,0,2,4
170560,"2018",1,0,1,2
170560,"2020",1,0,0,1
170560,"2021",0,0,1,1
170560,"2022",0,0,1,1
170560,"2023",0,0,1,1
170600,"2015",1,0,0,1
170600,"2016",0,0,1,1
170600,"2018",0,0,1,1
170600,"2019",1,0,2,3
170600,"2022",0,0,1,1
170600,"2023",0,0,1,1
170610,"2015",0,0,4,4
170610,"2017",1,0,3,4
170610,"2018",0,0,3,3
170610,"2019",2,0,0,2
170610,"2020",3,0,3,6
170610,"2021",1,1,1,3
170610,"2022",0,2,3,5
170610,"2023",2,0,1,3
170625,"2015",0,0,1,1
170625,"2018",2,0,1,3
170625,"2019",0,0,1,1
170625,"2022",0,0,1,1
170650,"2015",1,1,4,6
170650,"2016",3,0,7,10
170650,"2017",0,0,2,2
170650,"2018",1,1,4,6
170650,"2019",0,1,5,6
170650,"2020",1,0,2,3
170650,"2021",1,0,2,3
170650,"2022",2,0,6,8
170650,"2023",0,0,4,4
170700,"2015",1,1,9,11
170700,"2016",3,0,6,9
170700,"2017",5,2,8,15
170700,"2018",0,0,4,4
170700,"2019",7,2,5,14
170700,"2020",1,0,3,4
170700,"2021",1,1,5,7
170700,"2022",2,0,3,5
170700,"2023",1,1,2,4
170710,"2015",1,0,2,3
170710,"2016",0,0,2,2
170710,"2017",0,0,1,1
170710,"2018",1,1,1,3
170710,"2019",3,0,2,5
170710,"2020",2,0,4,6
170710,"2021",3,0,2,5
170710,"2022",0,0,1,1
170710,"2023",0,0,2,2
170720,"2015",1,0,1,2
170720,"2016",0,0,1,1
170720,"2017",2,0,1,3
170720,"2018",1,0,0,1
170720,"2019",2,0,1,3
170720,"2020",0,0,2,2
170720,"2021",1,0,3,4
170720,"2022",3,0,1,4
170720,"2023",0,0,1,1
170730,"2015",0,0,1,1
170730,"2016",0,0,1,1
170730,"2017",0,0,1,1
170730,"2018",0,1,0,1
170730,"2019",0,0,3,3
170730,"2021",2,0,3,5
170730,"2022",0,2,2,4
170740,"2015",1,0,5,6
170740,"2016",1,0,3,4
170740,"2017",1,0,7,8
170740,"2018",1,0,2,3
170740,"2019",1,0,5,6
170740,"2020",1,0,4,5
170740,"2021",4,1,1,6
170740,"2022",1,1,2,4
170755,"2015",1,0,3,4
170755,"2016",1,1,0,2
170755,"2017",2,0,0,2
170755,"2018",0,0,2,2
170755,"2019",0,1,2,3
170755,"2020",2,1,1,4
170755,"2021",0,0,1,1
170765,"2015",1,0,2,3
170765,"2016",1,0,2,3
170765,"2017",0,2,0,2
170765,"2018",0,0,1,1
170765,"2019",0,0,1,1
170765,"2020",1,0,1,2
170765,"2021",2,0,0,2
170765,"2022",0,1,0,1
170770,"2015",2,0,4,6
170770,"2016",5,3,8,16
170770,"2017",0,0,5,5
170770,"2018",2,1,7,10
170770,"2019",2,0,8,10
170770,"2020",3,0,1,4
170770,"2021",3,0,1,4
170770,"2022",3,0,1,4
170770,"2023",4,0,4,8
170820,"2015",5,1,6,12
170820,"2016",4,1,8,13
170820,"2017",4,2,9,15
170820,"2018",2,0,6,8
170820,"2019",7,0,5,12
170820,"2020",4,0,7,11
170820,"2021",0,0,9,9
170820,"2022",3,0,9,12
170820,"2023",1,0,2,3
170825,"2015",0,0,2,2
170825,"2016",1,0,5,6
170825,"2017",1,0,3,4
170825,"2018",1,0,0,1
170825,"2019",0,1,1,2
170825,"2021",1,0,0,1
170825,"2022",0,0,1,1
170830,"2015",0,0,1,1
170830,"2016",1,0,1,2
170830,"2017",0,0,2,2
170830,"2018",0,0,3,3
170830,"2019",1,0,2,3
170830,"2021",1,0,2,3
170830,"2022",1,0,0,1
170830,"2023",1,0,1,2
170900,"2015",4,0,9,13
170900,"2016",6,1,4,11
170900,"2017",4,0,6,10
170900,"2018",2,1,9,12
170900,"2019",2,2,13,17
170900,"2020",1,0,5,6
170900,"2021",5,0,4,9
170900,"2022",6,1,7,14
170900,"2023",1,1,5,7
170930,"2015",4,0,19,23
170930,"2016",11,4,17,32
170930,"2017",3,0,10,13
170930,"2018",2,0,9,11
170930,"2019",2,0,8,10
170930,"2020",1,0,0,1
170930,"2021",2,0,1,3
170930,"2022",1,0,1,2
170930,"2023",2,0,2,4
170950,"2015",23,4,64,91
170950,"2016",26,5,51,82
170950,"2017",32,3,47,82
170950,"2018",23,2,23,48
170950,"2019",16,7,26,49
170950,"2020",18,6,42,66
170950,"2021",12,1,36,49
170950,"2022",21,6,37,64
170950,"2023",10,2,17,29
170980,"2015",2,0,2,4
170980,"2016",1,0,1,2
170980,"2017",2,0,1,3
170980,"2020",1,1,0,2
171050,"2015",2,0,1,3
171050,"2016",2,0,2,4
171050,"2017",1,0,4,5
171050,"2018",0,0,3,3
171050,"2019",2,0,5,7
171050,"2021",2,0,2,4
171050,"2022",1,1,6,8
171050,"2023",0,0,3,3
171070,"2015",2,1,3,6
171070,"2016",0,0,2,2
171070,"2017",0,0,1,1
171070,"2018",0,0,1,1
171070,"2019",0,0,1,1
171070,"2020",2,0,3,5
171070,"2021",0,0,2,2
171070,"2022",0,0,4,4
171070,"2023",1,0,0,1
171090,"2015",0,0,2,2
171090,"2016",0,0,1,1
171090,"2017",1,1,1,3
171090,"2018",0,0,1,1
171090,"2019",1,0,1,2
171090,"2020",1,0,1,2
171090,"2022",1,0,2,3
171110,"2015",1,0,2,3
171110,"2016",0,0,1,1
171110,"2017",0,0,1,1
171110,"2018",1,0,2,3
171110,"2022",0,0,1,1
171110,"2023",1,0,1,2
171150,"2015",0,0,1,1
171150,"2017",1,0,0,1
171150,"2018",1,0,0,1
171150,"2019",1,0,0,1
171150,"2022",0,0,1,1
171180,"2015",0,0,2,2
171180,"2016",1,0,0,1
171180,"2017",0,0,3,3
171180,"2018",0,0,3,3
171180,"2019",1,0,0,1
171180,"2020",2,0,1,3
171180,"2021",0,0,2,2
171180,"2022",0,0,1,1
171180,"2023",1,0,0,1
171190,"2015",2,3,7,12
171190,"2016",3,0,4,7
171190,"2017",2,0,9,11
171190,"2018",2,1,5,8
171190,"2019",3,0,6,9
171190,"2020",1,1,18,20
171190,"2021",2,0,7,9
171190,"2022",0,0,5,5
171190,"2023",1,0,6,7
171195,"2015",2,0,3,5
171195,"2016",0,0,3,3
171195,"2017",1,0,1,2
171195,"2018",2,0,0,2
171195,"2019",2,0,1,3
171195,"2020",0,0,2,2
171195,"2021",0,0,2,2
171195,"2022",3,0,1,4
171195,"2023",0,1,1,2
171200,"2015",1,1,1,3
171200,"2016",2,0,1,3
171200,"2017",1,0,1,2
171200,"2019",1,1,1,3
171200,"2020",0,0,1,1
171200,"2021",0,0,2,2
171200,"2023",1,0,0,1
171215,"2016",0,0,1,1
171215,"2018",0,1,0,1
171215,"2019",0,1,0,1
171240,"2015",0,2,1,3
171240,"2017",2,1,0,3
171240,"2020",0,1,1,2
171240,"2021",1,0,0,1
171240,"2022",1,0,1,2
171245,"2015",2,0,1,3
171245,"2016",0,0,4,4
171245,"2017",1,0,0,1
171245,"2018",2,0,2,4
171245,"2019",1,0,2,3
171245,"2020",2,0,1,3
171245,"2021",0,0,2,2
171245,"2022",3,0,3,6
171245,"2023",3,0,0,3
171250,"2015",1,0,0,1
171250,"2016",0,1,2,3
171250,"2017",1,0,1,2
171250,"2018",0,0,2,2
171250,"2019",1,0,0,1
171250,"2020",2,0,2,4
171250,"2021",3,0,2,5
171250,"2022",1,1,3,5
171250,"2023",0,0,2,2
171270,"2015",0,0,1,1
171270,"2017",1,1,2,4
171270,"2018",0,0,1,1
171280,"2015",0,0,2,2
171280,"2016",0,0,1,1
171280,"2017",0,0,2,2
171280,"2018",0,0,2,2
171280,"2019",1,0,1,2
171280,"2020",1,1,0,2
171280,"2021",0,0,1,1
171280,"2022",2,0,3,5
171280,"2023",1,0,0,1
171320,"2015",6,0,28,34
171320,"2016",3,1,13,17
171320,"2017",3,3,22,28
171320,"2018",2,0,7,9
171320,"2019",5,1,12,18
171320,"2020",7,1,8,16
171320,"2021",2,0,8,10
171320,"2022",0,0,3,3
171320,"2023",0,0,1,1
171330,"2015",4,0,9,13
171330,"2016",4,0,8,12
171330,"2017",4,0,2,6
171330,"2018",1,0,2,3
171330,"2019",2,0,4,6
171330,"2020",2,1,6,9
171330,"2021",2,0,2,4
171330,"2022",0,0,3,3
171330,"2023",1,1,0,2
171360,"2015",2,1,1,4
171360,"2016",1,0,7,8
171360,"2017",3,0,4,7
171360,"2018",1,0,0,1
171360,"2019",1,1,1,3
171360,"2020",0,0,1,1
171360,"2022",0,0,2,2
171360,"2023",1,1,0,2
171370,"2015",1,0,0,1
171370,"2017",0,0,1,1
171370,"2018",0,0,2,2
171370,"2021",0,0,1,1
171370,"2022",0,0,3,3
171380,"2015",1,0,3,4
171380,"2016",0,1,2,3
171380,"2017",1,0,5,6
171380,"2018",1,0,4,5
171380,"2019",0,0,2,2
171380,"2020",1,1,2,4
171380,"2021",1,0,4,5
171380,"2022",3,0,2,5
171380,"2023",1,0,4,5
171395,"2015",1,0,3,4
171395,"2016",1,0,3,4
171395,"2017",3,0,1,4
171395,"2018",1,0,3,4
171395,"2019",2,0,1,3
171395,"2020",2,0,5,7
171395,"2021",1,0,0,1
171395,"2022",0,0,2,2
171395,"2023",2,0,1,3
171420,"2015",2,0,1,3
171420,"2016",1,1,7,9
171420,"2017",2,0,6,8
171420,"2018",1,0,1,2
171420,"2019",4,0,1,5
171420,"2020",1,0,2,3
171420,"2021",0,1,0,1
171430,"2015",1,2,4,7
171430,"2016",1,0,3,4
171430,"2017",1,0,0,1
171430,"2018",1,0,3,4
171430,"2019",0,0,1,1
171430,"2020",0,0,2,2
171430,"2021",0,0,2,2
171430,"2022",2,0,2,4
171430,"2023",0,0,1,1
171488,"2015",3,0,5,8
171488,"2016",2,2,8,12
171488,"2017",2,1,12,15
171488,"2018",3,0,9,12
171488,"2019",3,2,10,15
171488,"2020",2,1,6,9
171488,"2021",5,1,6,12
171488,"2022",4,1,5,10
171488,"2023",1,0,7,8
171500,"2015",1,1,1,3
171500,"2016",1,0,0,1
171500,"2017",0,0,2,2
171500,"2018",0,0,1,1
171500,"2019",0,0,1,1
171500,"2022",2,0,1,3
171500,"2023",0,0,4,4
171510,"2015",2,0,1,3
171510,"2016",2,0,1,3
171510,"2017",1,0,2,3
171510,"2019",0,1,4,5
171510,"2020",1,0,2,3
171510,"2022",1,0,2,3
171515,"2015",0,0,1,1
171515,"2020",0,0,1,1
171525,"2015",1,0,0,1
171525,"2016",2,0,1,3
171525,"2017",0,0,2,2
171525,"2020",0,0,1,1
171525,"2023",0,0,1,1
171550,"2015",1,0,1,2
171550,"2016",1,0,1,2
171550,"2017",0,0,2,2
171550,"2018",1,0,0,1
171550,"2019",1,0,1,2
171570,"2015",1,1,4,6
171570,"2016",3,0,1,4
171570,"2017",2,0,0,2
171570,"2018",0,1,3,4
171570,"2019",1,0,2,3
171570,"2020",1,0,0,1
171570,"2021",0,0,2,2
171570,"2022",2,0,0,2
171570,"2023",2,0,1,3
171575,"2015",0,0,4,4
171575,"2016",1,0,2,3
171575,"2017",0,0,1,1
171575,"2018",2,0,0,2
171575,"2019",1,0,2,3
171575,"2020",1,0,2,3
171575,"2021",2,0,4,6
171575,"2022",0,0,1,1
171610,"2015",12,0,27,39
171610,"2016",6,0,8,14
171610,"2017",9,0,19,28
171610,"2018",6,1,15,22
171610,"2019",19,6,24,49
171610,"2020",12,3,18,33
171610,"2021",9,2,17,28
171610,"2022",7,4,21,32
171610,"2023",1,1,21,23
171620,"2015",3,1,4,8
171620,"2016",0,0,5,5
171620,"2017",1,0,3,4
171620,"2018",1,0,1,2
171620,"2019",1,0,7,8
171620,"2020",1,3,5,9
171620,"2021",0,1,1,2
171620,"2022",0,0,2,2
171620,"2023",1,0,0,1
171630,"2015",1,0,0,1
171630,"2017",1,0,2,3
171630,"2018",3,0,0,3
171630,"2019",2,1,2,5
171630,"2020",0,0,3,3
171630,"2021",3,0,2,5
171630,"2022",1,0,4,5
171630,"2023",0,0,2,2
171650,"2015",1,0,1,2
171650,"2016",1,0,4,5
171650,"2017",2,0,4,6
171650,"2018",2,0,1,3
171650,"2019",2,0,3,5
171650,"2020",0,0,3,3
171650,"2021",0,0,4,4
171650,"2022",1,1,3,5
171650,"2023",2,0,0,2
171660,"2015",2,0,6,8
171660,"2016",1,1,4,6
171660,"2017",1,0,1,2
171660,"2018",2,0,2,4
171660,"2019",1,0,1,2
171660,"2020",0,0,4,4
171660,"2021",1,0,2,3
171660,"2022",1,0,2,3
171660,"2023",0,1,4,5
171665,"2015",0,0,2,2
171665,"2016",1,0,0,1
171665,"2017",1,0,4,5
171665,"2018",0,0,1,1
171665,"2019",1,0,1,2
171665,"2022",2,0,1,3
171665,"2023",0,0,1,1
171670,"2015",5,0,5,10
171670,"2016",3,1,5,9
171670,"2017",1,0,2,3
171670,"2018",0,0,5,5
171670,"2019",1,1,1,3
171670,"2020",1,0,0,1
171670,"2021",0,0,1,1
171670,"2022",1,0,1,2
171670,"2023",0,0,1,1
171700,"2015",0,1,1,2
171700,"2016",1,0,1,2
171700,"2017",0,0,1,1
171700,"2018",0,0,2,2
171700,"2019",0,0,1,1
171700,"2020",0,0,2,2
171700,"2022",2,0,0,2
171720,"2015",0,0,2,2
171720,"2016",0,0,4,4
171720,"2017",0,0,4,4
171720,"2018",1,0,1,2
171720,"2019",1,0,2,3
171720,"2020",0,0,3,3
171720,"2021",0,0,1,1
171720,"2022",1,0,1,2
171720,"2023",1,0,1,2
171750,"2015",2,0,3,5
171750,"2016",2,0,1,3
171750,"2017",1,0,1,2
171750,"2018",3,0,0,3
171750,"2019",0,0,1,1
171750,"2020",3,0,1,4
171750,"2021",1,0,0,1
171750,"2022",1,0,0,1
171750,"2023",1,1,0,2
171780,"2015",0,1,0,1
171780,"2016",1,0,1,2
171780,"2017",0,0,3,3
171780,"2021",0,0,3,3
171790,"2015",0,0,4,4
171790,"2016",0,0,5,5
171790,"2017",1,0,9,10
171790,"2018",0,0,2,2
171790,"2019",3,1,2,6
171790,"2020",0,0,1,1
171790,"2021",1,0,0,1
171790,"2022",0,1,3,4
171800,"2015",0,0,1,1
171800,"2017",0,0,2,2
171800,"2018",0,0,1,1
171800,"2019",1,0,1,2
171820,"2015",30,8,51,89
171820,"2016",30,8,56,94
171820,"2017",33,7,60,100
171820,"2018",12,3,31,46
171820,"2019",24,5,35,64
171820,"2020",17,5,25,47
171820,"2021",11,8,13,32
171820,"2022",8,2,21,31
171820,"2023",5,1,5,11
171830,"2015",2,0,8,10
171830,"2016",1,0,4,5
171830,"2017",3,1,2,6
171830,"2018",0,0,1,1
171830,"2019",1,0,1,2
171830,"2020",1,0,0,1
171830,"2021",1,0,2,3
171830,"2022",1,0,0,1
171840,"2015",1,0,1,2
171840,"2016",2,0,2,4
171840,"2017",0,0,1,1
171840,"2018",1,1,0,2
171840,"2019",0,0,2,2
171840,"2020",1,0,0,1
171840,"2022",0,0,1,1
171840,"2023",1,0,0,1
171845,"2015",0,0,1,1
171845,"2016",0,0,1,1
171845,"2017",1,0,3,4
171845,"2018",0,0,1,1
171845,"2019",0,2,0,2
171845,"2020",0,0,3,3
171850,"2015",0,0,1,1
171850,"2016",1,0,0,1
171850,"2018",1,0,0,1
171850,"2020",0,0,1,1
171855,"2015",1,0,0,1
171855,"2016",1,0,1,2
171855,"2018",2,0,1,3
171855,"2021",1,1,0,2
171855,"2022",4,1,1,6
171855,"2023",1,1,3,5
171865,"2015",0,0,1,1
171865,"2016",0,0,1,1
171865,"2022",0,0,1,1
171870,"2015",1,0,2,3
171870,"2016",1,0,2,3
171870,"2017",0,1,0,1
171870,"2018",0,1,1,2
171870,"2019",0,0,1,1
171870,"2020",1,0,0,1
171875,"2015",0,0,2,2
171875,"2016",1,0,1,2
171875,"2017",0,0,1,1
171875,"2018",0,0,1,1
171875,"2019",0,0,1,1
171875,"2021",0,0,2,2
171875,"2022",0,0,1,1
171875,"2023",0,0,1,1
171880,"2015",0,0,7,7
171880,"2016",0,0,1,1
171880,"2017",1,0,1,2
171880,"2019",0,0,2,2
171880,"2020",0,0,2,2
171880,"2021",1,0,3,4
171880,"2022",1,1,2,4
171880,"2023",0,0,1,1
171884,"2015",0,0,1,1
171884,"2017",0,0,1,1
171884,"2018",2,0,0,2
171884,"2020",1,0,3,4
171884,"2021",1,0,0,1
171884,"2022",1,0,2,3
171886,"2015",0,0,7,7
171886,"2016",2,0,9,11
171886,"2017",3,0,3,6
171886,"2018",0,0,5,5
171886,"2019",0,0,3,3
171886,"2020",0,0,4,4
171886,"2021",0,1,4,5
171886,"2022",1,1,3,5
171886,"2023",1,0,0,1
171888,"2017",0,0,3,3
171888,"2020",1,0,0,1
171888,"2021",0,0,1,1
171889,"2017",0,0,1,1
171889,"2018",0,0,1,1
171889,"2022",0,0,1,1
171890,"2015",0,1,3,4
171890,"2016",2,0,2,4
171890,"2017",2,0,4,6
171890,"2018",0,0,1,1
171890,"2020",0,0,1,1
171890,"2021",0,0,1,1
171900,"2015",1,0,2,3
171900,"2016",0,0,4,4
171900,"2017",1,0,4,5
171900,"2019",0,1,1,2
171900,"2022",1,0,3,4
172000,"2015",0,0,1,1
172000,"2016",1,0,2,3
172000,"2017",1,0,1,2
172000,"2018",1,0,2,3
172000,"2019",1,0,0,1
172000,"2020",0,1,0,1
172000,"2021",0,0,1,1
172000,"2022",1,0,0,1
172000,"2023",1,0,1,2
172010,"2015",1,0,6,7
172010,"2016",1,0,1,2
172010,"2017",0,0,2,2
172010,"2018",0,1,0,1
172010,"2019",0,0,1,1
172010,"2021",2,0,2,4
172010,"2022",3,0,0,3
172010,"2023",1,1,3,5
172015,"2015",1,1,0,2
172015,"2016",0,1,0,1
172015,"2019",2,1,2,5
172015,"2022",1,0,0,1
172020,"2015",1,1,6,8
172020,"2016",2,0,3,5
172020,"2017",5,0,2,7
172020,"2018",2,0,0,2
172020,"2019",1,0,1,2
172020,"2020",0,0,2,2
172020,"2021",1,0,1,2
172020,"2022",1,0,1,2
172020,"2023",1,0,1,2
172025,"2015",1,0,0,1
172025,"2016",2,0,0,2
172025,"2017",1,0,0,1
172025,"2019",0,0,2,2
172025,"2020",1,0,1,2
172025,"2023",0,0,1,1
172030,"2015",2,1,5,8
172030,"2016",0,0,4,4
172030,"2017",0,0,2,2
172030,"2018",0,0,1,1
172030,"2019",0,0,1,1
172030,"2020",2,0,1,3
172030,"2021",2,0,1,3
172030,"2023",0,0,1,1
172049,"2015",1,0,0,1
172049,"2016",0,0,1,1
172049,"2017",0,0,2,2
172049,"2018",2,0,0,2
172049,"2019",1,0,2,3
172049,"2020",1,0,1,2
172049,"2021",1,0,1,2
172049,"2022",0,2,1,3
172049,"2023",0,0,1,1
172065,"2015",2,0,6,8
172065,"2016",2,0,1,3
172065,"2017",5,0,6,11
172065,"2018",0,0,1,1
172065,"2019",1,0,3,4
172065,"2020",0,0,1,1
172065,"2021",0,0,3,3
172065,"2023",1,0,0,1
172080,"2015",0,0,4,4
172080,"2016",3,0,4,7
172080,"2018",0,0,4,4
172080,"2019",0,0,4,4
172080,"2020",0,0,3,3
172080,"2021",1,0,4,5
172080,"2022",2,0,1,3
172080,"2023",1,0,1,2
172085,"2015",0,0,2,2
172085,"2018",0,0,1,1
172085,"2019",1,0,0,1
172090,"2015",2,0,6,8
172090,"2016",1,1,5,7
172090,"2017",3,0,4,7
172090,"2019",1,1,2,4
172090,"2020",1,0,2,3
172090,"2021",1,2,3,6
172090,"2022",5,0,3,8
172090,"2023",1,0,1,2
172093,"2015",0,0,1,1
172093,"2017",0,0,2,2
172093,"2019",1,0,0,1
172093,"2020",0,0,1,1
172097,"2016",0,0,3,3
172097,"2017",0,0,1,1
172097,"2018",0,0,1,1
172097,"2019",1,1,2,4
172097,"2020",1,0,1,2
172097,"2021",1,0,0,1
172097,"2023",0,0,1,1
172100,"2015",139,38,278,455
172100,"2016",105,27,228,360
172100,"2017",133,28,247,408
172100,"2018",59,12,100,171
172100,"2019",123,25,179,327
172100,"2020",103,25,167,295
172100,"2021",83,24,129,236
172100,"2022",55,19,94,168
172100,"2023",38,7,50,95
172110,"2015",1,0,6,7
172110,"2016",1,0,0,1
172110,"2017",3,1,6,10
172110,"2018",0,0,4,4
172110,"2019",2,1,3,6
172110,"2020",1,1,4,6
172110,"2021",3,0,4,7
172110,"2022",1,0,0,1
172120,"2015",6,0,15,21
172120,"2016",9,0,21,30
172120,"2017",6,0,20,26
172120,"2018",6,5,21,32
172120,"2019",8,3,15,26
172120,"2020",3,0,13,16
172120,"2021",5,1,13,19
172120,"2022",5,1,8,14
172120,"2023",1,0,9,10
172125,"2022",0,0,1,1
172125,"2023",1,0,0,1
172130,"2015",1,0,0,1
172130,"2017",0,0,2,2
172130,"2020",0,0,1,1
172130,"2022",0,0,2,2
172130,"2023",1,0,0,1
172208,"2015",2,0,5,7
172208,"2016",4,1,5,10
172208,"2017",4,0,7,11
172208,"2018",6,0,7,13
172208,"2019",2,1,7,10
172208,"2020",1,0,3,4
172208,"2021",5,1,2,8
172208,"2022",1,0,7,8
172208,"2023",1,0,4,5
172210,"2015",1,0,4,5
172210,"2016",3,0,13,16
172210,"2017",0,0,8,8
172210,"2018",3,0,6,9
172210,"2019",5,0,4,9
172210,"2020",3,1,5,9
172210,"2021",4,1,6,11
172210,"2022",4,0,2,6
172210,"2023",2,1,4,7
210005,"2015",44,5,101,150
210005,"2016",24,1,65,90
210005,"2017",30,8,90,128
210005,"2018",15,4,47,66
210005,"2019",24,7,64,95
210005,"2020",19,4,48,71
210005,"2021",22,3,72,97
210005,"2022",27,4,45,76
210005,"2023",22,1,43,66
210010,"2015",2,0,6,8
210010,"2016",1,0,1,2
210010,"2017",1,0,7,8
210010,"2018",2,0,5,7
210010,"2019",3,0,6,9
210010,"2020",1,0,8,9
210010,"2021",2,1,5,8
210010,"2022",1,0,7,8
210010,"2023",0,0,2,2
210015,"2015",0,0,5,5
210015,"2016",2,0,3,5
210015,"2017",0,0,6,6
210015,"2018",2,0,1,3
210015,"2019",1,0,4,5
210015,"2020",0,0,3,3
210015,"2021",3,0,4,7
210015,"2022",1,0,1,2
210015,"2023",1,1,4,6
210020,"2015",0,0,4,4
210020,"2016",1,0,2,3
210020,"2017",2,0,4,6
210020,"2018",2,0,2,4
210020,"2019",4,1,4,9
210020,"2020",1,1,2,4
210020,"2021",2,0,4,6
210020,"2022",0,1,2,3
210020,"2023",1,2,1,4
210030,"2017",1,1,5,7
210030,"2018",9,1,10,20
210030,"2019",5,1,9,15
210030,"2020",4,0,11,15
210030,"2021",8,2,19,29
210030,"2022",7,1,12,20
210030,"2023",2,2,12,16
210040,"2015",0,0,2,2
210040,"2016",0,0,4,4
210040,"2017",3,0,0,3
210040,"2018",4,0,5,9
210040,"2019",2,0,4,6
210040,"2020",2,1,1,4
210040,"2021",0,0,2,2
210040,"2022",1,1,0,2
210040,"2023",0,0,1,1
210043,"2015",6,0,37,43
210043,"2016",7,0,26,33
210043,"2017",10,1,33,44
210043,"2018",5,0,37,42
210043,"2019",14,2,39,55
210043,"2020",10,1,26,37
210043,"2021",4,0,9,13
210043,"2022",6,2,29,37
210043,"2023",6,1,26,33
210047,"2015",1,0,5,6
210047,"2016",2,1,9,12
210047,"2017",2,0,11,13
210047,"2018",7,2,18,27
210047,"2019",6,2,10,18
210047,"2020",5,1,2,8
210047,"2021",1,2,9,12
210047,"2022",0,1,5,6
210047,"2023",1,0,1,2
210050,"2018",3,0,4,7
210050,"2019",0,0,1,1
210050,"2020",0,1,1,2
210050,"2021",1,1,0,2
210050,"2022",3,0,2,5
210050,"2023",1,1,0,2
210055,"2015",2,1,4,7
210055,"2016",4,0,6,10
210055,"2017",3,0,3,6
210055,"2018",2,0,0,2
210055,"2019",1,1,5,7
210055,"2020",2,0,6,8
210055,"2021",0,0,4,4
210055,"2022",3,0,1,4
210055,"2023",3,0,1,4
210060,"2015",3,1,7,11
210060,"2016",2,0,8,10
210060,"2017",6,1,8,15
210060,"2018",5,0,7,12
210060,"2019",0,0,5,5
210060,"2020",0,0,4,4
210060,"2021",0,0,2,2
210060,"2022",0,0,3,3
210060,"2023",0,0,3,3
210070,"2015",0,0,7,7
210070,"2016",4,0,4,8
210070,"2017",3,0,9,12
210070,"2018",3,0,9,12
210070,"2019",4,0,10,14
210070,"2020",6,1,6,13
210070,"2021",5,2,7,14
210070,"2022",9,0,15,24
210070,"2023",7,1,6,14
210080,"2015",3,0,15,18
210080,"2016",4,0,10,14
210080,"2017",1,1,11,13
210080,"2018",6,1,15,22
210080,"2019",5,1,14,20
210080,"2020",5,0,6,11
210080,"2021",3,1,4,8
210080,"2022",3,1,6,10
210080,"2023",4,0,8,12
210083,"2015",3,0,3,6
210083,"2021",2,0,2,4
210083,"2023",0,0,1,1
210087,"2016",0,0,3,3
210087,"2017",0,0,3,3
210087,"2018",1,0,2,3
210087,"2019",3,0,0,3
210087,"2020",0,0,6,6
210087,"2021",0,0,2,2
210087,"2022",0,0,3,3
210087,"2023",0,0,1,1
210090,"2015",1,0,7,8
210090,"2016",0,0,8,8
210090,"2017",8,2,14,24
210090,"2018",3,0,26,29
210090,"2019",4,2,7,13
210090,"2020",5,1,12,18
210090,"2021",3,3,6,12
210090,"2022",5,0,11,16
210090,"2023",1,0,8,9
210095,"2015",1,0,1,2
210095,"2016",3,1,7,11
210095,"2017",3,0,15,18
210095,"2018",9,1,21,31
210095,"2019",5,2,17,24
210095,"2020",8,2,17,27
210095,"2021",14,0,30,44
210095,"2022",7,4,26,37
210095,"2023",2,1,4,7
210100,"2015",5,1,9,15
210100,"2016",6,1,17,24
210100,"2017",3,1,11,15
210100,"2018",7,1,13,21
210100,"2019",9,2,19,30
210100,"2020",8,0,24,32
210100,"2021",8,1,10,19
210100,"2022",8,0,15,23
210100,"2023",1,1,10,12
210110,"2015",0,0,1,1
210110,"2017",1,0,0,1
210110,"2018",1,0,0,1
210110,"2019",0,0,2,2
210110,"2021",0,0,1,1
210110,"2022",0,0,1,1
210110,"2023",2,0,1,3
210120,"2015",44,8,150,202
210120,"2016",29,4,111,144
210120,"2017",27,7,90,124
210120,"2018",43,4,111,158
210120,"2019",53,10,124,187
210120,"2020",35,7,111,153
210120,"2021",36,6,104,146
210120,"2022",23,6,95,124
210120,"2023",29,5,59,93
210125,"2015",0,1,3,4
210125,"2016",0,0,4,4
210125,"2017",2,2,4,8
210125,"2018",2,1,3,6
210125,"2019",1,0,1,2
210125,"2020",2,0,0,2
210125,"2021",3,0,2,5
210125,"2022",0,1,5,6
210125,"2023",4,0,2,6
210130,"2015",1,0,3,4
210130,"2017",0,0,1,1
210130,"2018",1,0,1,2
210130,"2019",1,0,0,1
210130,"2020",0,0,1,1
210130,"2021",0,0,1,1
210130,"2022",1,0,1,2
210130,"2023",0,0,3,3
210135,"2015",1,0,1,2
210135,"2018",0,0,1,1
210135,"2019",1,0,0,1
210135,"2020",0,0,1,1
210135,"2021",1,0,1,2
210135,"2023",0,0,1,1
210140,"2015",1,0,5,6
210140,"2016",5,1,7,13
210140,"2017",6,0,16,22
210140,"2018",50,7,121,178
210140,"2019",56,10,132,198
210140,"2020",56,15,102,173
210140,"2021",65,8,115,188
210140,"2022",61,11,129,201
210140,"2023",31,8,74,113
210150,"2016",4,2,21,27
210150,"2017",7,2,24,33
210150,"2018",5,2,9,16
210150,"2019",9,0,15,24
210150,"2020",3,0,17,20
210150,"2021",11,1,17,29
210150,"2022",8,2,10,20
210150,"2023",3,5,14,22
210160,"2015",36,7,85,128
210160,"2016",25,4,87,116
210160,"2017",28,9,93,130
210160,"2018",32,11,92,135
210160,"2019",32,6,78,116
210160,"2020",24,7,62,93
210160,"2021",53,8,106,167
210160,"2022",25,8,55,88
210160,"2023",2,0,2,4
210170,"2015",17,2,44,63
210170,"2016",19,6,69,94
210170,"2017",22,4,47,73
210170,"2018",21,10,64,95
210170,"2019",23,4,51,78
210170,"2020",19,1,49,69
210170,"2021",23,3,47,73
210170,"2022",21,6,52,79
210170,"2023",20,3,32,55
210173,"2015",0,0,3,3
210173,"2016",0,0,4,4
210173,"2017",0,0,3,3
210173,"2018",1,0,4,5
210173,"2019",1,0,3,4
210173,"2020",0,0,3,3
210173,"2021",1,0,4,5
210173,"2022",0,0,4,4
210173,"2023",0,0,3,3
210177,"2015",4,1,15,20
210177,"2016",2,0,4,6
210177,"2017",1,1,11,13
210177,"2018",5,1,10,16
210177,"2019",3,0,12,15
210177,"2020",6,0,14,20
210177,"2021",8,2,8,18
210177,"2022",0,0,1,1
210177,"2023",0,0,1,1
210180,"2016",0,1,0,1
210180,"2018",0,0,1,1
210180,"2019",0,0,2,2
210180,"2021",2,0,0,2
210180,"2023",2,0,0,2
210190,"2015",0,0,5,5
210190,"2016",0,1,3,4
210190,"2017",0,0,8,8
210190,"2018",1,1,4,6
210190,"2019",3,0,2,5
210190,"2020",0,0,2,2
210190,"2021",0,0,2,2
210190,"2022",0,1,0,1
210190,"2023",1,1,0,2
210193,"2015",0,0,1,1
210193,"2016",2,0,2,4
210193,"2017",0,0,1,1
210193,"2018",2,0,5,7
210193,"2019",3,0,5,8
210193,"2020",0,0,1,1
210193,"2023",0,0,3,3
210197,"2015",5,0,6,11
210197,"2016",3,0,11,14
210197,"2017",2,0,5,7
210197,"2018",0,0,4,4
210197,"2019",5,0,6,11
210197,"2020",3,0,7,10
210197,"2021",2,1,7,10
210197,"2022",1,0,2,3
210197,"2023",1,0,3,4
210200,"2015",11,1,13,25
210200,"2016",6,0,19,25
210200,"2017",5,0,6,11
210200,"2018",2,0,12,14
210200,"2019",5,5,36,46
210200,"2020",3,1,10,14
210200,"2021",3,0,7,10
210200,"2022",1,0,3,4
210203,"2015",0,0,12,12
210203,"2016",2,0,10,12
210203,"2017",3,0,11,14
210203,"2018",8,0,7,15
210203,"2019",3,0,14,17
210203,"2020",2,1,7,10
210203,"2021",2,0,2,4
210203,"2022",3,0,3,6
210203,"2023",3,0,8,11
210207,"2015",2,0,10,12
210207,"2016",4,0,5,9
210207,"2017",3,0,5,8
210207,"2018",3,0,7,10
210207,"2019",1,0,6,7
210207,"2020",3,0,7,10
210207,"2021",2,0,5,7
210207,"2022",0,0,1,1
210207,"2023",0,0,2,2
210210,"2015",10,2,28,40
210210,"2016",6,2,18,26
210210,"2017",6,1,17,24
210210,"2018",12,4,18,34
210210,"2019",8,1,9,18
210210,"2020",22,4,20,46
210210,"2021",13,3,28,44
210210,"2022",13,3,23,39
210210,"2023",7,5,13,25
210215,"2015",2,0,4,6
210215,"2016",1,1,6,8
210215,"2017",0,0,5,5
210215,"2018",1,0,5,6
210215,"2019",0,0,6,6
210215,"2020",4,0,9,13
210215,"2021",0,0,5,5
210215,"2022",1,0,1,2
210220,"2015",13,3,20,36
210220,"2016",2,2,25,29
210220,"2017",4,3,22,29
210220,"2018",9,3,20,32
210220,"2019",10,2,30,42
210220,"2020",10,2,21,33
210220,"2021",5,0,9,14
210220,"2022",4,1,25,30
210220,"2023",11,0,13,24
210230,"2016",0,0,1,1
210230,"2017",0,1,2,3
210230,"2018",3,0,1,4
210230,"2019",3,1,3,7
210230,"2020",0,2,4,6
210230,"2021",4,0,6,10
210230,"2022",5,0,9,14
210230,"2023",0,1,4,5
210232,"2015",21,9,64,94
210232,"2016",16,1,66,83
210232,"2017",20,2,45,67
210232,"2018",23,2,47,72
210232,"2019",25,5,31,61
210232,"2020",11,2,18,31
210232,"2021",18,1,29,48
210232,"2022",15,3,20,38
210232,"2023",7,0,18,25
210235,"2015",5,0,7,12
210235,"2016",4,0,3,7
210235,"2017",2,1,4,7
210235,"2018",0,1,1,2
210235,"2019",0,0,3,3
210235,"2020",1,0,3,4
210235,"2022",2,1,6,9
210235,"2023",0,0,1,1
210237,"2017",0,0,1,1
210237,"2018",3,0,1,4
210237,"2020",2,0,3,5
210237,"2021",0,0,3,3
210237,"2022",1,0,2,3
210237,"2023",1,0,6,7
210240,"2015",1,1,4,6
210240,"2017",1,0,1,2
210240,"2018",0,1,2,3
210240,"2019",0,0,1,1
210240,"2020",2,0,0,2
210240,"2021",0,0,3,3
210240,"2023",0,0,1,1
210250,"2015",2,0,1,3
210250,"2016",0,0,6,6
210250,"2017",1,0,7,8
210250,"2018",2,0,3,5
210250,"2019",3,0,0,3
210250,"2020",1,0,1,2
210250,"2022",1,0,3,4
210250,"2023",0,0,2,2
210255,"2015",1,0,7,8
210255,"2016",4,1,12,17
210255,"2017",0,0,3,3
210255,"2018",5,0,7,12
210255,"2019",4,0,15,19
210255,"2020",1,0,5,6
210255,"2021",2,0,3,5
210255,"2023",0,0,1,1
210260,"2015",1,0,4,5
210260,"2016",0,1,8,9
210260,"2017",2,0,8,10
210260,"2018",0,0,6,6
210260,"2019",1,0,3,4
210260,"2020",1,0,2,3
210260,"2021",2,1,12,15
210260,"2022",3,0,5,8
210260,"2023",1,0,7,8
210270,"2015",3,1,10,14
210270,"2016",5,0,3,8
210270,"2017",6,2,8,16
210270,"2018",0,0,3,3
210270,"2019",2,0,8,10
210270,"2020",4,1,9,14
210270,"2021",4,0,17,21
210270,"2022",5,0,10,15
210270,"2023",3,1,11,15
210275,"2015",2,0,7,9
210275,"2016",1,0,9,10
210275,"2017",1,0,12,13
210275,"2018",4,0,7,11
210275,"2019",3,1,5,9
210275,"2020",1,0,2,3
210275,"2021",2,1,2,5
210275,"2022",1,0,5,6
210275,"2023",2,0,0,2
210280,"2015",6,1,1,8
210280,"2016",4,1,7,12
210280,"2017",1,0,6,7
210280,"2018",1,0,4,5
210280,"2019",3,1,9,13
210280,"2020",7,0,4,11
210280,"2021",5,0,11,16
210280,"2022",3,3,10,16
210280,"2023",0,0,11,11
210290,"2015",1,0,8,9
210290,"2016",2,0,10,12
210290,"2017",1,0,12,13
210290,"2018",1,1,13,15
210290,"2019",2,0,10,12
210290,"2020",7,1,13,21
210290,"2021",4,0,7,11
210290,"2022",5,0,11,16
210290,"2023",1,1,8,10
210300,"2015",2,0,1,3
210300,"2016",1,0,3,4
210300,"2017",11,2,46,59
210300,"2018",39,6,86,131
210300,"2019",77,13,125,215
210300,"2020",95,22,174,291
210300,"2021",84,17,181,282
210300,"2022",96,18,151,265
210300,"2023",38,9,108,155
210310,"2016",0,0,1,1
210310,"2018",0,0,1,1
210310,"2020",1,0,1,2
210310,"2022",1,0,0,1
210312,"2020",0,0,1,1
210315,"2015",1,1,11,13
210315,"2016",0,1,4,5
210315,"2017",0,0,3,3
210315,"2018",3,1,8,12
210315,"2019",3,0,6,9
210315,"2020",4,1,7,12
210315,"2021",2,0,8,10
210315,"2022",0,0,5,5
210315,"2023",1,0,5,6
210317,"2015",5,0,19,24
210317,"2016",5,3,17,25
210317,"2017",2,3,18,23
210317,"2018",3,3,15,21
210317,"2019",11,2,13,26
210317,"2020",3,0,14,17
210317,"2021",4,2,24,30
210317,"2022",5,2,14,21
210317,"2023",2,0,4,6
210320,"2015",21,4,83,108
210320,"2016",25,4,65,94
210320,"2017",39,9,100,148
210320,"2018",37,11,106,154
210320,"2019",36,3,95,134
210320,"2020",41,3,85,129
210320,"2021",37,12,70,119
210320,"2022",42,8,77,127
210320,"2023",35,9,64,108
210325,"2015",2,1,6,9
210325,"2016",1,1,5,7
210325,"2017",1,0,7,8
210325,"2018",1,0,9,10
210325,"2020",1,0,7,8
210325,"2021",2,0,4,6
210325,"2022",1,0,2,3
210325,"2023",1,0,2,3
210330,"2015",51,8,112,171
210330,"2016",29,3,93,125
210330,"2017",40,2,105,147
210330,"2018",52,7,139,198
210330,"2019",49,6,139,194
210330,"2020",35,6,89,130
210330,"2021",64,8,99,171
210330,"2022",69,15,105,189
210330,"2023",38,11,95,144
210340,"2015",12,2,40,54
210340,"2016",11,4,28,43
210340,"2017",14,4,31,49
210340,"2018",18,6,52,76
210340,"2019",17,10,45,72
210340,"2020",16,5,35,56
210340,"2021",12,1,29,42
210340,"2022",13,5,26,44
210340,"2023",10,4,19,33
210350,"2015",0,0,1,1
210350,"2016",1,0,1,2
210350,"2017",0,0,2,2
210350,"2018",0,0,3,3
210350,"2019",2,0,7,9
210350,"2020",5,2,23,30
210350,"2021",6,1,7,14
210350,"2022",1,0,7,8
210350,"2023",4,0,0,4
210355,"2015",2,0,10,12
210355,"2016",4,0,8,12
210355,"2017",4,0,7,11
210355,"2018",4,0,9,13
210355,"2019",3,0,8,11
210355,"2020",3,0,10,13
210355,"2021",0,0,4,4
210355,"2022",1,0,6,7
210355,"2023",0,0,4,4
210360,"2015",13,5,65,83
210360,"2016",8,6,55,69
210360,"2017",14,2,50,66
210360,"2018",23,6,55,84
210360,"2019",31,5,75,111
210360,"2020",22,5,48,75
210360,"2021",37,9,66,112
210360,"2022",19,2,29,50
210360,"2023",24,5,39,68
210370,"2015",1,0,2,3
210370,"2016",1,0,0,1
210370,"2017",0,0,2,2
210370,"2018",0,0,5,5
210370,"2020",0,0,1,1
210370,"2021",1,0,2,3
210370,"2022",0,1,2,3
210370,"2023",0,0,3,3
210375,"2015",2,0,10,12
210375,"2016",3,0,11,14
210375,"2017",1,0,5,6
210375,"2018",2,0,10,12
210375,"2019",2,0,7,9
210375,"2020",5,1,6,12
210375,"2021",0,0,7,7
210375,"2022",5,0,4,9
210375,"2023",2,0,5,7
210380,"2015",0,0,1,1
210380,"2017",2,0,0,2
210380,"2018",5,0,7,12
210380,"2019",2,1,6,9
210380,"2020",4,0,7,11
210380,"2021",1,0,2,3
210380,"2022",2,0,3,5
210380,"2023",1,0,3,4
210390,"2015",3,1,5,9
210390,"2016",1,0,4,5
210390,"2017",3,0,8,11
210390,"2018",3,0,4,7
210390,"2019",4,2,8,14
210390,"2020",2,1,7,10
210390,"2021",2,1,7,10
210390,"2022",2,0,9,11
210390,"2023",3,1,10,14
210400,"2015",4,1,17,22
210400,"2016",5,2,15,22
210400,"2017",5,1,13,19
210400,"2018",10,1,16,27
210400,"2019",4,1,14,19
210400,"2020",7,2,9,18
210400,"2021",1,0,15,16
210400,"2022",4,0,9,13
210400,"2023",4,0,2,6
210405,"2015",5,2,16,23
210405,"2016",4,0,10,14
210405,"2017",12,0,37,49
210405,"2018",6,0,10,16
210405,"2019",4,1,6,11
210405,"2020",1,0,1,2
210405,"2021",9,0,10,19
210405,"2022",11,1,19,31
210405,"2023",8,0,14,22
210407,"2015",2,0,3,5
210407,"2018",1,1,3,5
210407,"2019",7,0,3,10
210407,"2020",0,1,5,6
210407,"2021",0,0,4,4
210407,"2022",1,0,2,3
210407,"2023",3,0,5,8
210408,"2015",2,0,11,13
210408,"2016",4,0,7,11
210408,"2017",2,0,8,10
210408,"2018",5,0,12,17
210408,"2019",4,1,8,13
210408,"2020",2,3,13,18
210408,"2021",1,0,2,3
210408,"2023",0,1,0,1
210409,"2015",0,0,1,1
210409,"2016",1,0,2,3
210409,"2017",4,0,0,4
210409,"2018",1,4,17,22
210409,"2019",1,3,13,17
210409,"2020",7,2,9,18
210409,"2021",3,0,8,11
210409,"2022",2,1,6,9
210409,"2023",1,2,9,12
210410,"2017",0,0,6,6
210410,"2018",1,2,2,5
210410,"2019",1,1,8,10
210410,"2020",3,0,9,12
210410,"2021",6,2,6,14
210410,"2022",2,1,7,10
210410,"2023",2,1,6,9
210420,"2015",0,0,6,6
210420,"2016",2,1,4,7
210420,"2017",0,0,5,5
210420,"2018",3,1,5,9
210420,"2019",1,0,3,4
210420,"2020",0,0,4,4
210420,"2021",1,0,10,11
210420,"2022",0,0,1,1
210420,"2023",1,0,0,1
210430,"2015",0,0,2,2
210430,"2016",0,0,4,4
210430,"2017",0,0,6,6
210430,"2018",0,0,2,2
210430,"2019",0,0,2,2
210430,"2020",0,0,5,5
210430,"2021",5,0,7,12
210430,"2022",3,0,3,6
210430,"2023",1,0,3,4
210440,"2015",0,0,2,2
210440,"2016",0,0,1,1
210440,"2017",2,0,6,8
210440,"2018",0,0,4,4
210440,"2019",3,1,6,10
210440,"2020",2,1,3,6
210440,"2021",1,0,2,3
210440,"2022",1,0,2,3
210440,"2023",0,0,1,1
210450,"2015",0,0,2,2
210450,"2016",1,0,2,3
210450,"2017",1,0,3,4
210450,"2018",2,0,4,6
210450,"2019",1,0,2,3
210450,"2020",0,0,4,4
210450,"2021",0,0,4,4
210450,"2022",2,1,0,3
210450,"2023",0,0,2,2
210455,"2015",5,0,13,18
210455,"2016",2,0,10,12
210455,"2017",3,0,13,16
210455,"2018",5,0,11,16
210455,"2019",1,1,12,14
210455,"2020",4,0,8,12
210455,"2021",4,0,3,7
210455,"2022",2,0,8,10
210455,"2023",1,2,7,10
210460,"2015",0,0,1,1
210460,"2016",0,0,2,2
210460,"2017",6,0,10,16
210460,"2018",4,1,10,15
210460,"2019",6,1,9,16
210460,"2020",2,4,9,15
210460,"2022",0,0,1,1
210460,"2023",0,0,1,1
210462,"2016",0,1,1,2
210462,"2017",0,0,1,1
210462,"2018",0,0,1,1
210462,"2019",1,0,2,3
210462,"2021",0,1,0,1
210462,"2022",0,0,3,3
210465,"2016",0,0,1,1
210465,"2017",1,0,2,3
210465,"2018",3,2,2,7
210465,"2019",1,2,4,7
210465,"2020",6,0,3,9
210465,"2021",2,0,5,7
210465,"2022",2,0,0,2
210465,"2023",2,0,3,5
210467,"2015",15,0,33,48
210467,"2016",1,0,37,38
210467,"2017",8,4,29,41
210467,"2018",8,3,21,32
210467,"2019",13,2,28,43
210467,"2020",12,3,28,43
210467,"2021",11,5,24,40
210467,"2022",3,2,25,30
210467,"2023",7,0,14,21
210470,"2015",0,0,3,3
210470,"2016",1,0,1,2
210470,"2017",1,0,2,3
210470,"2018",1,0,3,4
210470,"2020",0,1,1,2
210470,"2021",1,0,0,1
210470,"2022",0,0,2,2
210480,"2015",11,1,44,56
210480,"2016",34,4,90,128
210480,"2017",49,7,104,160
210480,"2018",41,6,86,133
210480,"2019",31,7,80,118
210480,"2020",38,8,86,132
210480,"2021",43,5,100,148
210480,"2022",35,16,73,124
210480,"2023",42,4,46,92
210490,"2016",2,0,0,2
210490,"2017",0,1,1,2
210490,"2018",0,0,1,1
210490,"2020",1,0,0,1
210490,"2021",1,0,1,2
210490,"2022",0,0,1,1
210490,"2023",0,1,0,1
210500,"2015",0,0,5,5
210500,"2016",3,1,4,8
210500,"2017",0,0,7,7
210500,"2018",3,1,12,16
210500,"2019",6,0,13,19
210500,"2020",6,0,10,16
210500,"2021",1,0,9,10
210500,"2022",3,0,9,12
210500,"2023",1,0,12,13
210510,"2015",3,0,11,14
210510,"2016",2,0,2,4
210510,"2017",3,0,5,8
210510,"2018",1,0,4,5
210510,"2019",3,0,10,13
210510,"2020",0,1,6,7
210510,"2021",0,0,1,1
210510,"2022",2,1,3,6
210510,"2023",3,0,7,10
210515,"2015",5,1,6,12
210515,"2016",0,0,6,6
210515,"2017",2,0,4,6
210515,"2018",5,2,13,20
210515,"2019",6,0,15,21
210515,"2020",9,0,7,16
210515,"2021",4,4,18,26
210515,"2022",1,0,2,3
210515,"2023",0,0,1,1
210520,"2015",0,0,6,6
210520,"2016",1,0,2,3
210520,"2017",10,0,5,15
210520,"2018",4,0,7,11
210520,"2019",1,0,5,6
210520,"2020",2,1,5,8
210520,"2021",1,1,2,4
210520,"2022",1,0,1,2
210520,"2023",1,0,1,2
210530,"2015",66,12,207,285
210530,"2016",80,18,167,265
210530,"2017",70,9,208,287
210530,"2018",99,11,207,317
210530,"2019",78,17,156,251
210530,"2020",62,12,125,199
210530,"2021",65,8,117,190
210530,"2022",47,9,94,150
210530,"2023",43,13,110,166
210535,"2015",1,0,6,7
210535,"2016",1,0,3,4
210535,"2017",5,1,7,13
210535,"2018",2,1,8,11
210535,"2019",1,0,6,7
210535,"2020",3,1,5,9
210535,"2021",1,0,10,11
210535,"2022",2,1,5,8
210535,"2023",1,0,5,6
210540,"2015",38,8,107,153
210540,"2016",39,9,75,123
210540,"2017",19,4,47,70
210540,"2018",28,6,63,97
210540,"2019",18,5,64,87
210540,"2020",21,2,54,77
210540,"2021",25,7,64,96
210540,"2022",28,3,59,90
210540,"2023",19,4,40,63
210542,"2015",4,2,20,26
210542,"2016",3,0,15,18
210542,"2017",4,0,14,18
210542,"2018",1,0,7,8
210542,"2019",7,0,10,17
210542,"2020",0,1,6,7
210542,"2021",2,0,3,5
210542,"2022",1,0,5,6
210542,"2023",3,0,1,4
210545,"2019",0,0,1,1
210545,"2020",3,0,1,4
210545,"2021",0,0,4,4
210545,"2022",1,0,0,1
210547,"2015",8,1,9,18
210547,"2016",3,3,13,19
210547,"2017",8,1,18,27
210547,"2018",6,2,13,21
210547,"2019",5,1,8,14
210547,"2020",2,3,13,18
210547,"2021",1,0,1,2
210547,"2022",1,0,1,2
210547,"2023",0,0,2,2
210550,"2015",8,1,23,32
210550,"2016",1,0,17,18
210550,"2017",5,2,8,15
210550,"2018",7,0,13,20
210550,"2019",4,1,13,18
210550,"2020",0,1,14,15
210550,"2021",1,0,7,8
210550,"2022",6,0,10,16
210550,"2023",4,0,4,8
210560,"2015",1,0,3,4
210560,"2016",1,1,8,10
210560,"2017",1,1,3,5
210560,"2018",3,0,2,5
210560,"2019",0,0,3,3
210560,"2020",1,1,3,5
210560,"2021",0,1,0,1
210560,"2022",1,0,4,5
210560,"2023",0,0,3,3
210565,"2015",4,0,3,7
210565,"2016",0,0,5,5
210565,"2017",0,1,7,8
210565,"2018",3,0,5,8
210565,"2019",3,2,4,9
210565,"2020",5,0,7,12
210565,"2021",1,1,3,5
210565,"2022",3,0,3,6
210565,"2023",1,0,0,1
210570,"2015",10,3,30,43
210570,"2016",16,1,41,58
210570,"2017",9,3,58,70
210570,"2018",7,3,37,47
210570,"2019",7,2,33,42
210570,"2020",10,2,40,52
210570,"2021",13,5,25,43
210570,"2022",11,4,28,43
210570,"2023",21,1,32,54
210580,"2015",2,0,8,10
210580,"2016",1,0,3,4
210580,"2017",3,0,2,5
210580,"2018",4,1,9,14
210580,"2019",0,0,5,5
210580,"2020",3,1,5,9
210580,"2021",1,0,3,4
210580,"2022",0,0,4,4
210580,"2023",1,0,1,2
210590,"2015",0,1,12,13
210590,"2016",0,1,11,12
210590,"2017",1,0,9,10
210590,"2018",1,0,12,13
210590,"2019",2,0,12,14
210590,"2020",4,0,8,12
210590,"2021",1,0,7,8
210590,"2022",3,1,5,9
210590,"2023",3,1,3,7
210592,"2015",0,1,2,3
210592,"2016",0,1,3,4
210592,"2017",0,0,1,1
210592,"2018",1,0,1,2
210592,"2019",1,0,0,1
210592,"2020",1,0,1,2
210592,"2021",0,1,1,2
210592,"2022",1,0,4,5
210594,"2015",1,0,3,4
210594,"2016",0,0,3,3
210594,"2017",1,0,3,4
210594,"2018",2,0,6,8
210594,"2019",2,0,3,5
210594,"2020",0,0,2,2
210594,"2021",1,0,1,2
210594,"2022",3,0,3,6
210594,"2023",3,1,5,9
210596,"2015",1,0,3,4
210596,"2016",0,0,1,1
210596,"2017",1,0,2,3
210596,"2018",0,0,4,4
210596,"2019",0,0,5,5
210596,"2020",0,0,1,1
210596,"2021",0,0,5,5
210596,"2022",5,0,10,15
210596,"2023",1,1,5,7
210598,"2015",1,0,4,5
210598,"2016",0,0,3,3
210598,"2017",1,0,1,2
210598,"2018",5,0,4,9
210598,"2019",2,0,3,5
210598,"2020",0,0,3,3
210598,"2021",1,0,1,2
210600,"2015",3,0,13,16
210600,"2016",0,0,9,9
210600,"2017",3,0,4,7
210600,"2018",2,0,4,6
210600,"2019",1,0,7,8
210600,"2020",1,0,8,9
210600,"2021",0,0,3,3
210600,"2022",4,0,4,8
210600,"2023",0,0,5,5
210610,"2017",2,0,2,4
210610,"2018",2,0,5,7
210610,"2019",0,0,7,7
210610,"2020",1,0,8,9
210610,"2021",2,2,6,10
210610,"2022",4,1,2,7
210610,"2023",4,0,3,7
210620,"2015",2,0,4,6
210620,"2016",0,0,3,3
210620,"2017",1,0,5,6
210620,"2018",2,0,2,4
210620,"2019",0,0,3,3
210620,"2020",3,0,0,3
210620,"2021",0,0,2,2
210620,"2022",1,0,4,5
210620,"2023",1,0,1,2
210630,"2015",2,0,1,3
210630,"2016",3,0,5,8
210630,"2017",1,0,2,3
210630,"2018",2,0,6,8
210630,"2019",3,0,9,12
210630,"2020",1,1,5,7
210630,"2021",3,2,8,13
210630,"2022",2,1,10,13
210630,"2023",4,1,3,8
210632,"2015",3,0,30,33
210632,"2016",9,1,21,31
210632,"2017",8,0,20,28
210632,"2018",7,0,19,26
210632,"2019",3,1,15,19
210632,"2020",13,1,26,40
210632,"2021",3,1,15,19
210632,"2022",7,1,13,21
210632,"2023",2,0,9,11
210635,"2015",0,0,3,3
210635,"2016",1,1,2,4
210635,"2017",1,0,2,3
210635,"2018",0,0,2,2
210635,"2019",2,0,1,3
210635,"2020",2,1,7,10
210635,"2021",1,0,3,4
210635,"2022",0,0,1,1
210635,"2023",2,0,3,5
210637,"2015",5,2,14,21
210637,"2016",0,0,11,11
210637,"2017",3,1,11,15
210637,"2018",6,0,10,16
210637,"2019",3,1,11,15
210637,"2020",4,1,9,14
210637,"2021",5,0,7,12
210637,"2022",1,1,5,7
210637,"2023",0,2,5,7
210640,"2015",4,0,6,10
210640,"2016",3,0,8,11
210640,"2017",5,0,16,21
210640,"2018",12,1,18,31
210640,"2019",5,1,14,20
210640,"2020",6,0,9,15
210640,"2021",4,0,10,14
210640,"2022",4,0,8,12
210640,"2023",4,2,13,19
210650,"2015",2,0,10,12
210650,"2016",2,0,7,9
210650,"2017",1,0,9,10
210650,"2018",4,0,12,16
210650,"2019",2,0,7,9
210650,"2020",0,1,6,7
210650,"2021",1,0,4,5
210650,"2022",3,0,6,9
210650,"2023",3,0,6,9
210660,"2015",2,1,6,9
210660,"2016",6,1,9,16
210660,"2017",7,1,15,23
210660,"2018",7,0,17,24
210660,"2019",5,5,21,31
210660,"2020",4,1,17,22
210660,"2021",16,3,24,43
210660,"2022",5,2,14,21
210660,"2023",2,3,11,16
210663,"2016",0,0,1,1
210663,"2017",0,0,5,5
210663,"2018",1,0,3,4
210663,"2019",2,1,5,8
210663,"2020",1,0,2,3
210663,"2021",1,1,7,9
210663,"2022",6,0,1,7
210663,"2023",2,0,1,3
210667,"2015",1,2,0,3
210667,"2016",0,0,4,4
210667,"2017",1,2,3,6
210667,"2018",4,0,1,5
210667,"2019",2,0,2,4
210667,"2020",2,0,4,6
210667,"2021",1,0,2,3
210667,"2022",0,0,2,2
210670,"2015",0,0,2,2
210670,"2016",0,0,2,2
210670,"2017",1,0,1,2
210670,"2019",1,1,2,4
210670,"2020",1,0,9,10
210670,"2021",3,0,4,7
210670,"2022",4,2,6,12
210670,"2023",2,0,0,2
210675,"2015",3,0,8,11
210675,"2016",5,0,11,16
210675,"2017",4,0,6,10
210675,"2018",3,1,16,20
210675,"2019",7,0,16,23
210675,"2020",5,0,9,14
210675,"2021",4,2,10,16
210675,"2022",6,1,10,17
210675,"2023",5,0,7,12
210680,"2015",0,1,1,2
210680,"2016",0,0,2,2
210680,"2017",0,0,1,1
210680,"2021",1,0,0,1
210680,"2022",1,0,0,1
210680,"2023",0,1,1,2
210690,"2015",7,0,22,29
210690,"2016",9,1,24,34
210690,"2017",8,1,26,35
210690,"2018",10,1,22,33
210690,"2019",9,3,18,30
210690,"2020",5,1,15,21
210690,"2021",7,0,19,26
210690,"2022",3,0,1,4
210700,"2015",3,0,4,7
210700,"2016",3,0,3,6
210700,"2017",3,1,2,6
210700,"2018",2,0,2,4
210700,"2019",4,0,7,11
210700,"2020",2,0,4,6
210700,"2021",0,0,5,5
210700,"2022",0,0,1,1
210700,"2023",1,0,2,3
210710,"2015",0,0,2,2
210710,"2016",0,1,0,1
210710,"2017",0,0,1,1
210710,"2018",1,0,1,2
210710,"2019",2,0,9,11
210710,"2020",1,2,7,10
210710,"2021",1,0,12,13
210710,"2022",1,0,5,6
210710,"2023",1,2,4,7
210720,"2015",3,1,6,10
210720,"2016",3,1,7,11
210720,"2017",3,0,3,6
210720,"2018",3,0,3,6
210720,"2019",2,0,6,8
210720,"2020",4,0,5,9
210720,"2021",0,1,7,8
210720,"2022",6,1,9,16
210720,"2023",2,0,10,12
210725,"2015",0,0,1,1
210725,"2016",1,0,1,2
210725,"2019",1,4,4,9
210725,"2020",1,0,3,4
210725,"2021",3,1,3,7
210725,"2022",1,1,3,5
210725,"2023",0,0,4,4
210730,"2017",1,0,0,1
210730,"2018",0,0,2,2
210730,"2020",0,0,2,2
210730,"2021",0,0,1,1
210730,"2022",0,0,1,1
210735,"2015",0,0,1,1
210735,"2016",1,0,2,3
210735,"2017",2,1,2,5
210735,"2018",2,0,16,18
210735,"2019",4,0,8,12
210735,"2020",2,1,5,8
210735,"2021",1,0,7,8
210735,"2022",2,1,8,11
210735,"2023",0,0,10,10
210740,"2015",1,1,7,9
210740,"2016",0,0,4,4
210740,"2017",0,0,7,7
210740,"2018",1,0,4,5
210740,"2019",0,0,7,7
210740,"2020",1,1,4,6
210740,"2021",1,0,6,7
210740,"2022",1,1,3,5
210740,"2023",1,1,2,4
210745,"2015",4,0,10,14
210745,"2016",3,0,3,6
210745,"2017",4,1,7,12
210745,"2018",2,0,8,10
210745,"2019",1,0,12,13
210745,"2020",1,0,10,11
210745,"2021",1,1,10,12
210745,"2022",1,1,1,3
210745,"2023",1,0,3,4
210750,"2015",16,2,49,67
210750,"2016",10,4,25,39
210750,"2017",14,4,30,48
210750,"2018",26,6,38,70
210750,"2019",30,7,40,77
210750,"2020",17,3,37,57
210750,"2021",24,4,50,78
210750,"2022",37,4,58,99
210750,"2023",34,7,60,101
210760,"2015",0,0,14,14
210760,"2016",5,0,3,8
210760,"2017",2,0,8,10
210760,"2018",3,0,4,7
210760,"2019",9,0,14,23
210760,"2020",3,1,4,8
210760,"2021",1,0,2,3
210760,"2022",1,0,2,3
210760,"2023",1,0,4,5
210770,"2016",1,0,0,1
210770,"2017",1,2,6,9
210770,"2018",5,1,7,13
210770,"2019",6,2,7,15
210770,"2020",5,0,6,11
210770,"2021",4,1,8,13
210770,"2022",1,0,6,7
210770,"2023",2,0,3,5
210780,"2015",7,0,14,21
210780,"2016",11,1,16,28
210780,"2017",5,1,20,26
210780,"2018",2,2,20,24
210780,"2019",6,1,18,25
210780,"2020",9,3,9,21
210780,"2021",9,2,17,28
210780,"2022",10,2,18,30
210780,"2023",4,2,16,22
210790,"2015",2,0,4,6
210790,"2016",3,0,2,5
210790,"2017",0,1,1,2
210790,"2018",0,0,2,2
210790,"2019",5,0,3,8
210790,"2020",1,1,5,7
210790,"2021",2,0,3,5
210790,"2022",1,0,0,1
210800,"2016",0,0,2,2
210800,"2017",1,0,1,2
210800,"2018",1,0,0,1
210800,"2019",0,0,3,3
210800,"2020",5,1,6,12
210800,"2021",0,1,3,4
210800,"2022",0,0,3,3
210800,"2023",0,0,3,3
210805,"2015",3,1,9,13
210805,"2016",3,0,13,16
210805,"2017",2,0,6,8
210805,"2018",5,0,16,21
210805,"2019",3,0,17,20
210805,"2020",6,0,9,15
210805,"2021",8,3,18,29
210805,"2022",11,0,9,20
210805,"2023",5,2,14,21
210810,"2015",0,2,19,21
210810,"2016",6,1,17,24
210810,"2017",0,0,10,10
210810,"2018",3,1,11,15
210810,"2019",7,0,12,19
210810,"2020",9,1,11,21
210810,"2021",3,2,17,22
210810,"2022",7,1,23,31
210810,"2023",2,2,10,14
210820,"2015",11,1,37,49
210820,"2016",8,5,28,41
210820,"2017",11,1,53,65
210820,"2018",21,0,34,55
210820,"2019",10,3,21,34
210820,"2020",8,2,22,32
210820,"2021",5,2,19,26
210820,"2022",5,1,16,22
210820,"2023",1,0,10,11
210825,"2015",1,2,4,7
210825,"2016",1,0,3,4
210825,"2017",7,0,9,16
210825,"2018",6,0,10,16
210825,"2019",7,0,9,16
210825,"2020",4,0,9,13
210825,"2021",1,0,7,8
210825,"2022",4,0,3,7
210825,"2023",1,0,2,3
210830,"2015",0,0,1,1
210830,"2017",0,0,2,2
210830,"2018",1,0,1,2
210830,"2019",1,0,2,3
210830,"2020",1,0,1,2
210830,"2022",0,0,2,2
210840,"2015",1,0,5,6
210840,"2016",0,0,4,4
210840,"2017",0,0,5,5
210840,"2018",2,0,6,8
210840,"2019",3,0,2,5
210840,"2020",4,0,1,5
210840,"2021",0,0,3,3
210840,"2022",0,1,1,2
210840,"2023",2,0,3,5
210845,"2015",12,1,24,37
210845,"2016",3,1,15,19
210845,"2017",3,1,16,20
210845,"2018",8,0,14,22
210845,"2019",5,1,18,24
210845,"2020",4,2,14,20
210845,"2021",2,0,4,6
210845,"2022",2,2,16,20
210845,"2023",2,3,10,15
210850,"2015",4,1,27,32
210850,"2016",5,1,17,23
210850,"2017",11,0,9,20
210850,"2018",8,3,18,29
210850,"2019",11,0,25,36
210850,"2020",10,3,17,30
210850,"2021",9,3,33,45
210850,"2022",5,0,7,12
210850,"2023",0,0,1,1
210860,"2015",8,1,35,44
210860,"2016",14,2,49,65
210860,"2017",38,4,88,130
210860,"2018",31,3,82,116
210860,"2019",37,8,64,109
210860,"2020",23,5,50,78
210860,"2021",22,1,33,56
210860,"2022",15,1,19,35
210860,"2023",1,0,6,7
210870,"2015",1,0,11,12
210870,"2016",1,0,2,3
210870,"2017",4,1,5,10
210870,"2018",2,0,6,8
210870,"2019",6,1,8,15
210870,"2020",1,0,9,10
210870,"2021",9,0,6,15
210870,"2022",3,2,10,15
210870,"2023",1,0,9,10
210880,"2015",1,0,0,1
210880,"2016",1,0,3,4
210880,"2017",0,0,3,3
210880,"2018",0,0,2,2
210880,"2019",0,0,8,8
210880,"2020",1,0,3,4
210880,"2021",2,0,8,10
210880,"2022",1,0,3,4
210880,"2023",2,0,1,3
210890,"2015",1,0,2,3
210890,"2016",0,0,4,4
210890,"2017",1,1,0,2
210890,"2018",4,2,8,14
210890,"2019",2,0,7,9
210890,"2020",3,0,8,11
210890,"2021",4,0,5,9
210890,"2022",3,0,4,7
210890,"2023",2,1,4,7
210900,"2015",4,0,12,16
210900,"2016",6,0,15,21
210900,"2017",12,1,46,59
210900,"2018",14,4,38,56
210900,"2019",11,0,42,53
210900,"2020",3,1,17,21
210900,"2021",0,1,10,11
210900,"2022",0,0,1,1
210905,"2021",1,0,0,1
210910,"2015",24,1,66,91
210910,"2016",17,3,54,74
210910,"2017",9,0,34,43
210910,"2018",25,3,58,86
210910,"2019",13,4,34,51
210910,"2020",20,4,52,76
210910,"2021",10,2,31,43
210910,"2022",14,2,41,57
210910,"2023",6,1,13,20
210920,"2016",0,0,2,2
210920,"2017",1,0,3,4
210920,"2018",0,0,3,3
210920,"2019",0,0,1,1
210920,"2020",0,0,2,2
210920,"2021",0,0,5,5
210920,"2022",0,0,1,1
210920,"2023",0,0,2,2
210923,"2015",2,0,4,6
210923,"2016",2,1,7,10
210923,"2017",1,0,6,7
210923,"2018",1,0,6,7
210923,"2019",2,0,4,6
210923,"2020",3,0,8,11
210923,"2021",1,0,7,8
210923,"2022",0,1,2,3
210927,"2015",0,1,6,7
210927,"2016",2,0,4,6
210927,"2017",4,0,7,11
210927,"2018",6,0,15,21
210927,"2019",7,1,4,12
210927,"2020",5,1,6,12
210927,"2021",3,0,5,8
210927,"2022",1,0,6,7
210927,"2023",1,0,0,1
210930,"2015",3,0,1,4
210930,"2016",0,1,7,8
210930,"2017",2,1,6,9
210930,"2018",2,0,7,9
210930,"2019",2,0,4,6
210930,"2020",4,1,4,9
210930,"2021",1,2,11,14
210930,"2022",1,0,8,9
210930,"2023",2,1,4,7
210940,"2015",1,0,1,2
210940,"2016",1,0,7,8
210940,"2017",2,0,7,9
210940,"2018",0,0,2,2
210940,"2019",1,0,8,9
210940,"2020",0,0,4,4
210940,"2021",0,0,1,1
210940,"2022",3,2,2,7
210940,"2023",0,0,2,2
210945,"2015",2,0,11,13
210945,"2016",2,0,9,11
210945,"2017",5,0,15,20
210945,"2018",4,1,9,14
210945,"2019",5,1,18,24
210945,"2020",7,0,15,22
210945,"2021",4,1,11,16
210945,"2022",5,0,7,12
210945,"2023",2,1,7,10
210950,"2016",1,0,3,4
210950,"2017",1,0,2,3
210950,"2018",3,0,15,18
210950,"2019",3,1,12,16
210950,"2020",2,1,11,14
210950,"2021",7,2,17,26
210950,"2022",4,1,16,21
210950,"2023",7,0,13,20
210955,"2015",2,0,4,6
210955,"2016",3,0,3,6
210955,"2017",2,1,5,8
210955,"2018",2,1,4,7
210955,"2019",1,0,5,6
210955,"2022",1,1,0,2
210955,"2023",0,0,1,1
210960,"2015",3,0,6,9
210960,"2016",6,1,8,15
210960,"2017",4,0,10,14
210960,"2018",7,1,8,16
210960,"2019",3,2,17,22
210960,"2020",8,2,17,27
210960,"2021",3,2,11,16
210960,"2022",1,0,13,14
210960,"2023",8,0,2,10
210970,"2015",0,0,1,1
210970,"2016",0,0,1,1
210970,"2017",0,0,2,2
210970,"2018",1,0,3,4
210970,"2019",0,0,2,2
210970,"2020",2,0,2,4
210970,"2021",5,0,6,11
210970,"2022",1,0,1,2
210970,"2023",1,0,0,1
210975,"2015",0,0,3,3
210975,"2016",0,0,1,1
210975,"2017",0,1,2,3
210975,"2018",3,0,2,5
210975,"2019",0,0,1,1
210975,"2020",1,0,3,4
210975,"2021",0,0,1,1
210975,"2022",2,0,1,3
210980,"2015",11,2,32,45
210980,"2016",4,1,17,22
210980,"2017",6,1,31,38
210980,"2018",16,2,21,39
210980,"2019",6,0,36,42
210980,"2020",12,1,25,38
210980,"2021",6,0,18,24
210980,"2022",9,0,13,22
210980,"2023",3,0,15,18
210990,"2015",44,6,111,161
210990,"2016",21,5,56,82
210990,"2017",44,7,89,140
210990,"2018",38,15,125,178
210990,"2019",61,13,146,220
210990,"2020",48,9,125,182
210990,"2021",105,13,188,306
210990,"2022",6,3,32,41
210990,"2023",1,1,4,6
211000,"2015",15,4,18,37
211000,"2016",16,4,33,53
211000,"2017",18,2,49,69
211000,"2018",21,0,40,61
211000,"2019",16,4,39,59
211000,"2020",23,3,35,61
211000,"2021",14,3,34,51
211000,"2022",10,3,36,49
211000,"2023",7,0,20,27
211003,"2015",6,1,15,22
211003,"2016",1,0,9,10
211003,"2017",4,0,16,20
211003,"2018",7,0,15,22
211003,"2019",5,2,21,28
211003,"2020",8,0,16,24
211003,"2021",6,1,21,28
211003,"2022",5,2,12,19
211003,"2023",2,1,12,15
211010,"2015",3,4,24,31
211010,"2016",8,3,15,26
211010,"2017",11,2,25,38
211010,"2018",14,2,25,41
211010,"2019",6,2,25,33
211010,"2020",8,1,21,30
211010,"2021",12,1,21,34
211010,"2022",14,5,24,43
211010,"2023",5,5,23,33
211020,"2015",4,2,33,39
211020,"2016",6,1,18,25
211020,"2017",17,7,31,55
211020,"2018",14,4,31,49
211020,"2019",9,2,24,35
211020,"2020",4,4,21,29
211020,"2021",11,1,13,25
211020,"2022",5,0,13,18
211020,"2023",7,3,12,22
211023,"2015",1,0,2,3
211023,"2016",2,0,1,3
211023,"2017",1,0,4,5
211023,"2018",0,0,2,2
211023,"2019",2,0,3,5
211023,"2020",1,0,2,3
211023,"2021",1,0,4,5
211023,"2022",0,0,3,3
211023,"2023",0,0,1,1
211027,"2015",1,0,0,1
211027,"2016",1,0,5,6
211027,"2017",2,0,3,5
211027,"2018",1,0,5,6
211027,"2019",1,1,6,8
211027,"2020",1,1,4,6
211027,"2021",2,1,7,10
211027,"2022",0,0,4,4
211027,"2023",1,1,1,3
211030,"2015",2,0,3,5
211030,"2016",1,1,4,6
211030,"2017",4,0,6,10
211030,"2018",3,0,8,11
211030,"2019",1,0,9,10
211030,"2020",3,1,4,8
211030,"2022",0,0,2,2
211030,"2023",0,1,2,3
211040,"2015",4,0,7,11
211040,"2016",2,0,4,6
211040,"2017",5,0,10,15
211040,"2018",5,0,14,19
211040,"2019",5,2,10,17
211040,"2020",4,0,10,14
211040,"2021",2,3,10,15
211040,"2022",5,0,6,11
211040,"2023",0,1,9,10
211050,"2015",2,0,10,12
211050,"2016",0,0,6,6
211050,"2017",12,2,21,35
211050,"2018",7,0,16,23
211050,"2019",4,0,15,19
211050,"2020",4,2,15,21
211050,"2021",6,2,16,24
211050,"2022",7,1,15,23
211050,"2023",5,0,6,11
211060,"2015",3,1,21,25
211060,"2016",3,1,3,7
211060,"2017",4,2,11,17
211060,"2018",2,1,8,11
211060,"2019",11,2,12,25
211060,"2020",9,0,15,24
211060,"2021",5,0,13,18
211060,"2022",3,0,9,12
211060,"2023",4,0,6,10
211065,"2016",2,0,0,2
211065,"2017",0,0,1,1
211065,"2018",0,0,3,3
211065,"2019",0,0,2,2
211065,"2020",1,0,0,1
211065,"2021",0,0,1,1
211065,"2022",1,0,2,3
211070,"2015",6,0,15,21
211070,"2016",7,3,16,26
211070,"2017",0,1,0,1
211070,"2018",0,0,2,2
211070,"2019",5,1,10,16
211070,"2020",3,1,2,6
211070,"2021",0,0,3,3
211070,"2022",18,3,15,36
211070,"2023",7,1,17,25
211080,"2018",1,0,3,4
211080,"2020",1,1,4,6
211080,"2021",0,0,3,3
211080,"2022",0,0,1,1
211085,"2015",2,0,7,9
211085,"2016",1,0,8,9
211085,"2017",2,0,7,9
211085,"2018",1,1,3,5
211085,"2019",3,0,2,5
211085,"2020",1,0,2,3
211085,"2021",1,0,4,5
211085,"2022",1,0,2,3
211085,"2023",1,0,2,3
211090,"2015",0,0,3,3
211090,"2016",1,0,3,4
211090,"2017",1,1,7,9
211090,"2018",0,0,3,3
211090,"2019",2,0,6,8
211090,"2020",2,0,9,11
211090,"2021",4,0,4,8
211090,"2022",4,0,4,8
211090,"2023",1,0,2,3
211100,"2015",1,0,2,3
211100,"2016",2,0,7,9
211100,"2017",3,0,9,12
211100,"2018",3,0,5,8
211100,"2019",0,0,3,3
211100,"2020",2,0,3,5
211100,"2021",0,0,2,2
211100,"2022",0,0,2,2
211102,"2015",2,0,4,6
211102,"2016",0,0,6,6
211102,"2017",2,0,7,9
211102,"2018",5,0,9,14
211102,"2019",4,0,5,9
211102,"2020",0,2,7,9
211102,"2021",2,1,18,21
211102,"2022",3,3,8,14
211102,"2023",1,0,4,5
211105,"2015",2,0,4,6
211105,"2016",2,1,2,5
211105,"2017",4,0,5,9
211105,"2018",1,2,2,5
211105,"2019",2,0,10,12
211105,"2020",0,0,3,3
211105,"2023",0,0,1,1
211107,"2017",1,0,5,6
211107,"2018",4,0,3,7
211107,"2019",5,2,16,23
211107,"2020",6,1,14,21
211107,"2021",4,2,13,19
211107,"2022",3,1,14,18
211107,"2023",4,2,10,16
211110,"2015",0,1,0,1
211110,"2016",1,0,2,3
211110,"2017",1,1,1,3
211110,"2018",0,1,1,2
211110,"2019",0,2,2,4
211110,"2020",8,2,5,15
211110,"2021",4,0,6,10
211110,"2022",3,0,5,8
211110,"2023",1,3,0,4
211120,"2015",34,5,117,156
211120,"2016",25,3,72,100
211120,"2017",33,7,98,138
211120,"2018",32,8,84,124
211120,"2019",57,8,99,164
211120,"2020",58,10,91,159
211120,"2021",82,11,119,212
211120,"2022",67,11,120,198
211120,"2023",70,9,108,187
211125,"2015",1,0,0,1
211125,"2016",0,0,1,1
211125,"2017",2,0,1,3
211125,"2018",1,1,3,5
211125,"2019",0,0,3,3
211125,"2020",0,0,3,3
211130,"2015",221,26,482,729
211130,"2016",220,30,520,770
211130,"2017",252,52,553,857
211130,"2018",297,44,508,849
211130,"2019",341,48,583,972
211130,"2020",300,53,478,831
211130,"2021",280,58,446,784
211130,"2022",259,45,424,728
211130,"2023",178,31,304,513
211140,"2015",6,0,10,16
211140,"2016",0,2,12,14
211140,"2017",3,0,14,17
211140,"2018",3,0,12,15
211140,"2019",4,0,11,15
211140,"2020",3,0,11,14
211140,"2021",4,0,4,8
211140,"2022",2,0,6,8
211140,"2023",4,0,6,10
211150,"2015",14,1,36,51
211150,"2016",11,2,27,40
211150,"2017",13,1,31,45
211150,"2018",17,0,30,47
211150,"2019",18,1,46,65
211150,"2020",17,5,40,62
211150,"2021",9,5,45,59
211150,"2022",18,2,38,58
211150,"2023",4,3,17,24
211153,"2015",1,0,3,4
211153,"2016",1,0,1,2
211153,"2017",1,0,3,4
211153,"2018",3,0,3,6
211153,"2019",2,0,1,3
211153,"2020",3,2,2,7
211153,"2021",0,0,4,4
211153,"2022",0,1,5,6
211153,"2023",1,0,1,2
211157,"2016",0,0,1,1
211157,"2019",0,1,3,4
211157,"2020",0,0,3,3
211157,"2021",2,1,4,7
211157,"2022",2,0,3,5
211157,"2023",1,0,2,3
211160,"2015",1,0,0,1
211160,"2016",0,0,1,1
211160,"2017",0,0,4,4
211160,"2018",4,0,7,11
211160,"2019",1,1,15,17
211160,"2020",4,0,17,21
211160,"2021",4,0,15,19
211160,"2022",3,0,10,13
211160,"2023",1,1,14,16
211163,"2015",1,0,2,3
211163,"2016",0,1,5,6
211163,"2017",0,0,3,3
211163,"2018",1,0,0,1
211163,"2019",0,0,3,3
211163,"2020",0,0,1,1
211163,"2021",0,1,0,1
211167,"2015",4,0,3,7
211167,"2016",1,0,4,5
211167,"2017",3,0,2,5
211167,"2018",0,0,3,3
211167,"2019",0,0,3,3
211167,"2020",1,0,1,2
211167,"2023",0,0,1,1
211170,"2016",0,0,4,4
211170,"2017",0,0,2,2
211170,"2018",2,0,11,13
211170,"2019",0,0,2,2
211170,"2020",1,0,2,3
211170,"2021",0,0,2,2
211170,"2022",1,0,3,4
211170,"2023",1,0,4,5
211172,"2015",0,0,3,3
211172,"2016",0,0,2,2
211172,"2017",0,0,1,1
211172,"2018",1,0,1,2
211172,"2019",0,0,3,3
211172,"2020",1,0,5,6
211172,"2021",0,0,2,2
211172,"2022",1,0,2,3
211172,"2023",2,0,4,6
211174,"2016",1,0,2,3
211174,"2017",0,0,3,3
211174,"2018",1,1,3,5
211174,"2019",1,0,1,2
211174,"2020",1,0,1,2
211174,"2021",0,0,5,5
211174,"2022",4,0,1,5
211174,"2023",0,1,1,2
211176,"2015",1,0,10,11
211176,"2016",1,0,5,6
211176,"2017",2,0,6,8
211176,"2018",2,0,10,12
211176,"2019",3,1,1,5
211176,"2020",4,0,4,8
211176,"2021",4,1,9,14
211176,"2022",5,2,1,8
211176,"2023",2,0,4,6
211178,"2015",2,0,1,3
211178,"2021",0,0,1,1
211180,"2015",1,0,3,4
211180,"2016",2,1,6,9
211180,"2017",6,0,4,10
211180,"2018",5,2,9,16
211180,"2019",4,2,10,16
211180,"2020",6,0,8,14
211180,"2021",9,1,14,24
211180,"2022",2,1,8,11
211180,"2023",2,0,3,5
211190,"2017",0,1,4,5
211190,"2018",2,0,2,4
211190,"2019",0,0,1,1
211190,"2020",2,0,2,4
211190,"2021",3,1,3,7
211190,"2022",0,0,2,2
211190,"2023",0,0,1,1
211195,"2016",0,0,1,1
211195,"2018",0,0,1,1
211195,"2019",1,0,0,1
211195,"2020",2,0,2,4
211195,"2021",0,0,4,4
211195,"2022",0,0,2,2
211200,"2017",0,0,3,3
211200,"2018",2,0,4,6
211200,"2019",4,1,11,16
211200,"2020",5,2,7,14
211200,"2021",3,1,4,8
211200,"2022",4,4,8,16
211200,"2023",1,1,7,9
211210,"2015",8,0,36,44
211210,"2016",7,0,27,34
211210,"2017",4,0,10,14
211210,"2018",2,1,15,18
211210,"2019",6,0,25,31
211210,"2020",7,1,23,31
211210,"2021",11,3,21,35
211210,"2022",8,3,23,34
211210,"2023",0,1,5,6
211220,"2015",28,6,125,159
211220,"2016",50,8,158,216
211220,"2017",76,18,153,247
211220,"2018",92,23,242,357
211220,"2019",94,17,201,312
211220,"2020",81,18,198,297
211220,"2021",81,18,171,270
211220,"2022",92,22,161,275
211220,"2023",54,26,131,211
211223,"2015",4,2,21,27
211223,"2016",3,1,12,16
211223,"2017",3,0,9,12
211223,"2018",2,1,10,13
211223,"2019",4,0,7,11
211223,"2020",4,0,12,16
211223,"2021",5,1,13,19
211223,"2022",5,0,11,16
211223,"2023",1,0,9,10
211227,"2015",0,0,7,7
211227,"2016",0,0,2,2
211227,"2017",1,0,4,5
211227,"2018",3,0,7,10
211227,"2019",1,1,2,4
211227,"2020",2,0,6,8
211227,"2021",1,0,5,6
211227,"2022",0,0,1,1
211230,"2015",0,0,7,7
211230,"2016",1,0,5,6
211230,"2017",1,0,8,9
211230,"2018",2,0,8,10
211230,"2019",2,0,4,6
211230,"2020",3,0,6,9
211230,"2021",1,0,7,8
211230,"2022",2,0,1,3
211240,"2015",0,0,1,1
211240,"2016",0,0,1,1
211240,"2017",1,0,3,4
211240,"2018",0,0,2,2
211240,"2019",0,0,3,3
211240,"2021",2,3,13,18
211240,"2022",9,0,7,16
211240,"2023",3,1,8,12
211245,"2015",1,1,7,9
211245,"2016",1,1,7,9
211245,"2017",2,0,14,16
211245,"2018",3,1,11,15
211245,"2019",1,0,5,6
211245,"2020",3,0,5,8
211245,"2021",4,0,3,7
211245,"2022",2,0,6,8
211245,"2023",1,0,2,3
211250,"2015",3,1,29,33
211250,"2016",15,0,25,40
211250,"2017",9,2,28,39
211250,"2018",8,0,32,40
211250,"2019",10,0,30,40
211250,"2020",12,2,28,42
211250,"2021",21,0,24,45
211250,"2022",22,3,39,64
211250,"2023",13,2,47,62
211260,"2015",1,0,6,7
211260,"2016",4,1,11,16
211260,"2017",4,0,13,17
211260,"2018",4,0,18,22
211260,"2019",4,1,19,24
211260,"2020",4,1,15,20
211260,"2021",4,0,10,14
211260,"2022",3,0,7,10
211260,"2023",1,1,5,7
211270,"2015",11,0,55,66
211270,"2016",10,1,56,67
211270,"2017",18,0,47,65
211270,"2018",19,1,53,73
211270,"2019",16,1,39,56
211270,"2020",15,5,34,54
211270,"2021",16,5,35,56
211270,"2022",20,5,25,50
211270,"2023",5,0,14,19
211280,"2015",17,0,43,60
211280,"2016",15,2,52,69
211280,"2017",14,2,20,36
211280,"2018",11,0,25,36
211280,"2019",11,0,24,35
211280,"2020",7,0,17,24
211280,"2021",7,1,16,24
211280,"2022",26,3,34,63
211280,"2023",7,2,24,33
211285,"2015",1,0,2,3
211285,"2016",2,0,2,4
211285,"2017",1,0,0,1
211285,"2018",3,0,5,8
211285,"2019",2,2,4,8
211285,"2020",1,0,4,5
211285,"2021",1,0,4,5
211285,"2022",1,0,3,4
211285,"2023",1,0,0,1
211290,"2015",8,1,23,32
211290,"2016",6,1,17,24
211290,"2017",8,0,27,35
211290,"2018",9,2,22,33
211290,"2019",5,0,17,22
211290,"2020",8,1,14,23
211290,"2021",3,4,17,24
211290,"2022",5,1,5,11
211290,"2023",4,0,4,8
211300,"2015",10,0,27,37
211300,"2016",3,0,18,21
211300,"2017",6,1,32,39
211300,"2018",13,4,42,59
211300,"2019",13,2,34,49
211300,"2020",17,2,33,52
211300,"2021",13,3,50,66
211300,"2022",10,0,48,58
211300,"2023",5,1,16,22
211400,"2015",1,0,7,8
211400,"2016",2,0,23,25
211400,"2017",16,3,27,46
211400,"2018",14,4,30,48
211400,"2019",14,2,35,51
211400,"2020",12,3,35,50
211400,"2021",28,1,43,72
211400,"2022",21,3,47,71
211400,"2023",9,0,34,43
220005,"2015",2,0,0,2
220005,"2016",2,0,3,5
220005,"2017",0,0,1,1
220005,"2018",0,0,3,3
220005,"2019",0,0,3,3
220005,"2020",0,0,1,1
220005,"2021",0,1,1,2
220005,"2022",1,0,1,2
220005,"2023",2,0,3,5
220010,"2015",0,0,1,1
220010,"2016",0,0,1,1
220010,"2017",0,0,2,2
220010,"2018",0,1,3,4
220010,"2019",1,0,2,3
220010,"2020",1,0,1,2
220010,"2021",1,0,1,2
220010,"2022",1,0,3,4
220010,"2023",0,0,2,2
220020,"2015",7,0,11,18
220020,"2016",3,1,11,15
220020,"2017",2,3,3,8
220020,"2018",5,0,6,11
220020,"2019",4,0,7,11
220020,"2020",3,0,9,12
220020,"2021",2,0,5,7
220020,"2022",2,0,8,10
220020,"2023",3,0,3,6
220025,"2017",0,0,1,1
220025,"2018",0,0,3,3
220025,"2019",1,0,0,1
220025,"2022",1,0,1,2
220027,"2015",0,1,2,3
220027,"2016",1,1,0,2
220027,"2017",0,1,0,1
220027,"2018",0,0,3,3
220027,"2019",0,0,1,1
220027,"2020",1,0,0,1
220027,"2022",2,0,1,3
220027,"2023",0,0,1,1
220030,"2015",2,0,6,8
220030,"2016",2,0,6,8
220030,"2017",1,1,3,5
220030,"2018",3,0,3,6
220030,"2019",0,1,2,3
220030,"2020",2,2,5,9
220030,"2021",1,0,3,4
220030,"2022",1,1,3,5
220030,"2023",0,1,4,5
220040,"2015",10,2,20,32
220040,"2016",7,1,19,27
220040,"2017",11,2,23,36
220040,"2018",12,1,18,31
220040,"2019",17,3,24,44
220040,"2020",12,1,15,28
220040,"2021",6,2,11,19
220040,"2022",8,4,6,18
220040,"2023",5,0,4,9
220045,"2015",0,0,1,1
220045,"2020",0,0,2,2
220050,"2015",0,1,3,4
220050,"2016",2,2,12,16
220050,"2017",3,3,8,14
220050,"2018",9,1,11,21
220050,"2019",3,1,6,10
220050,"2020",4,0,6,10
220050,"2021",5,0,7,12
220050,"2022",0,1,10,11
220050,"2023",4,0,4,8
220060,"2015",2,1,2,5
220060,"2016",1,0,2,3
220060,"2017",0,0,6,6
220060,"2018",1,0,1,2
220060,"2019",0,0,3,3
220060,"2020",1,0,4,5
220060,"2021",2,1,3,6
220060,"2022",2,0,1,3
220070,"2015",2,1,2,5
220070,"2016",2,0,2,4
220070,"2017",2,0,6,8
220070,"2018",2,1,6,9
220070,"2019",1,1,6,8
220070,"2020",2,1,7,10
220070,"2021",1,0,5,6
220070,"2022",2,0,7,9
220070,"2023",3,1,5,9
220080,"2016",2,0,3,5
220080,"2017",1,0,1,2
220080,"2018",1,0,0,1
220080,"2019",2,0,4,6
220080,"2020",0,0,3,3
220080,"2021",2,0,0,2
220080,"2022",2,1,4,7
220080,"2023",2,0,2,4
220090,"2015",2,0,3,5
220090,"2016",1,0,3,4
220090,"2017",2,0,6,8
220090,"2018",2,0,2,4
220090,"2019",0,0,1,1
220090,"2020",1,0,2,3
220090,"2021",0,0,1,1
220090,"2022",2,0,3,5
220090,"2023",1,1,2,4
220095,"2021",2,0,0,2
220100,"2016",4,0,3,7
220100,"2017",0,0,3,3
220100,"2018",1,0,3,4
220100,"2019",1,0,0,1
220100,"2020",1,0,3,4
220100,"2021",3,0,5,8
220100,"2022",3,1,2,6
220100,"2023",1,0,3,4
220105,"2015",0,0,3,3
220105,"2016",0,0,2,2
220105,"2017",0,0,1,1
220105,"2018",1,0,3,4
220105,"2019",1,0,1,2
220105,"2020",3,1,3,7
220105,"2021",1,0,2,3
220105,"2022",0,0,1,1
220105,"2023",0,0,2,2
220110,"2015",0,0,3,3
220110,"2016",0,0,4,4
220110,"2017",1,1,13,15
220110,"2018",4,1,4,9
220110,"2019",4,1,3,8
220110,"2020",2,0,0,2
220110,"2021",1,0,0,1
220110,"2022",0,0,2,2
220110,"2023",2,0,3,5
220115,"2015",0,0,2,2
220115,"2016",0,0,1,1
220115,"2019",0,0,3,3
220115,"2020",0,0,1,1
220115,"2021",1,0,3,4
220115,"2022",2,0,2,4
220115,"2023",0,0,2,2
220117,"2015",1,1,1,3
220117,"2016",1,0,1,2
220117,"2017",0,0,3,3
220117,"2018",2,0,4,6
220117,"2019",1,0,4,5
220117,"2020",1,1,0,2
220117,"2021",0,0,3,3
220117,"2022",1,2,3,6
220117,"2023",1,0,3,4
220120,"2015",8,1,10,19
220120,"2016",8,1,25,34
220120,"2017",9,0,13,22
220120,"2018",10,3,20,33
220120,"2019",7,1,22,30
220120,"2020",9,0,14,23
220120,"2021",5,3,11,19
220120,"2022",10,1,13,24
220120,"2023",5,4,8,17
220130,"2015",0,0,2,2
220130,"2016",0,0,2,2
220130,"2017",1,0,0,1
220130,"2018",0,0,2,2
220130,"2020",0,0,1,1
220130,"2021",0,1,3,4
220130,"2023",2,0,0,2
220140,"2015",0,0,4,4
220140,"2016",0,1,7,8
220140,"2017",2,0,2,4
220140,"2018",1,1,2,4
220140,"2019",0,0,2,2
220140,"2020",3,1,1,5
220140,"2021",0,1,0,1
220140,"2022",0,0,1,1
220150,"2015",2,1,8,11
220150,"2016",2,1,5,8
220150,"2017",2,0,8,10
220150,"2018",1,0,6,7
220150,"2019",6,0,3,9
220150,"2020",3,0,15,18
220150,"2021",6,3,10,19
220150,"2022",5,2,6,13
220150,"2023",2,2,4,8
220155,"2015",0,0,1,1
220155,"2016",0,0,3,3
220155,"2018",0,1,1,2
220155,"2019",0,1,0,1
220155,"2020",0,1,0,1
220155,"2022",1,0,1,2
220157,"2016",0,0,1,1
220157,"2018",2,1,0,3
220157,"2019",0,0,2,2
220157,"2020",0,0,1,1
220157,"2022",2,0,0,2
220157,"2023",0,1,1,2
220160,"2015",2,0,2,4
220160,"2016",2,0,2,4
220160,"2017",1,0,2,3
220160,"2018",1,1,1,3
220160,"2019",0,0,1,1
220160,"2020",0,0,5,5
220160,"2021",0,0,4,4
220160,"2022",3,0,0,3
220160,"2023",0,0,3,3
220170,"2015",0,0,1,1
220170,"2016",1,0,2,3
220170,"2017",1,1,3,5
220170,"2018",2,0,4,6
220170,"2019",3,0,3,6
220170,"2020",2,1,1,4
220170,"2021",4,0,4,8
220170,"2022",0,0,5,5
220170,"2023",2,0,3,5
220173,"2015",2,0,3,5
220173,"2016",1,0,4,5
220173,"2017",1,1,3,5
220173,"2018",0,1,2,3
220173,"2019",1,0,0,1
220173,"2020",1,0,3,4
220173,"2021",2,0,5,7
220173,"2022",3,0,3,6
220173,"2023",1,0,2,3
220177,"2015",2,0,2,4
220177,"2016",0,1,3,4
220177,"2017",1,1,5,7
220177,"2018",2,1,2,5
220177,"2019",3,0,2,5
220177,"2020",3,0,1,4
220177,"2021",1,0,2,3
220177,"2022",1,1,0,2
220177,"2023",2,0,2,4
220180,"2015",0,0,1,1
220180,"2018",0,0,2,2
220180,"2019",1,0,0,1
220180,"2021",0,1,1,2
220180,"2022",2,0,2,4
220180,"2023",0,0,1,1
220190,"2015",6,3,8,17
220190,"2016",2,0,4,6
220190,"2018",3,1,5,9
220190,"2019",3,1,4,8
220190,"2020",0,0,6,6
220190,"2021",1,0,0,1
220190,"2022",0,0,3,3
220191,"2015",1,0,2,3
220191,"2016",0,0,1,1
220191,"2017",0,0,2,2
220191,"2018",2,0,4,6
220191,"2019",1,0,4,5
220191,"2020",1,0,5,6
220191,"2021",0,0,2,2
220191,"2022",0,1,5,6
220191,"2023",2,0,2,4
220192,"2015",2,0,2,4
220192,"2016",2,1,4,7
220192,"2017",1,0,6,7
220192,"2018",0,0,3,3
220192,"2019",0,0,1,1
220192,"2020",0,1,3,4
220192,"2021",2,0,3,5
220192,"2022",1,0,2,3
220192,"2023",2,0,2,4
220194,"2015",0,0,2,2
220194,"2016",0,0,3,3
220194,"2017",2,0,2,4
220194,"2018",3,1,2,6
220194,"2019",1,0,2,3
220194,"2020",1,0,2,3
220194,"2021",7,0,0,7
220194,"2022",1,1,3,5
220196,"2015",3,0,5,8
220196,"2016",1,0,3,4
220196,"2017",2,0,3,5
220196,"2018",1,0,4,5
220196,"2019",6,0,1,7
220196,"2020",1,1,3,5
220196,"2021",0,1,4,5
220196,"2022",2,0,2,4
220196,"2023",1,2,2,5
220198,"2016",0,0,2,2
220198,"2017",1,0,0,1
220198,"2018",0,0,1,1
220198,"2019",1,0,0,1
220198,"2020",1,0,4,5
220198,"2021",1,0,0,1
220198,"2023",0,0,3,3
220200,"2015",3,1,2,6
220200,"2016",1,0,10,11
220200,"2017",0,0,9,9
220200,"2018",2,0,13,15
220200,"2019",7,0,17,24
220200,"2020",11,2,5,18
220200,"2021",2,1,7,10
220200,"2022",1,1,5,7
220200,"2023",4,4,4,12
220202,"2015",1,0,2,3
220202,"2016",1,0,2,3
220202,"2017",0,0,2,2
220202,"2018",0,0,2,2
220202,"2019",1,0,4,5
220202,"2020",1,1,1,3
220202,"2021",0,0,2,2
220202,"2022",1,1,2,4
220202,"2023",0,0,2,2
220205,"2015",3,1,3,7
220205,"2016",2,0,6,8
220205,"2017",0,2,6,8
220205,"2018",3,0,3,6
220205,"2019",1,0,5,6
220205,"2020",2,2,2,6
220205,"2021",5,0,2,7
220205,"2022",2,1,4,7
220205,"2023",0,0,2,2
220207,"2015",0,0,2,2
220207,"2017",1,0,0,1
220207,"2019",0,0,2,2
220207,"2020",1,0,1,2
220207,"2022",0,0,1,1
220208,"2015",1,0,2,3
220208,"2016",0,0,5,5
220208,"2017",1,0,1,2
220208,"2018",1,1,5,7
220208,"2019",2,0,3,5
220208,"2020",4,1,4,9
220208,"2021",2,0,3,5
220208,"2022",0,0,1,1
220208,"2023",2,0,1,3
220209,"2018",1,1,4,6
220209,"2019",0,1,1,2
220209,"2020",0,1,0,1
220209,"2021",0,0,1,1
220209,"2022",0,1,1,2
220209,"2023",0,0,3,3
220210,"2015",1,0,1,2
220210,"2017",0,0,2,2
220210,"2018",0,0,1,1
220210,"2021",0,0,1,1
220211,"2016",1,0,1,2
220211,"2017",1,0,3,4
220211,"2018",1,0,1,2
220211,"2019",2,0,0,2
220211,"2020",1,0,0,1
220211,"2021",2,1,3,6
220211,"2022",0,0,3,3
220211,"2023",0,0,2,2
220213,"2015",0,0,1,1
220213,"2017",0,0,3,3
220213,"2019",1,0,4,5
220213,"2020",1,0,0,1
220213,"2021",0,0,2,2
220213,"2022",0,0,1,1
220213,"2023",1,0,1,2
220217,"2016",0,0,7,7
220217,"2017",2,0,1,3
220217,"2018",1,1,1,3
220217,"2019",2,0,0,2
220217,"2020",1,0,4,5
220217,"2021",1,0,3,4
220217,"2022",0,1,2,3
220217,"2023",0,0,2,2
220220,"2015",7,1,25,33
220220,"2016",12,4,22,38
220220,"2017",11,0,29,40
220220,"2018",11,2,15,28
220220,"2019",18,3,27,48
220220,"2020",9,3,19,31
220220,"2021",15,4,18,37
220220,"2022",8,4,17,29
220220,"2023",4,0,9,13
220225,"2017",1,0,3,4
220225,"2018",0,0,1,1
220225,"2019",1,0,2,3
220225,"2020",2,2,0,4
220225,"2021",2,0,2,4
220225,"2022",0,0,3,3
220225,"2023",1,0,1,2
220230,"2015",0,1,3,4
220230,"2016",0,0,4,4
220230,"2017",5,1,16,22
220230,"2018",1,1,12,14
220230,"2019",6,0,7,13
220230,"2020",2,1,6,9
220230,"2021",1,0,7,8
220230,"2022",8,2,9,19
220230,"2023",4,0,9,13
220240,"2015",1,1,4,6
220240,"2016",2,2,1,5
220240,"2017",3,2,6,11
220240,"2018",3,0,5,8
220240,"2019",4,0,11,15
220240,"2020",5,0,5,10
220240,"2021",5,1,6,12
220240,"2022",1,2,4,7
220240,"2023",2,1,1,4
220245,"2015",3,0,0,3
220245,"2016",1,0,0,1
220245,"2017",0,1,1,2
220245,"2018",1,0,1,2
220245,"2020",0,0,3,3
220245,"2021",0,0,2,2
220245,"2022",0,0,3,3
220250,"2015",1,0,1,2
220250,"2016",3,0,4,7
220250,"2017",4,0,7,11
220250,"2018",2,0,8,10
220250,"2019",1,0,8,9
220250,"2020",2,0,5,7
220250,"2021",2,0,4,6
220250,"2022",2,0,7,9
220250,"2023",1,0,5,6
220253,"2015",2,0,3,5
220253,"2016",2,0,3,5
220253,"2017",0,0,3,3
220253,"2018",1,0,6,7
220253,"2019",2,0,4,6
220253,"2020",2,0,5,7
220253,"2021",1,0,4,5
220253,"2022",2,0,1,3
220253,"2023",1,0,0,1
220255,"2015",0,0,1,1
220255,"2020",0,0,1,1
220255,"2022",1,0,1,2
220255,"2023",0,0,2,2
220260,"2015",1,0,5,6
220260,"2016",3,2,2,7
220260,"2017",4,4,13,21
220260,"2018",6,1,11,18
220260,"2019",7,0,5,12
220260,"2020",3,2,4,9
220260,"2021",2,1,6,9
220260,"2022",4,1,3,8
220260,"2023",1,0,3,4
220265,"2015",0,0,2,2
220265,"2016",1,0,5,6
220265,"2017",0,0,1,1
220265,"2018",1,3,0,4
220265,"2019",0,1,3,4
220265,"2020",0,0,4,4
220265,"2021",0,0,4,4
220265,"2022",0,0,4,4
220265,"2023",0,0,3,3
220270,"2015",4,1,5,10
220270,"2016",1,2,6,9
220270,"2017",2,0,6,8
220270,"2018",7,0,14,21
220270,"2019",4,3,16,23
220270,"2020",8,1,6,15
220270,"2021",5,1,12,18
220270,"2022",5,1,4,10
220270,"2023",4,2,4,10
220271,"2015",0,0,2,2
220271,"2016",3,0,0,3
220271,"2017",2,0,1,3
220271,"2018",1,0,2,3
220271,"2019",0,0,1,1
220271,"2020",0,0,3,3
220271,"2021",1,0,2,3
220271,"2022",0,0,1,1
220271,"2023",0,0,1,1
220272,"2015",0,0,1,1
220272,"2017",3,0,5,8
220272,"2018",1,1,3,5
220272,"2019",2,0,0,2
220272,"2020",3,0,2,5
220272,"2021",0,2,1,3
220272,"2022",2,0,0,2
220272,"2023",1,0,2,3
220273,"2015",2,0,0,2
220273,"2016",0,0,2,2
220273,"2017",2,0,2,4
220273,"2018",1,0,4,5
220273,"2019",2,0,2,4
220273,"2020",0,0,2,2
220273,"2021",0,0,1,1
220273,"2023",0,1,3,4
220275,"2015",2,0,0,2
220275,"2016",0,2,2,4
220275,"2018",1,0,0,1
220275,"2019",3,1,0,4
220275,"2020",1,0,2,3
220275,"2021",1,0,3,4
220275,"2022",0,0,1,1
220275,"2023",0,0,1,1
220277,"2015",0,0,1,1
220277,"2016",1,0,0,1
220277,"2017",1,1,0,2
220277,"2018",0,0,3,3
220277,"2019",0,0,2,2
220277,"2020",0,0,3,3
220277,"2021",0,0,1,1
220277,"2022",0,0,1,1
220280,"2015",0,0,1,1
220280,"2016",1,1,1,3
220280,"2017",0,0,1,1
220280,"2018",0,0,3,3
220280,"2019",1,0,1,2
220280,"2020",2,0,1,3
220280,"2021",0,0,2,2
220280,"2022",0,0,2,2
220285,"2015",0,0,1,1
220285,"2016",0,0,3,3
220285,"2017",2,0,2,4
220285,"2018",2,1,2,5
220285,"2019",1,0,3,4
220285,"2020",1,2,4,7
220285,"2021",0,0,2,2
220285,"2022",1,0,0,1
220285,"2023",2,0,1,3
220290,"2015",4,0,7,11
220290,"2016",7,0,15,22
220290,"2017",4,0,18,22
220290,"2018",8,2,25,35
220290,"2019",4,1,11,16
220290,"2020",13,1,31,45
220290,"2021",11,0,24,35
220290,"2022",9,1,20,30
220290,"2023",8,2,15,25
220300,"2015",1,0,0,1
220300,"2016",2,0,2,4
220300,"2018",1,0,3,4
220300,"2019",0,0,2,2
220300,"2020",1,0,2,3
220300,"2021",0,1,1,2
220300,"2022",0,0,2,2
220300,"2023",2,0,0,2
220310,"2015",1,0,2,3
220310,"2016",1,0,0,1
220310,"2017",0,1,1,2
220310,"2019",0,0,2,2
220310,"2022",1,0,2,3
220320,"2015",4,3,12,19
220320,"2016",4,2,19,25
220320,"2017",5,1,8,14
220320,"2018",7,2,7,16
220320,"2019",2,1,4,7
220320,"2020",2,1,6,9
220320,"2021",1,0,8,9
220320,"2022",4,1,5,10
220320,"2023",3,1,10,14
220323,"2015",0,0,1,1
220323,"2019",0,0,1,1
220323,"2020",0,0,1,1
220325,"2015",0,1,1,2
220325,"2016",0,1,2,3
220325,"2017",0,1,2,3
220325,"2018",0,1,1,2
220325,"2019",0,0,1,1
220325,"2020",5,0,1,6
220325,"2021",1,0,2,3
220325,"2022",1,0,3,4
220325,"2023",0,0,2,2
220327,"2017",0,0,1,1
220327,"2018",0,0,1,1
220327,"2020",0,0,1,1
220327,"2021",0,0,1,1
220330,"2015",2,0,7,9
220330,"2016",2,0,8,10
220330,"2017",6,1,8,15
220330,"2018",2,0,10,12
220330,"2019",4,0,3,7
220330,"2020",5,0,3,8
220330,"2021",4,0,10,14
220330,"2022",2,0,5,7
220330,"2023",4,0,8,12
220335,"2015",2,0,7,9
220335,"2016",2,0,2,4
220335,"2017",0,0,6,6
220335,"2018",0,0,4,4
220335,"2019",2,0,6,8
220335,"2020",0,0,3,3
220335,"2021",1,0,0,1
220335,"2022",1,1,3,5
220335,"2023",2,0,1,3
220340,"2016",0,0,1,1
220340,"2017",1,0,0,1
220340,"2018",3,0,1,4
220340,"2019",1,1,3,5
220340,"2022",2,0,1,3
220340,"2023",1,0,0,1
220342,"2015",0,0,6,6
220342,"2016",2,0,3,5
220342,"2017",0,0,3,3
220342,"2019",4,0,3,7
220342,"2020",1,0,5,6
220342,"2021",0,0,4,4
220342,"2022",3,0,2,5
220342,"2023",1,0,0,1
220345,"2015",1,1,5,7
220345,"2016",0,0,4,4
220345,"2017",2,0,2,4
220345,"2018",5,0,3,8
220345,"2019",1,0,2,3
220345,"2020",2,0,6,8
220345,"2021",1,1,5,7
220345,"2022",3,1,1,5
220345,"2023",0,0,3,3
220350,"2015",2,0,6,8
220350,"2016",2,0,9,11
220350,"2017",3,0,6,9
220350,"2018",5,1,4,10
220350,"2019",3,0,7,10
220350,"2020",2,1,3,6
220350,"2021",4,1,2,7
220350,"2022",1,0,4,5
220350,"2023",2,2,1,5
220360,"2016",0,0,1,1
220360,"2017",2,0,2,4
220360,"2018",0,0,4,4
220360,"2019",2,0,2,4
220360,"2020",0,0,1,1
220360,"2021",0,0,1,1
220370,"2015",2,2,12,16
220370,"2016",6,1,11,18
220370,"2017",5,0,10,15
220370,"2018",1,0,4,5
220370,"2019",8,1,6,15
220370,"2020",9,0,13,22
220370,"2021",14,2,23,39
220370,"2022",12,1,14,27
220370,"2023",10,0,19,29
220375,"2015",1,1,3,5
220375,"2016",1,0,2,3
220375,"2017",3,0,2,5
220375,"2018",1,0,2,3
220375,"2019",1,0,4,5
220375,"2020",2,1,2,5
220375,"2021",0,0,3,3
220375,"2022",1,0,4,5
220375,"2023",0,0,2,2
220380,"2016",1,0,2,3
220380,"2017",1,0,6,7
220380,"2018",2,0,3,5
220380,"2019",0,1,4,5
220380,"2020",1,0,1,2
220380,"2021",1,1,1,3
220380,"2022",2,0,3,5
220380,"2023",1,2,2,5
220385,"2019",1,0,0,1
220390,"2015",0,0,2,2
220390,"2016",44,5,96,145
220390,"2017",49,4,96,149
220390,"2018",37,4,86,127
220390,"2019",32,9,89,130
220390,"2020",37,6,62,105
220390,"2021",48,5,74,127
220390,"2022",35,4,62,101
220390,"2023",26,10,38,74
220400,"2015",2,0,2,4
220400,"2016",0,0,2,2
220400,"2017",0,1,1,2
220400,"2018",1,0,2,3
220400,"2019",4,1,2,7
220400,"2020",0,1,4,5
220400,"2021",0,0,1,1
220400,"2022",0,0,1,1
220400,"2023",2,1,1,4
220410,"2016",2,0,2,4
220410,"2017",1,0,5,6
220410,"2018",1,0,7,8
220410,"2019",0,0,2,2
220410,"2020",1,1,5,7
220410,"2021",0,0,2,2
220410,"2022",2,0,2,4
220410,"2023",3,0,2,5
220415,"2018",2,0,2,4
220415,"2019",0,0,1,1
220415,"2023",0,0,1,1
220420,"2019",2,0,3,5
220420,"2020",1,0,1,2
220420,"2021",0,0,2,2
220420,"2022",1,0,0,1
220420,"2023",1,0,1,2
220430,"2015",0,2,4,6
220430,"2016",1,0,0,1
220430,"2017",3,0,2,5
220430,"2020",1,0,1,2
220430,"2022",1,0,1,2
220435,"2018",0,0,2,2
220435,"2019",0,0,4,4
220435,"2020",0,0,2,2
220435,"2022",2,0,1,3
220435,"2023",1,0,1,2
220440,"2015",0,0,5,5
220440,"2016",2,0,4,6
220440,"2017",3,0,4,7
220440,"2018",2,0,8,10
220440,"2019",2,0,2,4
220440,"2020",0,0,6,6
220440,"2021",1,0,3,4
220440,"2022",0,0,2,2
220440,"2023",0,1,5,6
220450,"2015",3,0,3,6
220450,"2016",3,1,8,12
220450,"2017",3,1,4,8
220450,"2018",3,3,11,17
220450,"2019",2,2,2,6
220450,"2020",5,1,8,14
220450,"2021",7,1,11,19
220450,"2022",5,3,7,15
220450,"2023",3,2,2,7
220455,"2015",0,0,3,3
220455,"2016",0,0,6,6
220455,"2017",2,0,3,5
220455,"2018",0,0,4,4
220455,"2019",2,0,1,3
220455,"2020",0,0,4,4
220455,"2021",0,0,4,4
220455,"2022",1,0,6,7
220455,"2023",2,0,5,7
220460,"2015",0,0,2,2
220460,"2016",1,1,0,2
220460,"2017",1,0,0,1
220460,"2018",1,1,2,4
220460,"2019",2,1,1,4
220460,"2021",1,0,0,1
220460,"2022",0,0,2,2
220460,"2023",0,0,1,1
220465,"2015",0,0,2,2
220465,"2016",0,1,5,6
220465,"2017",0,0,5,5
220465,"2018",2,0,5,7
220465,"2019",5,0,6,11
220465,"2020",0,0,7,7
220465,"2021",1,0,0,1
220465,"2022",2,0,4,6
220465,"2023",1,1,4,6
220470,"2015",3,0,8,11
220470,"2016",7,3,6,16
220470,"2017",8,2,11,21
220470,"2018",5,1,9,15
220470,"2019",4,2,11,17
220470,"2020",8,3,6,17
220470,"2021",14,1,11,26
220470,"2022",5,0,9,14
220470,"2023",0,0,3,3
220480,"2018",0,0,7,7
220480,"2019",1,0,2,3
220480,"2020",0,0,2,2
220480,"2021",0,1,1,2
220480,"2022",0,0,3,3
220480,"2023",1,0,1,2
220490,"2016",0,0,1,1
220490,"2017",0,0,1,1
220490,"2018",1,0,2,3
220490,"2019",0,0,1,1
220490,"2020",1,0,0,1
220490,"2023",2,0,2,4
220500,"2015",0,0,1,1
220500,"2018",1,0,2,3
220500,"2019",0,0,2,2
220500,"2021",0,1,3,4
220500,"2022",0,1,2,3
220510,"2015",0,0,4,4
220510,"2016",9,1,2,12
220510,"2017",2,0,9,11
220510,"2018",2,2,9,13
220510,"2019",2,1,5,8
220510,"2020",1,1,7,9
220510,"2021",2,2,8,12
220510,"2022",1,1,4,6
220510,"2023",0,0,5,5
220515,"2015",1,0,2,3
220515,"2016",1,1,4,6
220515,"2017",1,0,3,4
220515,"2018",2,0,2,4
220515,"2019",4,0,5,9
220515,"2020",2,0,3,5
220515,"2021",2,1,4,7
220515,"2022",1,0,2,3
220515,"2023",1,0,0,1
220520,"2015",0,0,1,1
220520,"2017",0,0,1,1
220520,"2018",2,0,5,7
220520,"2019",1,1,2,4
220520,"2020",0,0,5,5
220520,"2021",1,0,4,5
220520,"2022",1,1,3,5
220520,"2023",0,1,6,7
220525,"2015",0,0,2,2
220525,"2017",1,0,1,2
220525,"2018",0,0,2,2
220525,"2019",0,0,1,1
220525,"2020",0,0,1,1
220525,"2021",0,0,2,2
220525,"2022",0,0,4,4
220525,"2023",1,0,1,2
220527,"2015",0,0,2,2
220527,"2017",4,0,2,6
220527,"2018",2,0,2,4
220527,"2019",2,0,0,2
220527,"2020",3,0,0,3
220527,"2021",3,0,0,3
220527,"2022",3,0,1,4
220527,"2023",0,1,0,1
220530,"2016",4,0,5,9
220530,"2017",3,2,6,11
220530,"2018",2,1,4,7
220530,"2019",1,0,3,4
220530,"2020",0,1,6,7
220530,"2021",2,0,4,6
220530,"2022",3,0,4,7
220530,"2023",0,0,5,5
220535,"2017",0,0,3,3
220535,"2019",0,0,2,2
220535,"2020",0,0,1,1
220535,"2021",0,0,1,1
220535,"2023",1,0,0,1
220540,"2015",2,0,7,9
220540,"2016",1,0,4,5
220540,"2017",3,0,8,11
220540,"2018",1,0,7,8
220540,"2019",3,0,6,9
220540,"2020",3,0,6,9
220540,"2021",2,1,5,8
220540,"2022",4,0,2,6
220540,"2023",0,0,6,6
220545,"2015",0,1,3,4
220545,"2016",0,0,1,1
220545,"2018",0,0,3,3
220545,"2019",0,0,1,1
220545,"2020",2,0,3,5
220545,"2021",2,0,5,7
220545,"2022",0,0,5,5
220545,"2023",0,0,1,1
220550,"2015",9,0,14,23
220550,"2016",9,0,20,29
220550,"2017",8,0,20,28
220550,"2018",10,1,21,32
220550,"2019",17,2,14,33
220550,"2020",10,0,19,29
220550,"2021",9,0,10,19
220550,"2022",6,3,12,21
220550,"2023",4,2,8,14
220551,"2016",1,0,0,1
220551,"2018",0,0,3,3
220551,"2019",0,0,1,1
220551,"2020",0,1,5,6
220551,"2021",1,1,0,2
220551,"2022",1,0,1,2
220551,"2023",1,0,1,2
220552,"2015",0,2,1,3
220552,"2016",1,0,2,3
220552,"2017",2,1,4,7
220552,"2018",1,0,1,2
220552,"2019",0,1,0,1
220552,"2020",1,0,1,2
220552,"2021",0,0,1,1
220552,"2022",0,0,2,2
220552,"2023",0,0,3,3
220553,"2016",3,0,1,4
220553,"2017",2,0,4,6
220553,"2018",1,0,5,6
220553,"2019",3,0,1,4
220553,"2020",2,1,0,3
220553,"2021",1,0,1,2
220553,"2022",2,0,2,4
220553,"2023",0,0,1,1
220554,"2015",0,0,3,3
220554,"2016",0,2,0,2
220554,"2017",1,0,3,4
220554,"2018",0,0,2,2
220554,"2019",0,0,1,1
220554,"2021",0,0,1,1
220555,"2015",0,0,3,3
220555,"2016",0,0,3,3
220555,"2017",1,1,2,4
220555,"2018",3,1,3,7
220555,"2019",1,1,4,6
220555,"2020",5,1,0,6
220555,"2021",2,0,2,4
220555,"2022",3,1,2,6
220555,"2023",1,0,1,2
220556,"2015",1,0,2,3
220556,"2016",1,0,0,1
220556,"2017",1,0,1,2
220556,"2020",0,0,1,1
220556,"2021",0,0,1,1
220556,"2022",0,1,5,6
220556,"2023",1,0,0,1
220557,"2015",1,0,2,3
220557,"2016",1,0,7,8
220557,"2017",3,0,3,6
220557,"2018",3,0,2,5
220557,"2019",3,1,2,6
220557,"2020",1,0,4,5
220557,"2021",2,1,2,5
220557,"2023",1,4,4,9
220558,"2015",0,0,5,5
220558,"2016",1,1,3,5
220558,"2017",2,0,1,3
220558,"2018",1,1,2,4
220558,"2019",1,0,0,1
220558,"2020",0,0,2,2
220558,"2021",2,0,2,4
220558,"2022",0,1,0,1
220558,"2023",1,0,1,2
220559,"2015",1,0,4,5
220559,"2016",1,0,5,6
220559,"2017",1,0,3,4
220559,"2018",1,0,2,3
220559,"2019",0,0,1,1
220559,"2020",1,0,2,3
220559,"2021",0,0,1,1
220559,"2022",0,1,1,2
220559,"2023",1,1,1,3
220560,"2016",1,1,3,5
220560,"2017",2,1,2,5
220560,"2018",2,0,3,5
220560,"2019",3,3,5,11
220560,"2020",1,0,0,1
220560,"2021",1,2,1,4
220560,"2022",0,0,4,4
220560,"2023",3,0,4,7
220570,"2015",3,0,11,14
220570,"2016",3,3,11,17
220570,"2017",5,1,6,12
220570,"2018",9,0,10,19
220570,"2019",4,0,12,16
220570,"2020",11,1,15,27
220570,"2021",7,0,13,20
220570,"2022",4,0,5,9
220570,"2023",5,1,2,8
220580,"2015",7,2,7,16
220580,"2016",5,0,11,16
220580,"2017",6,1,15,22
220580,"2018",5,1,12,18
220580,"2019",6,1,6,13
220580,"2020",7,1,19,27
220580,"2021",6,1,14,21
220580,"2022",3,1,10,14
220580,"2023",2,1,10,13
220585,"2015",0,0,5,5
220585,"2016",1,0,2,3
220585,"2017",0,0,1,1
220585,"2018",1,0,1,2
220585,"2019",2,0,3,5
220585,"2020",0,1,6,7
220585,"2021",0,1,2,3
220585,"2022",0,1,3,4
220585,"2023",1,0,3,4
220590,"2016",1,1,3,5
220590,"2017",0,0,2,2
220590,"2018",0,0,2,2
220590,"2019",0,0,2,2
220590,"2020",2,1,0,3
220590,"2021",0,0,2,2
220590,"2022",2,1,0,3
220595,"2015",0,0,1,1
220595,"2016",1,0,0,1
220595,"2017",1,0,1,2
220595,"2018",1,1,5,7
220595,"2019",2,0,2,4
220595,"2020",0,0,2,2
220595,"2021",0,0,1,1
220595,"2022",1,0,0,1
220595,"2023",0,0,4,4
220600,"2016",1,1,3,5
220600,"2017",2,0,1,3
220600,"2018",4,0,4,8
220600,"2019",2,0,4,6
220600,"2020",0,0,5,5
220600,"2021",3,0,3,6
220600,"2022",4,2,2,8
220600,"2023",0,2,5,7
220605,"2016",0,0,1,1
220605,"2019",1,0,0,1
220605,"2020",1,0,2,3
220605,"2021",1,0,2,3
220605,"2023",0,0,2,2
220610,"2015",0,0,3,3
220610,"2016",1,0,4,5
220610,"2017",0,0,2,2
220610,"2018",0,0,2,2
220610,"2019",0,0,2,2
220610,"2020",0,0,4,4
220610,"2021",2,0,8,10
220610,"2022",1,1,0,2
220610,"2023",0,0,1,1
220620,"2015",1,1,18,20
220620,"2016",1,1,12,14
220620,"2017",7,0,17,24
220620,"2018",11,1,6,18
220620,"2019",5,1,13,19
220620,"2020",10,0,9,19
220620,"2021",4,2,13,19
220620,"2022",2,2,7,11
220620,"2023",3,1,8,12
220630,"2019",0,0,1,1
220630,"2020",1,0,1,2
220630,"2021",1,0,3,4
220630,"2022",1,0,0,1
220635,"2015",0,0,2,2
220635,"2016",2,0,3,5
220635,"2017",1,0,3,4
220635,"2018",0,0,3,3
220635,"2019",1,0,2,3
220635,"2020",1,0,1,2
220635,"2021",0,1,2,3
220635,"2022",2,0,0,2
220640,"2015",1,0,3,4
220640,"2016",3,1,2,6
220640,"2017",4,1,3,8
220640,"2018",1,0,4,5
220640,"2019",4,0,5,9
220640,"2020",2,1,1,4
220640,"2021",2,0,1,3
220640,"2022",3,1,3,7
220640,"2023",0,1,2,3
220650,"2018",0,0,3,3
220650,"2019",0,1,2,3
220650,"2020",0,0,3,3
220650,"2021",1,0,1,2
220650,"2022",2,0,1,3
220650,"2023",2,0,3,5
220660,"2015",2,0,2,4
220660,"2016",0,0,2,2
220660,"2017",0,0,2,2
220660,"2018",0,0,1,1
220660,"2019",2,0,0,2
220660,"2020",4,2,4,10
220660,"2021",5,0,4,9
220660,"2022",0,0,1,1
220660,"2023",0,0,1,1
220665,"2015",0,0,1,1
220665,"2016",0,0,5,5
220665,"2017",0,0,3,3
220665,"2018",0,0,2,2
220665,"2019",0,0,2,2
220665,"2021",2,0,2,4
220665,"2022",1,0,2,3
220665,"2023",0,0,1,1
220667,"2016",1,0,3,4
220667,"2017",1,0,0,1
220667,"2019",2,0,1,3
220667,"2020",1,0,5,6
220667,"2021",1,0,2,3
220667,"2022",1,0,4,5
220667,"2023",0,0,2,2
220669,"2015",1,1,4,6
220669,"2016",1,0,0,1
220669,"2017",0,0,5,5
220669,"2018",1,0,4,5
220669,"2019",0,0,2,2
220669,"2020",0,0,3,3
220669,"2021",1,2,0,3
220669,"2022",0,0,1,1
220669,"2023",1,0,1,2
220670,"2016",3,1,5,9
220670,"2017",3,0,9,12
220670,"2018",0,1,4,5
220670,"2019",2,1,5,8
220670,"2020",3,0,6,9
220670,"2021",1,0,6,7
220670,"2022",0,1,4,5
220670,"2023",2,0,2,4
220672,"2015",1,1,11,13
220672,"2016",1,2,2,5
220672,"2017",1,0,6,7
220672,"2018",1,0,4,5
220672,"2019",1,0,3,4
220672,"2020",0,0,4,4
220672,"2021",2,0,5,7
220672,"2022",1,0,2,3
220672,"2023",0,0,3,3
220675,"2015",1,0,4,5
220675,"2016",1,0,1,2
220675,"2017",1,2,3,6
220675,"2018",1,1,0,2
220675,"2019",0,1,1,2
220675,"2020",1,0,0,1
220675,"2021",2,0,0,2
220675,"2022",1,0,2,3
220675,"2023",1,0,0,1
220680,"2015",0,1,5,6
220680,"2016",2,0,3,5
220680,"2017",0,0,4,4
220680,"2018",1,0,6,7
220680,"2019",1,0,5,6
220680,"2020",2,2,4,8
220680,"2021",2,0,3,5
220680,"2022",2,0,2,4
220680,"2023",1,1,4,6
220690,"2015",1,0,3,4
220690,"2016",1,0,2,3
220690,"2017",2,0,3,5
220690,"2018",3,0,5,8
220690,"2019",0,0,3,3
220690,"2020",0,1,0,1
220690,"2021",2,0,3,5
220690,"2022",0,0,5,5
220690,"2023",0,0,3,3
220695,"2015",0,0,1,1
220695,"2016",1,0,0,1
220695,"2017",0,0,1,1
220695,"2018",0,0,1,1
220695,"2020",0,0,1,1
220695,"2021",1,0,0,1
220695,"2023",0,0,1,1
220700,"2015",3,0,4,7
220700,"2016",0,0,3,3
220700,"2017",3,0,12,15
220700,"2018",7,2,15,24
220700,"2019",4,0,5,9
220700,"2020",5,0,6,11
220700,"2021",2,0,2,4
220700,"2022",1,1,1,3
220700,"2023",1,0,1,2
220710,"2016",0,0,1,1
220710,"2019",0,0,1,1
220710,"2021",0,0,1,1
220720,"2017",0,0,2,2
220720,"2019",2,0,1,3
220720,"2020",1,0,0,1
220720,"2021",1,0,0,1
220720,"2023",0,1,0,1
220730,"2015",0,0,2,2
220730,"2016",0,1,3,4
220730,"2018",2,0,0,2
220730,"2019",1,0,0,1
220730,"2020",0,0,1,1
220730,"2021",0,0,1,1
220730,"2022",2,1,3,6
220735,"2016",1,0,0,1
220735,"2018",2,0,3,5
220735,"2019",1,0,2,3
220735,"2020",1,0,0,1
220735,"2021",2,0,2,4
220735,"2022",1,0,2,3
220735,"2023",0,1,0,1
220740,"2016",1,0,0,1
220740,"2022",0,0,1,1
220740,"2023",1,0,0,1
220750,"2015",1,0,3,4
220750,"2016",1,0,4,5
220750,"2017",0,0,1,1
220750,"2018",2,1,5,8
220750,"2019",0,0,5,5
220750,"2020",2,0,1,3
220750,"2021",1,1,4,6
220750,"2022",1,1,2,4
220750,"2023",1,0,2,3
220755,"2018",1,0,1,2
220755,"2020",0,0,1,1
220755,"2021",0,0,1,1
220755,"2022",0,0,2,2
220755,"2023",1,0,0,1
220760,"2015",1,0,1,2
220760,"2016",1,0,5,6
220760,"2017",2,1,3,6
220760,"2018",0,1,3,4
220760,"2019",2,0,3,5
220760,"2020",5,0,4,9
220760,"2022",2,0,2,4
220760,"2023",1,0,1,2
220770,"2015",45,10,119,174
220770,"2016",60,16,145,221
220770,"2017",61,13,158,232
220770,"2018",52,9,97,158
220770,"2019",52,11,95,158
220770,"2020",49,10,71,130
220770,"2021",99,16,105,220
220770,"2022",70,10,102,182
220770,"2023",55,8,88,151
220775,"2015",1,0,2,3
220775,"2016",0,2,2,4
220775,"2017",1,0,1,2
220775,"2018",0,0,1,1
220775,"2019",0,0,1,1
220775,"2020",1,0,2,3
220775,"2021",0,1,2,3
220775,"2022",1,0,1,2
220775,"2023",0,1,2,3
220777,"2016",0,0,1,1
220777,"2017",0,0,1,1
220777,"2018",0,0,1,1
220777,"2020",1,0,1,2
220777,"2021",0,0,1,1
220777,"2023",1,0,2,3
220779,"2015",1,0,3,4
220779,"2017",0,0,1,1
220779,"2018",0,1,1,2
220779,"2019",0,0,1,1
220779,"2020",0,0,1,1
220779,"2021",1,1,0,2
220779,"2023",1,0,3,4
220780,"2015",9,1,10,20
220780,"2016",10,3,23,36
220780,"2017",10,1,20,31
220780,"2018",7,1,11,19
220780,"2019",2,0,20,22
220780,"2020",8,1,21,30
220780,"2021",10,2,21,33
220780,"2022",5,2,9,16
220780,"2023",1,0,11,12
220785,"2015",0,0,1,1
220785,"2016",0,0,1,1
220785,"2017",0,0,1,1
220785,"2018",0,1,0,1
220785,"2019",1,0,0,1
220785,"2020",1,0,2,3
220785,"2021",1,1,1,3
220785,"2022",2,1,3,6
220785,"2023",0,1,3,4
220790,"2015",4,1,6,11
220790,"2016",8,1,18,27
220790,"2017",8,1,11,20
220790,"2018",8,0,6,14
220790,"2019",13,3,11,27
220790,"2020",11,1,9,21
220790,"2021",8,0,18,26
220790,"2022",10,3,13,26
220790,"2023",3,0,7,10
220793,"2015",0,0,2,2
220793,"2016",0,0,1,1
220793,"2017",0,0,1,1
220793,"2018",1,0,0,1
220793,"2019",1,0,0,1
220793,"2020",0,0,1,1
220793,"2021",2,0,2,4
220793,"2022",0,0,1,1
220795,"2015",0,0,1,1
220795,"2017",0,1,1,2
220795,"2018",0,0,2,2
220795,"2019",1,0,2,3
220795,"2020",0,1,3,4
220795,"2021",2,0,0,2
220795,"2022",2,0,2,4
220795,"2023",1,0,0,1
220800,"2015",2,0,1,3
220800,"2016",2,0,4,6
220800,"2017",5,1,6,12
220800,"2018",24,1,32,57
220800,"2019",12,1,26,39
220800,"2020",12,0,22,34
220800,"2021",13,0,25,38
220800,"2022",10,0,25,35
220800,"2023",10,5,25,40
220810,"2015",2,0,3,5
220810,"2016",2,1,10,13
220810,"2017",2,0,3,5
220810,"2018",0,1,4,5
220810,"2019",2,0,5,7
220810,"2020",1,0,4,5
220810,"2021",5,0,0,5
220810,"2022",1,1,6,8
220810,"2023",1,1,4,6
220820,"2015",1,0,0,1
220820,"2017",1,0,0,1
220820,"2018",1,1,2,4
220820,"2019",1,0,8,9
220820,"2020",0,0,6,6
220820,"2021",1,1,1,3
220820,"2022",3,0,5,8
220820,"2023",3,0,4,7
220830,"2015",11,1,31,43
220830,"2016",10,1,10,21
220830,"2017",8,0,21,29
220830,"2018",14,4,25,43
220830,"2019",8,2,16,26
220830,"2020",9,4,18,31
220830,"2021",7,1,17,25
220830,"2022",7,4,10,21
220830,"2023",10,3,6,19
220840,"2015",21,5,30,56
220840,"2016",17,3,35,55
220840,"2017",9,3,41,53
220840,"2018",23,1,42,66
220840,"2019",19,6,30,55
220840,"2020",19,6,35,60
220840,"2021",32,7,37,76
220840,"2022",23,6,37,66
220840,"2023",11,6,28,45
220850,"2015",2,0,6,8
220850,"2016",2,0,6,8
220850,"2017",1,1,3,5
220850,"2018",2,0,3,5
220850,"2019",1,0,2,3
220850,"2020",4,0,4,8
220850,"2021",3,0,3,6
220850,"2022",5,0,3,8
220850,"2023",1,1,2,4
220855,"2016",0,0,4,4
220855,"2017",1,0,1,2
220855,"2018",1,0,1,2
220855,"2019",2,0,2,4
220855,"2020",2,0,2,4
220855,"2021",2,0,1,3
220855,"2022",2,0,3,5
220855,"2023",0,0,2,2
220860,"2015",0,1,1,2
220860,"2016",1,0,1,2
220860,"2017",0,0,1,1
220860,"2018",1,0,2,3
220860,"2020",1,0,0,1
220860,"2021",0,0,2,2
220860,"2022",1,0,1,2
220865,"2015",1,0,5,6
220865,"2016",0,0,8,8
220865,"2017",0,0,5,5
220865,"2018",2,0,2,4
220865,"2019",4,2,4,10
220865,"2020",0,0,1,1
220865,"2021",1,1,2,4
220865,"2022",0,0,4,4
220865,"2023",0,0,4,4
220870,"2015",2,0,2,4
220870,"2016",1,1,0,2
220870,"2018",0,0,2,2
220870,"2019",0,0,1,1
220870,"2020",1,1,2,4
220870,"2022",1,0,0,1
220880,"2015",3,0,6,9
220880,"2016",3,0,8,11
220880,"2017",2,0,11,13
220880,"2018",2,0,3,5
220880,"2019",1,0,4,5
220880,"2020",3,0,7,10
220880,"2021",3,0,4,7
220880,"2022",2,1,7,10
220880,"2023",3,1,6,10
220885,"2015",1,0,1,2
220885,"2016",0,0,2,2
220885,"2017",0,0,1,1
220885,"2018",1,0,2,3
220885,"2019",0,0,1,1
220885,"2020",0,0,1,1
220885,"2021",0,0,1,1
220885,"2022",1,0,0,1
220885,"2023",1,1,1,3
220887,"2016",0,0,3,3
220887,"2017",2,1,0,3
220887,"2018",0,0,1,1
220887,"2019",0,1,1,2
220887,"2021",2,0,3,5
220887,"2022",3,0,3,6
220887,"2023",0,0,2,2
220890,"2015",0,0,1,1
220890,"2016",0,0,2,2
220890,"2018",2,0,0,2
220890,"2022",0,0,1,1
220890,"2023",1,0,1,2
220900,"2016",0,0,3,3
220900,"2017",0,0,3,3
220900,"2018",3,0,6,9
220900,"2019",2,0,6,8
220900,"2020",0,1,4,5
220900,"2021",1,0,5,6
220900,"2022",2,0,3,5
220900,"2023",1,0,1,2
220910,"2015",0,0,1,1
220910,"2018",1,0,2,3
220910,"2019",0,0,3,3
220910,"2020",0,0,2,2
220910,"2021",1,0,0,1
220910,"2023",0,0,2,2
220915,"2015",1,0,0,1
220915,"2016",2,1,0,3
220915,"2017",1,0,1,2
220915,"2018",2,0,1,3
220915,"2019",0,0,1,1
220915,"2020",2,0,1,3
220915,"2021",1,0,1,2
220915,"2022",1,0,1,2
220920,"2016",1,0,0,1
220920,"2017",0,0,1,1
220920,"2019",1,0,0,1
220920,"2021",0,0,1,1
220920,"2022",1,0,0,1
220930,"2015",1,0,3,4
220930,"2016",0,0,1,1
220930,"2019",0,0,1,1
220930,"2020",0,0,1,1
220930,"2021",0,0,2,2
220930,"2022",0,0,1,1
220935,"2018",0,0,3,3
220935,"2019",0,0,1,1
220935,"2021",0,0,1,1
220937,"2015",0,0,1,1
220937,"2016",1,0,0,1
220937,"2017",0,0,1,1
220937,"2018",1,0,1,2
220937,"2019",0,1,0,1
220937,"2023",0,0,1,1
220940,"2015",0,0,1,1
220940,"2017",0,0,1,1
220940,"2018",0,0,1,1
220940,"2019",0,0,1,1
220940,"2020",0,0,2,2
220940,"2021",0,0,2,2
220940,"2022",1,0,3,4
220940,"2023",1,0,4,5
220945,"2015",2,0,1,3
220945,"2017",0,0,1,1
220945,"2018",0,0,1,1
220945,"2019",1,0,2,3
220945,"2021",1,0,0,1
220950,"2019",0,0,2,2
220950,"2020",1,0,0,1
220955,"2015",1,1,4,6
220955,"2016",0,0,3,3
220955,"2017",2,0,4,6
220955,"2018",0,0,4,4
220955,"2019",1,2,4,7
220955,"2020",2,0,1,3
220955,"2021",0,0,2,2
220955,"2023",0,0,1,1
220960,"2015",0,0,1,1
220960,"2020",0,2,0,2
220965,"2015",1,0,2,3
220965,"2016",1,0,0,1
220965,"2017",1,0,0,1
220965,"2018",1,0,2,3
220965,"2019",1,1,0,2
220965,"2020",1,0,2,3
220965,"2021",1,0,2,3
220965,"2022",2,0,1,3
220965,"2023",0,0,1,1
220970,"2016",1,0,3,4
220970,"2017",2,0,7,9
220970,"2018",0,0,5,5
220970,"2019",1,2,5,8
220970,"2020",0,0,1,1
220970,"2021",0,1,2,3
220970,"2022",1,0,3,4
220970,"2023",2,0,1,3
220975,"2015",0,0,2,2
220975,"2016",0,0,4,4
220975,"2017",0,0,4,4
220975,"2018",2,1,0,3
220975,"2019",2,0,3,5
220975,"2020",1,0,3,4
220975,"2021",2,0,2,4
220975,"2022",0,0,3,3
220975,"2023",0,1,1,2
220980,"2015",1,0,3,4
220980,"2016",1,0,1,2
220980,"2018",2,1,1,4
220980,"2019",1,0,1,2
220980,"2020",1,0,0,1
220980,"2021",1,0,0,1
220980,"2022",0,0,1,1
220980,"2023",1,0,1,2
220985,"2018",2,1,1,4
220985,"2020",2,0,1,3
220985,"2023",0,0,1,1
220987,"2015",2,0,3,5
220987,"2016",0,1,1,2
220987,"2017",1,0,1,2
220987,"2018",1,0,3,4
220987,"2019",0,0,2,2
220987,"2020",0,0,4,4
220987,"2021",0,1,1,2
220987,"2022",3,0,7,10
220987,"2023",1,0,1,2
220990,"2015",1,0,1,2
220990,"2016",1,0,2,3
220990,"2017",1,0,2,3
220990,"2019",0,0,2,2
220990,"2020",1,0,2,3
220990,"2021",0,0,1,1
220990,"2022",1,0,0,1
220990,"2023",1,0,0,1
220995,"2017",1,0,1,2
220995,"2018",0,0,1,1
220995,"2019",0,0,1,1
220995,"2022",0,0,1,1
220995,"2023",0,0,1,1
220997,"2015",0,0,1,1
220997,"2016",1,0,4,5
220997,"2018",2,0,0,2
220997,"2019",0,0,3,3
220997,"2020",2,1,0,3
220997,"2021",1,0,2,3
220997,"2022",2,0,5,7
220997,"2023",0,0,1,1
221000,"2015",1,0,12,13
221000,"2016",1,1,8,10
221000,"2017",5,1,7,13
221000,"2018",2,1,6,9
221000,"2019",4,0,3,7
221000,"2020",4,0,4,8
221000,"2021",9,1,18,28
221000,"2022",4,2,8,14
221000,"2023",2,1,4,7
221005,"2015",1,0,1,2
221005,"2016",0,2,3,5
221005,"2017",2,1,2,5
221005,"2018",1,1,2,4
221005,"2019",2,0,1,3
221005,"2020",2,0,2,4
221005,"2021",1,0,1,2
221005,"2022",1,0,1,2
221005,"2023",2,0,2,4
221010,"2016",1,0,0,1
221010,"2017",0,1,4,5
221010,"2018",1,0,1,2
221010,"2019",0,1,1,2
221010,"2020",0,0,2,2
221010,"2021",1,0,3,4
221010,"2022",0,1,1,2
221020,"2018",0,1,2,3
221020,"2020",0,0,2,2
221020,"2021",1,0,0,1
221020,"2022",3,0,4,7
221020,"2023",0,0,4,4
221030,"2015",0,0,1,1
221030,"2018",1,0,2,3
221030,"2019",2,0,0,2
221030,"2020",0,0,1,1
221030,"2021",1,0,1,2
221030,"2022",0,0,2,2
221030,"2023",1,0,1,2
221035,"2015",3,0,1,4
221035,"2016",3,1,2,6
221035,"2017",2,0,2,4
221035,"2018",2,0,2,4
221035,"2019",1,0,2,3
221035,"2020",0,0,1,1
221035,"2021",2,0,1,3
221035,"2022",3,1,1,5
221035,"2023",2,0,1,3
221037,"2021",1,0,0,1
221037,"2023",1,0,0,1
221038,"2016",0,0,1,1
221038,"2017",0,0,1,1
221038,"2018",1,0,0,1
221038,"2019",1,0,5,6
221038,"2023",2,1,0,3
221039,"2015",0,1,2,3
221039,"2017",1,0,0,1
221039,"2018",1,0,0,1
221039,"2019",0,0,1,1
221040,"2015",3,2,4,9
221040,"2016",7,2,7,16
221040,"2017",2,2,6,10
221040,"2018",3,1,10,14
221040,"2019",4,2,6,12
221040,"2020",5,0,4,9
221040,"2021",1,0,6,7
221040,"2022",5,2,5,12
221040,"2023",0,2,6,8
221050,"2015",5,1,4,10
221050,"2016",2,0,5,7
221050,"2017",5,1,3,9
221050,"2018",1,2,4,7
221050,"2019",5,0,4,9
221050,"2020",4,0,4,8
221050,"2021",5,0,6,11
221050,"2022",2,0,7,9
221050,"2023",2,1,1,4
221060,"2015",14,1,27,42
221060,"2016",8,2,29,39
221060,"2017",12,2,35,49
221060,"2018",13,1,29,43
221060,"2019",14,3,29,46
221060,"2020",15,2,29,46
221060,"2021",7,0,35,42
221060,"2022",12,2,18,32
221060,"2023",11,0,15,26
221062,"2015",0,0,1,1
221062,"2016",0,0,2,2
221062,"2017",0,0,2,2
221062,"2018",0,0,2,2
221062,"2019",0,0,1,1
221062,"2020",0,0,1,1
221062,"2021",2,0,2,4
221062,"2022",0,0,1,1
221063,"2016",2,0,1,3
221063,"2017",2,0,2,4
221063,"2018",1,0,1,2
221063,"2019",1,0,2,3
221063,"2020",1,0,1,2
221063,"2021",1,0,1,2
221063,"2022",3,0,3,6
221063,"2023",1,1,0,2
221065,"2015",1,0,1,2
221065,"2017",0,0,3,3
221065,"2018",0,0,2,2
221065,"2019",1,1,3,5
221065,"2020",0,0,2,2
221065,"2021",3,0,1,4
221065,"2022",1,1,3,5
221065,"2023",2,1,1,4
221070,"2015",1,1,1,3
221070,"2016",0,0,1,1
221070,"2017",1,0,0,1
221070,"2018",0,0,2,2
221070,"2020",2,0,2,4
221070,"2022",1,0,3,4
221070,"2023",0,0,1,1
221080,"2015",2,0,2,4
221080,"2016",0,0,5,5
221080,"2017",0,1,2,3
221080,"2018",0,0,5,5
221080,"2019",2,2,3,7
221080,"2020",1,0,1,2
221080,"2021",1,0,1,2
221080,"2022",0,0,3,3
221080,"2023",0,1,2,3
221090,"2015",1,1,0,2
221090,"2016",0,0,1,1
221090,"2018",0,0,1,1
221090,"2020",0,0,2,2
221093,"2016",1,0,0,1
221093,"2019",1,0,1,2
221093,"2020",1,0,1,2
221093,"2021",1,0,2,3
221093,"2022",1,0,1,2
221093,"2023",0,0,1,1
221095,"2015",1,0,2,3
221095,"2016",0,0,1,1
221095,"2017",1,0,2,3
221095,"2018",0,0,2,2
221095,"2019",0,1,2,3
221095,"2020",0,0,1,1
221095,"2021",1,1,0,2
221095,"2022",1,0,0,1
221097,"2015",0,0,1,1
221097,"2016",1,0,0,1
221097,"2017",0,1,2,3
221097,"2018",1,0,1,2
221097,"2019",1,0,1,2
221097,"2020",0,0,2,2
221097,"2022",0,0,1,1
221100,"2015",296,62,689,1047
221100,"2016",242,37,702,981
221100,"2017",282,49,628,959
221100,"2018",272,59,646,977
221100,"2019",258,56,572,886
221100,"2020",209,45,396,650
221100,"2021",208,33,382,623
221100,"2022",198,34,320,552
221100,"2023",139,44,257,440
221110,"2015",12,0,19,31
221110,"2016",7,2,17,26
221110,"2017",10,2,20,32
221110,"2018",10,0,32,42
221110,"2019",10,2,18,30
221110,"2020",7,1,9,17
221110,"2021",7,0,10,17
221110,"2022",16,2,14,32
221110,"2023",13,1,11,25
221120,"2015",1,0,1,2
221120,"2016",3,0,14,17
221120,"2017",6,0,12,18
221120,"2018",6,1,17,24
221120,"2019",4,4,15,23
221120,"2020",5,0,2,7
221120,"2021",1,1,1,3
221120,"2022",0,0,2,2
221120,"2023",0,1,1,2
221130,"2015",6,1,15,22
221130,"2016",7,0,23,30
221130,"2017",8,2,22,32
221130,"2018",10,0,14,24
221130,"2019",10,2,29,41
221130,"2020",12,2,22,36
221130,"2021",11,2,17,30
221130,"2022",8,1,9,18
221130,"2023",4,0,15,19
221135,"2015",0,0,1,1
221135,"2016",1,0,2,3
221135,"2017",0,0,3,3
221135,"2018",1,0,2,3
221135,"2019",3,0,0,3
221135,"2020",1,0,2,3
221135,"2021",0,0,1,1
221135,"2022",1,0,2,3
221135,"2023",3,0,0,3
221140,"2016",3,0,3,6
221140,"2017",3,1,1,5
221140,"2018",0,0,4,4
221140,"2019",2,0,1,3
221140,"2020",2,1,3,6
221140,"2021",1,0,1,2
221140,"2022",1,0,2,3
221140,"2023",1,0,1,2
221150,"2018",1,0,0,1
221150,"2019",0,0,1,1
221150,"2021",0,0,1,1
221150,"2022",1,0,0,1
221150,"2023",1,1,2,4
221160,"2019",1,0,0,1
221160,"2021",1,0,1,2
221160,"2023",1,0,0,1
221170,"2017",0,0,1,1
221170,"2018",0,0,1,1
221170,"2020",0,0,1,1
230010,"2015",1,0,2,3
230010,"2016",0,0,4,4
230010,"2017",2,2,4,8
230010,"2018",0,0,5,5
230010,"2019",4,0,0,4
230010,"2020",0,0,2,2
230010,"2021",1,1,1,3
230010,"2022",1,1,2,4
230010,"2023",1,0,1,2
230015,"2015",2,1,8,11
230015,"2016",3,1,10,14
230015,"2017",4,1,5,10
230015,"2018",4,0,11,15
230015,"2019",5,1,10,16
230015,"2020",4,0,6,10
230015,"2021",4,0,7,11
230015,"2022",6,2,8,16
230015,"2023",2,0,4,6
230020,"2015",24,6,44,74
230020,"2016",20,3,26,49
230020,"2017",24,8,26,58
230020,"2018",26,2,32,60
230020,"2019",17,3,29,49
230020,"2020",29,8,33,70
230020,"2021",18,3,27,48
230020,"2022",17,4,28,49
230020,"2023",21,10,17,48
230030,"2015",1,0,3,4
230030,"2016",2,0,0,2
230030,"2017",1,0,1,2
230030,"2018",1,1,4,6
230030,"2019",0,1,1,2
230030,"2020",0,0,2,2
230030,"2021",0,1,3,4
230030,"2022",1,0,1,2
230030,"2023",0,0,2,2
230040,"2015",0,0,2,2
230040,"2016",2,0,1,3
230040,"2017",0,1,2,3
230040,"2019",3,1,2,6
230040,"2020",1,1,6,8
230040,"2021",2,1,7,10
230040,"2022",6,0,6,12
230040,"2023",1,1,0,2
230050,"2015",3,2,3,8
230050,"2016",4,0,2,6
230050,"2017",2,1,3,6
230050,"2018",4,1,3,8
230050,"2019",3,1,4,8
230050,"2020",0,4,5,9
230050,"2021",6,0,2,8
230050,"2022",2,1,3,6
230050,"2023",2,1,3,6
230060,"2015",2,0,4,6
230060,"2016",4,0,7,11
230060,"2017",2,0,3,5
230060,"2018",1,0,3,4
230060,"2019",2,1,2,5
230060,"2020",1,1,6,8
230060,"2021",5,0,2,7
230060,"2022",5,0,4,9
230060,"2023",1,0,1,2
230070,"2015",6,0,15,21
230070,"2016",2,2,12,16
230070,"2017",4,1,11,16
230070,"2018",7,1,11,19
230070,"2019",7,1,12,20
230070,"2020",4,2,12,18
230070,"2021",10,2,5,17
230070,"2022",5,0,5,10
230070,"2023",2,0,5,7
230075,"2015",10,5,22,37
230075,"2016",11,5,22,38
230075,"2017",8,2,26,36
230075,"2018",16,6,25,47
230075,"2019",21,6,23,50
230075,"2020",12,2,27,41
230075,"2021",12,2,16,30
230075,"2022",17,5,20,42
230075,"2023",9,3,17,29
230080,"2015",0,0,1,1
230080,"2016",2,1,1,4
230080,"2017",1,0,3,4
230080,"2018",2,1,6,9
230080,"2019",6,1,2,9
230080,"2020",4,1,5,10
230080,"2021",2,1,2,5
230080,"2022",1,0,1,2
230080,"2023",3,1,0,4
230090,"2015",1,0,4,5
230090,"2016",1,1,0,2
230090,"2017",1,0,2,3
230090,"2018",0,0,2,2
230090,"2019",1,0,0,1
230090,"2020",0,0,1,1
230090,"2021",1,1,1,3
230090,"2022",0,0,2,2
230090,"2023",0,0,1,1
230100,"2015",17,4,42,63
230100,"2016",23,4,40,67
230100,"2017",17,2,34,53
230100,"2018",26,7,39,72
230100,"2019",20,5,38,63
230100,"2020",13,6,25,44
230100,"2021",20,7,38,65
230100,"2022",21,10,20,51
230100,"2023",10,2,25,37
230110,"2015",43,14,71,128
230110,"2016",36,9,66,111
230110,"2017",27,5,59,91
230110,"2018",40,9,46,95
230110,"2019",28,8,40,76
230110,"2020",27,5,34,66
230110,"2021",29,4,37,70
230110,"2022",34,4,38,76
230110,"2023",16,4,30,50
230120,"2015",11,1,21,33
230120,"2016",11,5,25,41
230120,"2017",5,6,19,30
230120,"2018",13,1,25,39
230120,"2019",14,3,15,32
230120,"2020",12,5,4,21
230120,"2021",6,4,16,26
230120,"2022",6,8,14,28
230120,"2023",10,2,18,30
230125,"2015",2,1,3,6
230125,"2016",6,1,3,10
230125,"2017",5,0,4,9
230125,"2018",2,2,3,7
230125,"2019",4,0,2,6
230125,"2020",4,1,6,11
230125,"2021",2,2,5,9
230125,"2022",1,1,1,3
230125,"2023",2,1,2,5
230130,"2015",8,0,14,22
230130,"2016",5,2,18,25
230130,"2017",6,2,12,20
230130,"2018",4,2,12,18
230130,"2019",9,4,20,33
230130,"2020",5,1,16,22
230130,"2021",9,2,13,24
230130,"2022",5,1,11,17
230130,"2023",1,1,2,4
230140,"2015",6,0,9,15
230140,"2016",2,2,2,6
230140,"2017",0,0,7,7
230140,"2018",7,1,6,14
230140,"2019",4,2,6,12
230140,"2020",3,2,4,9
230140,"2021",4,0,7,11
230140,"2022",9,0,3,12
230140,"2023",3,0,4,7
230150,"2015",1,0,1,2
230150,"2019",1,0,2,3
230150,"2020",1,1,3,5
230150,"2021",4,1,3,8
230150,"2022",0,2,0,2
230150,"2023",0,1,0,1
230160,"2015",4,3,17,24
230160,"2016",5,1,5,11
230160,"2017",7,1,10,18
230160,"2018",8,2,14,24
230160,"2019",7,3,15,25
230160,"2020",7,1,15,23
230160,"2021",10,2,14,26
230160,"2022",7,3,7,17
230160,"2023",0,0,4,4
230170,"2015",7,1,5,13
230170,"2016",3,1,8,12
230170,"2017",3,0,7,10
230170,"2018",3,1,6,10
230170,"2019",4,3,11,18
230170,"2020",7,0,9,16
230170,"2021",3,1,6,10
230170,"2022",2,1,1,4
230170,"2023",2,0,2,4
230180,"2015",0,0,6,6
230180,"2016",0,0,4,4
230180,"2017",1,1,1,3
230180,"2018",0,2,1,3
230180,"2019",0,0,3,3
230180,"2020",0,1,0,1
230180,"2021",1,0,2,3
230180,"2022",2,0,1,3
230180,"2023",0,1,3,4
230185,"2015",8,2,11,21
230185,"2016",8,2,5,15
230185,"2017",12,2,17,31
230185,"2018",15,1,15,31
230185,"2019",4,6,19,29
230185,"2020",8,2,7,17
230185,"2021",5,1,11,17
230185,"2022",10,5,20,35
230185,"2023",11,3,6,20
230190,"2015",15,3,32,50
230190,"2016",23,7,28,58
230190,"2017",15,5,22,42
230190,"2018",23,2,30,55
230190,"2019",21,8,28,57
230190,"2020",21,3,31,55
230190,"2021",18,3,23,44
230190,"2022",12,2,9,23
230190,"2023",13,6,20,39
230195,"2015",5,0,10,15
230195,"2016",4,1,16,21
230195,"2017",3,0,17,20
230195,"2018",7,2,16,25
230195,"2019",6,3,15,24
230195,"2020",5,1,12,18
230195,"2021",7,4,11,22
230195,"2022",4,1,11,16
230195,"2023",4,2,3,9
230200,"2015",2,0,9,11
230200,"2016",1,0,5,6
230200,"2017",4,0,7,11
230200,"2018",1,1,5,7
230200,"2019",1,1,6,8
230200,"2020",2,0,6,8
230200,"2021",3,2,7,12
230200,"2022",2,1,7,10
230205,"2015",7,0,6,13
230205,"2016",4,1,7,12
230205,"2017",7,0,12,19
230205,"2018",6,0,6,12
230205,"2019",7,0,13,20
230205,"2020",6,1,2,9
230205,"2021",5,0,8,13
230205,"2022",8,0,13,21
230205,"2023",0,1,3,4
230210,"2015",8,2,29,39
230210,"2016",13,3,17,33
230210,"2017",7,4,27,38
230210,"2018",10,8,20,38
230210,"2019",12,5,19,36
230210,"2020",11,3,21,35
230210,"2021",15,5,20,40
230210,"2022",11,1,19,31
230210,"2023",9,2,11,22
230220,"2015",4,2,21,27
230220,"2016",10,2,15,27
230220,"2017",11,0,14,25
230220,"2018",12,2,18,32
230220,"2019",16,5,14,35
230220,"2020",13,3,20,36
230220,"2021",11,2,5,18
230220,"2022",5,4,11,20
230220,"2023",7,2,13,22
230230,"2015",13,2,21,36
230230,"2016",4,0,8,12
230230,"2017",10,2,14,26
230230,"2018",13,0,17,30
230230,"2019",8,2,6,16
230230,"2020",1,2,3,6
230230,"2021",10,1,8,19
230230,"2022",7,1,11,19
230230,"2023",7,2,9,18
230240,"2015",13,2,17,32
230240,"2016",4,3,23,30
230240,"2017",7,2,13,22
230240,"2018",10,2,13,25
230240,"2019",15,3,29,47
230240,"2020",17,2,16,35
230240,"2021",5,0,10,15
230240,"2022",5,2,11,18
230240,"2023",6,8,19,33
230250,"2015",6,1,23,30
230250,"2016",8,1,14,23
230250,"2017",12,1,19,32
230250,"2018",9,2,17,28
230250,"2019",16,3,20,39
230250,"2020",3,0,18,21
230250,"2021",3,0,7,10
230250,"2022",7,3,13,23
230250,"2023",5,1,3,9
230260,"2015",30,6,53,89
230260,"2016",15,7,53,75
230260,"2017",31,1,51,83
230260,"2018",22,7,39,68
230260,"2019",29,5,41,75
230260,"2020",19,10,36,65
230260,"2021",18,6,33,57
230260,"2022",29,8,54,91
230260,"2023",28,7,35,70
230270,"2015",8,1,17,26
230270,"2016",7,1,19,27
230270,"2017",6,1,11,18
230270,"2018",7,3,18,28
230270,"2019",5,4,17,26
230270,"2020",6,3,16,25
230270,"2021",9,0,13,22
230270,"2022",5,4,15,24
230270,"2023",2,0,4,6
230280,"2015",26,9,43,78
230280,"2016",27,5,37,69
230280,"2017",18,10,54,82
230280,"2018",34,5,58,97
230280,"2019",37,7,44,88
230280,"2020",37,10,43,90
230280,"2021",29,15,46,90
230280,"2022",32,9,31,72
230280,"2023",16,5,25,46
230290,"2015",12,1,15,28
230290,"2016",8,0,10,18
230290,"2017",7,3,11,21
230290,"2018",12,2,11,25
230290,"2019",7,1,13,21
230290,"2020",7,0,11,18
230290,"2021",9,3,8,20
230290,"2022",11,2,10,23
230290,"2023",3,1,7,11
230300,"2015",6,0,12,18
230300,"2016",4,1,9,14
230300,"2017",2,1,11,14
230300,"2018",10,0,14,24
230300,"2019",7,1,11,19
230300,"2020",6,0,10,16
230300,"2021",2,1,6,9
230300,"2022",4,1,3,8
230300,"2023",1,0,3,4
230310,"2015",5,3,9,17
230310,"2016",4,0,7,11
230310,"2017",8,2,4,14
230310,"2018",7,1,6,14
230310,"2019",6,0,5,11
230310,"2020",1,1,5,7
230310,"2021",0,3,4,7
230310,"2022",6,1,4,11
230310,"2023",2,0,2,4
230320,"2016",0,0,1,1
230320,"2019",1,0,0,1
230320,"2021",1,3,3,7
230320,"2022",2,0,1,3
230330,"2015",1,0,5,6
230330,"2016",2,1,4,7
230330,"2017",4,1,4,9
230330,"2018",3,0,7,10
230330,"2019",3,1,4,8
230330,"2020",2,0,6,8
230330,"2021",3,1,1,5
230330,"2022",6,0,6,12
230330,"2023",0,0,7,7
230340,"2015",3,2,15,20
230340,"2016",5,3,15,23
230340,"2017",5,3,6,14
230340,"2018",6,3,12,21
230340,"2019",6,0,5,11
230340,"2020",3,2,7,12
230340,"2021",6,3,7,16
230340,"2022",3,5,7,15
230340,"2023",3,0,7,10
230350,"2015",24,7,59,90
230350,"2016",25,9,39,73
230350,"2017",27,9,40,76
230350,"2018",17,13,36,66
230350,"2019",34,14,32,80
230350,"2020",33,12,40,85
230350,"2021",36,10,32,78
230350,"2022",17,16,42,75
230350,"2023",23,7,28,58
230360,"2015",4,0,3,7
230360,"2016",3,0,1,4
230360,"2017",1,0,0,1
230360,"2018",3,1,6,10
230360,"2019",2,0,0,2
230360,"2020",4,0,1,5
230360,"2021",1,0,3,4
230360,"2022",0,0,1,1
230360,"2023",1,1,3,5
230365,"2015",3,0,6,9
230365,"2016",3,0,3,6
230365,"2017",4,0,3,7
230365,"2018",2,1,1,4
230365,"2019",2,2,6,10
230365,"2021",1,0,1,2
230365,"2022",2,0,1,3
230365,"2023",2,0,2,4
230370,"2015",50,13,106,169
230370,"2016",49,13,86,148
230370,"2017",24,7,43,74
230370,"2018",36,11,57,104
230370,"2019",25,8,55,88
230370,"2020",34,7,46,87
230370,"2021",26,8,34,68
230370,"2022",15,5,28,48
230370,"2023",6,5,26,37
230380,"2015",3,0,6,9
230380,"2016",1,0,3,4
230380,"2017",1,1,4,6
230380,"2018",3,0,3,6
230380,"2019",4,0,3,7
230380,"2020",4,1,3,8
230380,"2021",3,1,1,5
230380,"2022",0,0,2,2
230390,"2015",3,1,6,10
230390,"2016",2,1,3,6
230390,"2017",3,3,5,11
230390,"2018",4,1,9,14
230390,"2019",0,1,5,6
230390,"2020",2,0,9,11
230390,"2021",6,2,3,11
230390,"2022",2,1,3,6
230390,"2023",3,1,5,9
230393,"2015",4,0,5,9
230393,"2016",9,1,8,18
230393,"2017",5,1,20,26
230393,"2018",9,2,12,23
230393,"2019",6,2,9,17
230393,"2020",10,1,10,21
230393,"2021",8,0,9,17
230393,"2022",11,1,12,24
230393,"2023",3,3,4,10
230395,"2015",3,0,5,8
230395,"2016",1,0,5,6
230395,"2017",0,2,5,7
230395,"2018",2,0,5,7
230395,"2019",4,1,9,14
230395,"2020",3,4,8,15
230395,"2021",6,2,2,10
230395,"2022",0,0,5,5
230395,"2023",4,2,4,10
230400,"2015",3,2,17,22
230400,"2016",8,4,11,23
230400,"2017",9,3,5,17
230400,"2018",9,0,6,15
230400,"2019",2,1,7,10
230400,"2020",4,0,5,9
230400,"2021",1,2,2,5
230400,"2022",5,0,1,6
230400,"2023",1,0,8,9
230410,"2015",33,11,56,100
230410,"2016",30,6,46,82
230410,"2017",29,7,61,97
230410,"2018",18,4,36,58
230410,"2019",16,4,43,63
230410,"2020",21,6,42,69
230410,"2021",16,6,28,50
230410,"2022",19,5,22,46
230410,"2023",21,6,28,55
230420,"2015",55,17,135,207
230420,"2016",70,17,111,198
230420,"2017",72,14,113,199
230420,"2018",79,21,122,222
230420,"2019",68,14,119,201
230420,"2020",65,15,137,217
230420,"2021",80,11,110,201
230420,"2022",55,11,65,131
230420,"2023",15,4,27,46
230423,"2015",4,1,9,14
230423,"2016",5,1,4,10
230423,"2017",2,1,5,8
230423,"2018",2,0,3,5
230423,"2019",2,0,4,6
230423,"2020",1,0,3,4
230423,"2021",3,3,5,11
230423,"2022",6,2,4,12
230423,"2023",3,1,1,5
230425,"2015",9,2,8,19
230425,"2016",8,2,6,16
230425,"2017",9,2,13,24
230425,"2018",11,6,20,37
230425,"2019",14,4,9,27
230425,"2020",4,4,13,21
230425,"2021",8,2,9,19
230425,"2022",10,3,9,22
230425,"2023",12,0,8,20
230426,"2015",2,0,2,4
230426,"2016",0,0,1,1
230426,"2017",2,0,1,3
230426,"2018",0,0,4,4
230426,"2020",1,0,2,3
230426,"2021",0,0,3,3
230426,"2022",0,0,1,1
230426,"2023",0,0,1,1
230427,"2015",1,0,2,3
230427,"2016",1,0,2,3
230427,"2017",1,1,4,6
230427,"2018",4,0,4,8
230427,"2019",1,0,2,3
230427,"2020",0,0,4,4
230427,"2022",1,0,1,2
230427,"2023",0,1,3,4
230428,"2015",24,7,29,60
230428,"2016",23,4,35,62
230428,"2017",22,7,44,73
230428,"2018",25,4,70,99
230428,"2019",25,3,50,78
230428,"2020",21,2,42,65
230428,"2021",20,5,31,56
230428,"2022",20,10,21,51
230428,"2023",8,4,21,33
230430,"2015",5,2,14,21
230430,"2016",9,0,11,20
230430,"2017",6,1,18,25
230430,"2018",7,1,10,18
230430,"2019",8,2,15,25
230430,"2020",2,1,13,16
230430,"2021",6,2,16,24
230430,"2022",4,1,13,18
230430,"2023",0,1,2,3
230435,"2015",8,0,12,20
230435,"2016",5,1,19,25
230435,"2017",9,0,10,19
230435,"2018",2,3,7,12
230435,"2019",5,4,10,19
230435,"2020",4,0,3,7
230435,"2021",7,1,6,14
230435,"2022",2,2,7,11
230435,"2023",5,1,4,10
230440,"2015",851,225,1614,2690
230440,"2016",769,176,1506,2451
230440,"2017",746,208,1366,2320
230440,"2018",726,199,1246,2171
230440,"2019",709,213,1155,2077
230440,"2020",555,167,947,1669
230440,"2021",432,141,769,1342
230440,"2022",458,140,832,1430
230440,"2023",372,125,591,1088
230445,"2015",6,2,5,13
230445,"2016",2,1,4,7
230445,"2017",1,2,8,11
230445,"2018",1,0,6,7
230445,"2019",5,0,7,12
230445,"2020",6,1,6,13
230445,"2021",5,1,3,9
230445,"2022",10,1,13,24
230445,"2023",2,0,4,6
230450,"2015",4,2,8,14
230450,"2016",3,1,3,7
230450,"2017",1,1,4,6
230450,"2018",6,0,6,12
230450,"2019",4,1,3,8
230450,"2020",2,1,3,6
230450,"2021",1,0,6,7
230450,"2022",4,1,8,13
230450,"2023",4,1,2,7
230460,"2015",2,0,0,2
230460,"2016",0,1,2,3
230460,"2018",0,0,3,3
230460,"2019",0,0,1,1
230460,"2020",1,0,0,1
230465,"2015",8,4,8,20
230465,"2016",5,2,6,13
230465,"2017",5,1,4,10
230465,"2018",5,0,3,8
230465,"2019",4,3,2,9
230465,"2020",0,0,3,3
230465,"2021",2,0,1,3
230465,"2022",2,1,4,7
230465,"2023",1,1,3,5
230470,"2015",13,2,22,37
230470,"2016",15,0,24,39
230470,"2017",6,1,27,34
230470,"2018",14,5,33,52
230470,"2019",16,3,22,41
230470,"2020",13,5,29,47
230470,"2021",18,6,29,53
230470,"2022",15,3,20,38
230470,"2023",9,4,21,34
230480,"2015",0,1,0,1
230480,"2016",1,1,0,2
230480,"2017",4,0,0,4
230480,"2018",0,0,1,1
230480,"2019",2,1,1,4
230480,"2020",0,1,3,4
230480,"2021",1,0,1,2
230480,"2022",0,0,2,2
230480,"2023",1,0,0,1
230490,"2015",5,2,8,15
230490,"2016",0,0,5,5
230490,"2017",6,0,2,8
230490,"2018",2,0,7,9
230490,"2019",2,0,2,4
230490,"2020",0,0,2,2
230490,"2021",3,1,1,5
230490,"2022",1,1,1,3
230490,"2023",1,0,2,3
230495,"2015",4,0,4,8
230495,"2016",2,1,10,13
230495,"2017",6,0,14,20
230495,"2018",12,0,4,16
230495,"2019",5,2,14,21
230495,"2020",7,2,8,17
230495,"2021",7,1,11,19
230495,"2022",1,1,12,14
230495,"2023",3,1,1,5
230500,"2015",8,1,20,29
230500,"2016",11,2,12,25
230500,"2017",10,3,16,29
230500,"2018",18,4,31,53
230500,"2019",10,6,12,28
230500,"2020",9,3,15,27
230500,"2021",8,1,16,25
230500,"2022",7,3,15,25
230500,"2023",4,4,13,21
230510,"2015",1,2,3,6
230510,"2016",2,1,3,6
230510,"2017",1,0,4,5
230510,"2018",1,2,4,7
230510,"2019",2,2,3,7
230510,"2020",2,0,0,2
230510,"2021",1,0,0,1
230510,"2022",0,1,2,3
230510,"2023",4,0,5,9
230520,"2015",7,0,5,12
230520,"2016",2,2,8,12
230520,"2017",4,2,5,11
230520,"2018",4,1,3,8
230520,"2019",1,0,5,6
230520,"2020",1,2,9,12
230520,"2021",3,1,6,10
230520,"2022",1,1,1,3
230520,"2023",2,1,2,5
230523,"2015",40,9,58,107
230523,"2016",24,10,58,92
230523,"2017",20,6,40,66
230523,"2018",38,5,56,99
230523,"2019",38,9,48,95
230523,"2020",31,6,42,79
230523,"2021",33,12,46,91
230523,"2022",32,13,48,93
230523,"2023",39,6,33,78
230526,"2015",2,0,5,7
230526,"2016",3,2,5,10
230526,"2017",6,6,14,26
230526,"2018",5,3,9,17
230526,"2019",2,4,10,16
230526,"2020",4,3,7,14
230526,"2021",7,0,9,16
230526,"2022",0,0,8,8
230526,"2023",5,1,4,10
230530,"2015",6,3,17,26
230530,"2016",5,2,19,26
230530,"2017",10,2,14,26
230530,"2018",7,4,18,29
230530,"2019",11,3,13,27
230530,"2020",4,3,7,14
230530,"2021",9,4,15,28
230530,"2022",9,4,16,29
230530,"2023",6,1,7,14
230533,"2015",3,1,3,7
230533,"2016",4,1,7,12
230533,"2017",4,0,6,10
230533,"2018",5,2,5,12
230533,"2019",4,2,6,12
230533,"2020",6,3,4,13
230533,"2021",1,0,2,3
230533,"2022",4,2,6,12
230533,"2023",2,0,7,9
230535,"2015",8,1,18,27
230535,"2016",7,2,8,17
230535,"2017",13,1,11,25
230535,"2018",9,0,8,17
230535,"2019",13,2,10,25
230535,"2020",3,1,6,10
230535,"2021",8,3,6,17
230535,"2022",2,2,9,13
230535,"2023",3,0,3,6
230540,"2015",17,5,36,58
230540,"2016",19,0,31,50
230540,"2017",27,2,50,79
230540,"2018",26,4,35,65
230540,"2019",16,2,26,44
230540,"2020",21,5,29,55
230540,"2021",18,8,35,61
230540,"2022",18,10,22,50
230540,"2023",13,2,10,25
230550,"2015",29,9,65,103
230550,"2016",47,5,75,127
230550,"2017",38,7,62,107
230550,"2018",51,10,71,132
230550,"2019",31,9,50,90
230550,"2020",40,6,53,99
230550,"2021",32,15,43,90
230550,"2022",32,10,37,79
230550,"2023",27,4,31,62
230560,"2015",4,2,7,13
230560,"2016",8,0,8,16
230560,"2017",6,0,9,15
230560,"2018",5,0,5,10
230560,"2019",2,2,5,9
230560,"2020",2,0,3,5
230560,"2021",3,1,2,6
230560,"2022",3,3,5,11
230560,"2023",2,0,1,3
230565,"2015",7,2,4,13
230565,"2016",4,2,4,10
230565,"2017",1,0,8,9
230565,"2018",2,1,5,8
230565,"2019",0,2,1,3
230565,"2020",1,1,3,5
230565,"2021",0,1,5,6
230565,"2022",1,2,3,6
230565,"2023",0,0,1,1
230570,"2015",1,2,8,11
230570,"2016",1,0,7,8
230570,"2017",4,3,2,9
230570,"2018",3,0,1,4
230570,"2019",2,0,4,6
230570,"2020",0,1,3,4
230570,"2021",1,0,6,7
230570,"2022",2,0,2,4
230570,"2023",0,0,1,1
230580,"2015",12,3,11,26
230580,"2016",18,1,21,40
230580,"2017",13,5,22,40
230580,"2018",21,5,33,59
230580,"2019",15,6,32,53
230580,"2020",20,10,37,67
230580,"2021",21,7,25,53
230580,"2022",20,7,27,54
230580,"2023",22,9,19,50
230590,"2015",10,4,9,23
230590,"2016",8,3,6,17
230590,"2017",9,1,16,26
230590,"2018",4,1,8,13
230590,"2019",3,0,4,7
230590,"2020",7,3,7,17
230590,"2021",10,5,5,20
230590,"2022",5,1,5,11
230590,"2023",7,0,12,19
230600,"2015",10,2,11,23
230600,"2016",3,2,15,20
230600,"2017",3,5,15,23
230600,"2018",6,3,10,19
230600,"2019",3,3,12,18
230600,"2020",5,1,7,13
230600,"2021",6,0,8,14
230600,"2022",7,0,8,15
230600,"2023",5,3,3,11
230610,"2015",5,2,14,21
230610,"2016",5,0,6,11
230610,"2017",5,0,17,22
230610,"2018",3,2,15,20
230610,"2019",7,0,13,20
230610,"2020",5,4,8,17
230610,"2021",1,2,9,12
230610,"2022",4,2,10,16
230610,"2023",0,3,12,15
230620,"2015",3,0,2,5
230620,"2016",6,0,6,12
230620,"2017",2,1,3,6
230620,"2018",2,0,5,7
230620,"2019",2,1,3,6
230620,"2020",2,0,1,3
230620,"2021",0,0,4,4
230620,"2022",3,2,1,6
230620,"2023",0,0,4,4
230625,"2015",3,0,11,14
230625,"2016",3,0,9,12
230625,"2017",4,1,9,14
230625,"2018",9,5,14,28
230625,"2019",11,0,16,27
230625,"2020",11,2,11,24
230625,"2021",11,1,9,21
230625,"2022",14,4,14,32
230625,"2023",7,2,7,16
230630,"2015",16,2,29,47
230630,"2016",20,5,21,46
230630,"2017",18,1,27,46
230630,"2018",13,3,21,37
230630,"2019",9,5,17,31
230630,"2020",8,5,11,24
230630,"2021",6,1,7,14
230630,"2022",5,4,7,16
230630,"2023",3,0,1,4
230640,"2015",42,13,78,133
230640,"2016",51,11,86,148
230640,"2017",50,12,93,155
230640,"2018",62,11,86,159
230640,"2019",52,9,66,127
230640,"2020",46,17,72,135
230640,"2021",50,18,80,148
230640,"2022",35,11,71,117
230640,"2023",40,15,64,119
230650,"2015",7,2,6,15
230650,"2016",7,1,9,17
230650,"2017",10,3,12,25
230650,"2018",7,0,6,13
230650,"2019",4,2,12,18
230650,"2020",7,2,4,13
230650,"2021",6,1,8,15
230650,"2022",5,1,6,12
230650,"2023",10,2,4,16
230655,"2015",11,4,16,31
230655,"2016",17,5,15,37
230655,"2017",11,2,21,34
230655,"2018",16,4,21,41
230655,"2019",18,6,16,40
230655,"2020",18,2,14,34
230655,"2021",18,3,19,40
230655,"2022",8,5,12,25
230655,"2023",6,6,10,22
230660,"2015",6,1,11,18
230660,"2016",5,2,15,22
230660,"2017",7,2,20,29
230660,"2018",8,0,9,17
230660,"2019",5,2,8,15
230660,"2020",3,3,15,21
230660,"2021",5,2,10,17
230660,"2022",3,2,5,10
230660,"2023",4,2,7,13
230670,"2015",2,1,12,15
230670,"2016",2,1,7,10
230670,"2017",2,1,3,6
230670,"2018",4,1,2,7
230670,"2019",7,0,5,12
230670,"2020",5,1,7,13
230670,"2021",7,3,5,15
230670,"2022",5,0,9,14
230670,"2023",5,2,8,15
230680,"2015",3,2,18,23
230680,"2016",1,0,5,6
230680,"2017",4,1,3,8
230680,"2018",1,0,9,10
230680,"2019",4,1,9,14
230680,"2020",8,0,12,20
230680,"2021",4,0,2,6
230680,"2022",6,0,6,12
230680,"2023",2,0,4,6
230690,"2015",16,3,40,59
230690,"2016",11,4,23,38
230690,"2017",7,2,20,29
230690,"2018",13,3,24,40
230690,"2019",17,3,19,39
230690,"2020",15,4,11,30
230690,"2021",4,1,3,8
230690,"2022",1,0,3,4
230690,"2023",5,1,3,9
230700,"2015",6,1,14,21
230700,"2016",8,3,16,27
230700,"2017",7,1,14,22
230700,"2018",10,9,12,31
230700,"2019",7,2,11,20
230700,"2020",13,4,6,23
230700,"2021",14,3,13,30
230700,"2022",5,7,13,25
230700,"2023",6,1,6,13
230710,"2015",4,4,10,18
230710,"2016",9,2,9,20
230710,"2017",17,0,2,19
230710,"2018",6,1,13,20
230710,"2019",5,4,11,20
230710,"2020",9,2,9,20
230710,"2021",6,2,3,11
230710,"2022",4,1,8,13
230710,"2023",5,1,6,12
230720,"2015",0,0,3,3
230720,"2016",0,0,2,2
230720,"2017",1,0,5,6
230720,"2018",0,0,5,5
230720,"2019",0,0,1,1
230720,"2020",1,0,2,3
230720,"2021",0,1,1,2
230720,"2023",2,0,0,2
230725,"2015",8,2,18,28
230725,"2016",4,1,13,18
230725,"2017",5,3,17,25
230725,"2018",7,4,14,25
230725,"2019",6,6,16,28
230725,"2020",10,0,10,20
230725,"2021",7,1,11,19
230725,"2022",7,6,10,23
230725,"2023",6,0,10,16
230730,"2015",3,0,9,12
230730,"2016",1,0,4,5
230730,"2017",1,0,1,2
230730,"2018",0,0,1,1
230730,"2019",2,2,2,6
230730,"2020",5,1,12,18
230730,"2021",23,8,37,68
230730,"2022",15,4,44,63
230730,"2023",0,0,8,8
230740,"2015",4,0,9,13
230740,"2016",0,0,4,4
230740,"2017",4,1,7,12
230740,"2018",2,0,6,8
230740,"2019",2,0,6,8
230740,"2020",4,0,3,7
230740,"2021",4,1,4,9
230740,"2022",2,0,4,6
230740,"2023",2,1,2,5
230750,"2015",7,1,14,22
230750,"2016",1,1,6,8
230750,"2017",4,2,13,19
230750,"2018",2,0,10,12
230750,"2019",4,1,7,12
230750,"2020",7,0,7,14
230750,"2021",3,1,1,5
230750,"2022",8,0,2,10
230750,"2023",1,0,5,6
230760,"2015",29,4,64,97
230760,"2016",19,8,54,81
230760,"2017",36,4,65,105
230760,"2018",36,8,56,100
230760,"2019",32,6,45,83
230760,"2020",43,10,60,113
230760,"2021",32,11,33,76
230760,"2022",41,8,32,81
230760,"2023",22,4,28,54
230763,"2015",4,1,6,11
230763,"2016",3,3,7,13
230763,"2017",1,1,5,7
230763,"2018",6,4,5,15
230763,"2019",6,2,4,12
230763,"2020",2,0,12,14
230763,"2021",1,2,5,8
230763,"2022",3,1,6,10
230763,"2023",4,0,2,6
230765,"2015",46,5,99,150
230765,"2016",92,26,175,293
230765,"2017",88,16,170,274
230765,"2018",115,34,182,331
230765,"2019",110,20,187,317
230765,"2020",113,35,165,313
230765,"2021",89,28,147,264
230765,"2022",76,23,157,256
230765,"2023",43,6,60,109
230770,"2015",5,2,8,15
230770,"2016",9,1,19,29
230770,"2017",11,3,18,32
230770,"2018",10,5,17,32
230770,"2019",9,1,24,34
230770,"2020",4,2,25,31
230770,"2021",15,1,31,47
230770,"2022",13,2,9,24
230770,"2023",3,1,5,9
230780,"2015",4,5,20,29
230780,"2016",14,3,29,46
230780,"2017",9,3,19,31
230780,"2018",4,3,13,20
230780,"2019",7,3,13,23
230780,"2020",9,1,16,26
230780,"2021",2,3,9,14
230780,"2022",6,3,18,27
230780,"2023",10,4,10,24
230790,"2015",2,1,13,16
230790,"2016",3,1,8,12
230790,"2017",1,1,11,13
230790,"2018",2,1,5,8
230790,"2019",3,1,4,8
230790,"2020",5,2,4,11
230790,"2021",4,1,11,16
230790,"2022",8,0,2,10
230790,"2023",3,1,4,8
230800,"2015",12,0,22,34
230800,"2016",13,0,21,34
230800,"2017",11,3,32,46
230800,"2018",14,5,24,43
230800,"2019",7,5,10,22
230800,"2020",8,0,14,22
230800,"2021",4,0,10,14
230800,"2022",6,3,7,16
230800,"2023",4,1,9,14
230810,"2015",6,5,24,35
230810,"2016",6,5,23,34
230810,"2017",15,2,16,33
230810,"2018",6,3,20,29
230810,"2019",8,4,11,23
230810,"2020",4,1,6,11
230810,"2021",3,1,6,10
230810,"2022",4,2,6,12
230810,"2023",2,2,1,5
230820,"2015",3,0,7,10
230820,"2016",3,2,4,9
230820,"2017",5,2,6,13
230820,"2018",4,3,4,11
230820,"2019",5,0,7,12
230820,"2020",3,0,2,5
230820,"2021",3,3,6,12
230820,"2022",4,2,5,11
230820,"2023",6,0,3,9
230830,"2015",2,0,9,11
230830,"2016",1,0,3,4
230830,"2017",6,1,12,19
230830,"2018",6,3,10,19
230830,"2019",12,1,8,21
230830,"2020",4,0,7,11
230830,"2021",12,3,11,26
230830,"2022",8,1,11,20
230830,"2023",0,2,1,3
230835,"2015",3,0,3,6
230835,"2016",2,0,8,10
230835,"2017",2,3,7,12
230835,"2018",7,3,5,15
230835,"2019",3,1,9,13
230835,"2020",2,1,2,5
230835,"2021",4,2,2,8
230835,"2022",4,4,4,12
230835,"2023",2,2,0,4
230837,"2015",8,3,11,22
230837,"2016",4,2,14,20
230837,"2017",5,4,10,19
230837,"2018",4,3,6,13
230837,"2019",4,2,6,12
230837,"2020",1,1,8,10
230837,"2021",3,3,8,14
230837,"2022",4,3,3,10
230837,"2023",3,2,2,7
230840,"2015",5,0,12,17
230840,"2016",5,1,15,21
230840,"2017",5,0,14,19
230840,"2018",11,1,17,29
230840,"2019",9,0,15,24
230840,"2020",8,1,8,17
230840,"2021",5,3,9,17
230840,"2022",6,1,10,17
230840,"2023",6,2,15,23
230850,"2015",4,0,1,5
230850,"2016",1,0,3,4
230850,"2017",2,1,5,8
230850,"2018",4,1,3,8
230850,"2019",1,0,1,2
230850,"2020",0,0,1,1
230850,"2021",1,1,4,6
230850,"2022",4,1,6,11
230850,"2023",0,0,4,4
230860,"2015",3,1,10,14
230860,"2016",1,1,4,6
230860,"2017",4,1,9,14
230860,"2018",5,1,6,12
230860,"2019",3,0,4,7
230860,"2020",3,0,2,5
230860,"2021",0,0,5,5
230860,"2022",3,1,4,8
230860,"2023",5,0,0,5
230870,"2015",24,5,69,98
230870,"2016",15,4,24,43
230870,"2017",15,12,35,62
230870,"2018",32,11,49,92
230870,"2019",27,7,35,69
230870,"2020",27,12,30,69
230870,"2021",32,11,45,88
230870,"2022",19,9,38,66
230870,"2023",10,3,35,48
230880,"2015",2,0,6,8
230880,"2016",0,0,2,2
230880,"2017",2,0,2,4
230880,"2018",1,0,0,1
230880,"2019",5,2,1,8
230880,"2020",1,0,1,2
230880,"2021",1,0,0,1
230880,"2022",1,0,3,4
230880,"2023",1,2,1,4
230890,"2015",7,0,9,16
230890,"2016",2,2,15,19
230890,"2017",3,1,13,17
230890,"2018",4,1,6,11
230890,"2019",7,2,4,13
230890,"2020",5,1,9,15
230890,"2021",6,1,5,12
230890,"2022",3,2,8,13
230890,"2023",2,2,8,12
230900,"2015",5,0,8,13
230900,"2016",2,1,10,13
230900,"2017",7,0,7,14
230900,"2018",2,0,6,8
230900,"2019",2,1,6,9
230900,"2020",2,0,6,8
230900,"2021",0,0,2,2
230900,"2022",4,0,2,6
230900,"2023",7,2,3,12
230910,"2015",1,1,5,7
230910,"2016",2,2,3,7
230910,"2017",3,0,4,7
230910,"2018",4,0,3,7
230910,"2019",4,3,3,10
230910,"2020",2,2,4,8
230910,"2021",3,1,4,8
230910,"2022",3,1,3,7
230910,"2023",1,1,2,4
230920,"2015",5,0,13,18
230920,"2016",2,0,8,10
230920,"2017",10,0,12,22
230920,"2018",8,0,13,21
230920,"2019",7,2,12,21
230920,"2020",9,2,13,24
230920,"2021",4,6,15,25
230920,"2022",3,2,5,10
230920,"2023",4,0,2,6
230930,"2015",8,2,9,19
230930,"2016",6,2,13,21
230930,"2017",3,1,8,12
230930,"2018",6,5,18,29
230930,"2019",4,2,12,18
230930,"2020",6,2,7,15
230930,"2021",3,1,14,18
230930,"2022",1,2,12,15
230930,"2023",5,3,4,12
230940,"2015",6,2,17,25
230940,"2016",4,1,13,18
230940,"2017",13,0,16,29
230940,"2018",8,3,5,16
230940,"2019",2,3,10,15
230940,"2020",2,1,6,9
230940,"2021",4,2,8,14
230940,"2022",10,1,2,13
230940,"2023",5,2,5,12
230945,"2015",4,2,7,13
230945,"2016",3,1,14,18
230945,"2017",8,1,11,20
230945,"2018",4,4,4,12
230945,"2019",8,2,10,20
230945,"2020",3,2,3,8
230945,"2021",7,0,6,13
230945,"2022",5,0,1,6
230945,"2023",8,0,6,14
230950,"2015",3,1,15,19
230950,"2016",0,0,7,7
230950,"2017",5,0,11,16
230950,"2018",8,2,6,16
230950,"2019",6,2,10,18
230950,"2020",1,1,6,8
230950,"2021",4,2,7,13
230950,"2022",2,1,6,9
230950,"2023",0,1,1,2
230960,"2015",8,3,26,37
230960,"2016",11,1,24,36
230960,"2017",8,3,31,42
230960,"2018",19,3,36,58
230960,"2019",22,6,49,77
230960,"2020",14,2,27,43
230960,"2021",18,2,21,41
230960,"2022",10,3,30,43
230960,"2023",8,6,21,35
230970,"2015",10,2,21,33
230970,"2016",16,7,38,61
230970,"2017",22,6,35,63
230970,"2018",27,3,36,66
230970,"2019",21,8,33,62
230970,"2020",12,7,41,60
230970,"2021",14,6,28,48
230970,"2022",19,7,25,51
230970,"2023",4,4,10,18
230980,"2015",1,1,4,6
230980,"2016",6,1,6,13
230980,"2017",3,0,5,8
230980,"2018",5,0,5,10
230980,"2019",3,0,8,11
230980,"2020",2,2,4,8
230980,"2021",2,0,4,6
230980,"2022",4,1,4,9
230980,"2023",3,0,5,8
230990,"2015",0,1,4,5
230990,"2016",2,3,1,6
230990,"2017",2,1,4,7
230990,"2018",1,0,0,1
230990,"2019",0,0,4,4
230990,"2021",0,2,4,6
230990,"2022",0,0,2,2
231000,"2015",2,1,3,6
231000,"2016",5,2,4,11
231000,"2017",1,3,2,6
231000,"2018",6,0,4,10
231000,"2019",6,1,1,8
231000,"2020",4,1,6,11
231000,"2021",1,0,1,2
231000,"2022",2,2,4,8
231000,"2023",2,1,1,4
231010,"2015",3,0,0,3
231010,"2016",0,0,1,1
231010,"2017",2,1,3,6
231010,"2018",0,0,8,8
231010,"2019",2,0,4,6
231010,"2020",3,0,3,6
231010,"2021",2,0,0,2
231010,"2022",1,0,1,2
231020,"2015",6,4,7,17
231020,"2016",5,1,3,9
231020,"2017",12,1,3,16
231020,"2018",5,1,8,14
231020,"2019",2,6,8,16
231020,"2020",2,1,6,9
231020,"2021",2,0,1,3
231020,"2022",3,1,4,8
231020,"2023",3,0,6,9
231025,"2015",2,0,2,4
231025,"2016",2,0,4,6
231025,"2017",1,1,3,5
231025,"2018",3,1,6,10
231025,"2019",2,0,1,3
231025,"2020",0,0,1,1
231025,"2021",0,0,1,1
231025,"2023",0,0,2,2
231030,"2015",0,0,2,2
231030,"2016",1,0,0,1
231030,"2017",3,1,0,4
231030,"2018",2,0,3,5
231030,"2019",3,0,5,8
231030,"2020",9,0,4,13
231030,"2021",5,2,3,10
231030,"2022",5,4,8,17
231030,"2023",8,0,8,16
231040,"2015",2,0,3,5
231040,"2016",2,1,4,7
231040,"2017",3,0,3,6
231040,"2018",1,1,5,7
231040,"2019",3,0,7,10
231040,"2020",3,1,0,4
231040,"2021",1,0,3,4
231040,"2023",2,1,4,7
231050,"2015",0,1,1,2
231050,"2016",1,1,5,7
231050,"2017",2,0,2,4
231050,"2018",3,1,5,9
231050,"2019",7,2,8,17
231050,"2020",12,4,15,31
231050,"2021",7,4,19,30
231050,"2022",9,9,21,39
231050,"2023",7,3,10,20
231060,"2015",3,0,2,5
231060,"2016",3,0,5,8
231060,"2017",1,0,4,5
231060,"2018",0,1,2,3
231060,"2019",3,0,2,5
231060,"2020",3,1,0,4
231060,"2021",1,0,2,3
231060,"2023",1,0,1,2
231070,"2015",0,0,5,5
231070,"2016",3,0,2,5
231070,"2017",1,0,3,4
231070,"2018",4,0,4,8
231070,"2019",1,1,6,8
231070,"2020",2,0,4,6
231070,"2021",1,0,2,3
231070,"2022",2,0,3,5
231070,"2023",0,0,2,2
231080,"2015",1,0,6,7
231080,"2016",0,0,3,3
231080,"2017",8,1,10,19
231080,"2018",7,1,17,25
231080,"2019",2,0,6,8
231080,"2020",3,1,2,6
231080,"2021",2,0,6,8
231080,"2022",5,2,6,13
231080,"2023",1,2,5,8
231085,"2015",2,2,12,16
231085,"2016",2,0,8,10
231085,"2017",5,1,5,11
231085,"2018",8,2,10,20
231085,"2019",5,0,9,14
231085,"2020",4,0,9,13
231085,"2021",2,5,5,12
231085,"2022",4,1,4,9
231085,"2023",1,0,2,3
231090,"2015",1,0,4,5
231090,"2016",2,0,3,5
231090,"2017",1,0,2,3
231090,"2018",2,2,5,9
231090,"2019",0,0,2,2
231090,"2020",1,0,1,2
231090,"2022",0,0,1,1
231090,"2023",1,1,1,3
231095,"2015",0,0,1,1
231095,"2016",2,0,1,3
231095,"2017",3,0,4,7
231095,"2018",3,0,0,3
231095,"2019",2,1,1,4
231095,"2020",7,1,4,12
231095,"2021",4,1,1,6
231095,"2022",3,0,1,4
231095,"2023",1,1,2,4
231100,"2015",1,1,2,4
231100,"2016",2,2,2,6
231100,"2017",0,3,3,6
231100,"2018",3,0,4,7
231100,"2019",4,0,3,7
231100,"2020",1,1,2,4
231100,"2021",0,0,5,5
231100,"2022",1,1,7,9
231100,"2023",0,0,2,2
231110,"2015",3,0,3,6
231110,"2016",0,0,9,9
231110,"2017",3,2,12,17
231110,"2018",2,1,4,7
231110,"2019",3,1,3,7
231110,"2020",1,1,7,9
231110,"2021",1,1,4,6
231110,"2022",1,0,0,1
231110,"2023",1,0,3,4
231120,"2015",3,0,6,9
231120,"2016",1,0,1,2
231120,"2017",11,1,3,15
231120,"2018",4,1,1,6
231120,"2019",1,0,6,7
231120,"2020",2,0,1,3
231120,"2021",2,0,9,11
231120,"2022",1,0,7,8
231120,"2023",0,0,2,2
231123,"2015",4,0,0,4
231123,"2016",0,2,3,5
231123,"2017",2,2,3,7
231123,"2018",2,0,2,4
231123,"2019",4,0,9,13
231123,"2020",2,0,5,7
231123,"2021",1,1,7,9
231123,"2022",5,0,5,10
231123,"2023",2,1,4,7
231126,"2015",7,1,11,19
231126,"2016",3,1,5,9
231126,"2017",6,0,7,13
231126,"2018",2,3,3,8
231126,"2019",2,0,6,8
231126,"2020",4,0,13,17
231126,"2021",1,0,9,10
231126,"2022",5,1,3,9
231126,"2023",1,1,5,7
231130,"2015",29,11,71,111
231130,"2016",36,13,79,128
231130,"2017",62,10,94,166
231130,"2018",46,13,77,136
231130,"2019",57,18,92,167
231130,"2020",44,18,84,146
231130,"2021",43,19,97,159
231130,"2022",55,18,89,162
231130,"2023",38,12,53,103
231135,"2015",1,0,4,5
231135,"2016",2,0,3,5
231135,"2017",8,0,12,20
231135,"2018",3,1,3,7
231135,"2019",1,2,4,7
231135,"2020",4,3,6,13
231135,"2021",1,1,3,5
231135,"2022",3,2,2,7
231135,"2023",1,0,2,3
231140,"2015",30,10,62,102
231140,"2016",17,6,46,69
231140,"2017",31,7,51,89
231140,"2018",32,13,44,89
231140,"2019",36,8,62,106
231140,"2020",27,12,66,105
231140,"2021",42,10,53,105
231140,"2022",36,10,49,95
231140,"2023",20,9,53,82
231150,"2015",4,6,17,27
231150,"2016",8,2,12,22
231150,"2017",7,3,17,27
231150,"2018",9,3,17,29
231150,"2019",10,1,12,23
231150,"2020",9,2,12,23
231150,"2021",7,3,13,23
231150,"2022",9,4,8,21
231150,"2023",3,0,14,17
231160,"2015",7,1,27,35
231160,"2016",9,3,24,36
231160,"2017",10,3,32,45
231160,"2018",10,3,19,32
231160,"2019",17,5,25,47
231160,"2020",12,6,20,38
231160,"2021",16,5,26,47
231160,"2022",15,3,12,30
231160,"2023",10,1,10,21
231170,"2015",4,3,4,11
231170,"2016",6,3,6,15
231170,"2017",5,2,8,15
231170,"2018",3,0,10,13
231170,"2019",7,1,3,11
231170,"2020",2,1,6,9
231170,"2021",3,0,2,5
231170,"2022",1,0,4,5
231170,"2023",3,1,0,4
231180,"2015",30,5,59,94
231180,"2016",35,5,45,85
231180,"2017",32,11,60,103
231180,"2018",32,12,45,89
231180,"2019",26,9,51,86
231180,"2020",31,5,38,74
231180,"2021",30,7,33,70
231180,"2022",27,7,36,70
231180,"2023",23,10,12,45
231190,"2015",3,0,2,5
231190,"2016",1,1,5,7
231190,"2017",2,0,3,5
231190,"2018",2,1,4,7
231190,"2019",1,1,1,3
231190,"2020",3,0,3,6
231190,"2021",3,0,2,5
231190,"2022",1,1,1,3
231190,"2023",2,0,3,5
231195,"2015",5,0,14,19
231195,"2016",1,1,8,10
231195,"2017",6,2,9,17
231195,"2018",9,0,19,28
231195,"2019",7,2,11,20
231195,"2020",8,1,9,18
231195,"2021",10,2,9,21
231195,"2022",6,1,12,19
231195,"2023",2,1,5,8
231200,"2015",8,0,13,21
231200,"2016",6,1,11,18
231200,"2017",6,0,7,13
231200,"2018",5,2,6,13
231200,"2019",4,3,9,16
231200,"2020",10,2,10,22
231200,"2021",5,1,8,14
231200,"2022",9,1,7,17
231200,"2023",4,1,6,11
231210,"2015",6,0,4,10
231210,"2016",6,1,8,15
231210,"2017",7,3,7,17
231210,"2018",9,1,5,15
231210,"2019",7,1,6,14
231210,"2020",9,1,11,21
231210,"2021",7,0,5,12
231210,"2022",2,2,9,13
231210,"2023",0,0,6,6
231220,"2015",19,4,13,36
231220,"2016",12,1,22,35
231220,"2017",9,3,13,25
231220,"2018",6,2,15,23
231220,"2019",6,1,11,18
231220,"2020",5,1,7,13
231220,"2021",11,1,14,26
231220,"2022",14,4,13,31
231220,"2023",7,0,11,18
231230,"2015",18,5,58,81
231230,"2016",27,6,47,80
231230,"2017",35,6,45,86
231230,"2018",33,7,53,93
231230,"2019",27,7,35,69
231230,"2020",12,8,20,40
231230,"2021",9,3,19,31
231230,"2022",24,4,30,58
231230,"2023",10,7,16,33
231240,"2015",6,1,7,14
231240,"2016",2,1,5,8
231240,"2017",3,1,4,8
231240,"2018",3,2,6,11
231240,"2019",7,0,5,12
231240,"2020",4,2,4,10
231240,"2021",2,0,4,6
231240,"2022",4,1,6,11
231240,"2023",4,2,7,13
231250,"2015",1,0,2,3
231250,"2016",7,1,2,10
231250,"2017",3,1,8,12
231250,"2018",3,1,7,11
231250,"2019",4,1,6,11
231250,"2020",2,0,5,7
231250,"2021",1,0,0,1
231250,"2022",0,1,1,2
231250,"2023",2,1,0,3
231260,"2015",1,1,2,4
231260,"2017",1,0,2,3
231260,"2018",1,0,1,2
231260,"2019",0,0,2,2
231260,"2020",0,0,2,2
231260,"2022",0,0,2,2
231260,"2023",1,0,1,2
231270,"2015",4,1,12,17
231270,"2016",3,0,9,12
231270,"2017",10,0,15,25
231270,"2018",11,2,10,23
231270,"2019",8,0,14,22
231270,"2020",12,1,13,26
231270,"2021",6,4,12,22
231270,"2022",4,4,9,17
231270,"2023",6,2,7,15
231280,"2015",3,0,1,4
231280,"2016",4,1,2,7
231280,"2017",3,0,3,6
231280,"2018",2,0,1,3
231280,"2019",3,0,7,10
231280,"2020",1,0,1,2
231280,"2021",1,0,2,3
231280,"2022",0,1,0,1
231280,"2023",0,0,1,1
231290,"2015",58,18,153,229
231290,"2016",66,19,128,213
231290,"2017",70,9,115,194
231290,"2018",38,14,82,134
231290,"2019",76,24,100,200
231290,"2020",53,13,55,121
231290,"2021",43,11,66,120
231290,"2022",51,7,65,123
231290,"2023",49,11,66,126
231300,"2015",2,0,3,5
231300,"2016",4,0,7,11
231300,"2017",8,1,7,16
231300,"2018",6,0,3,9
231300,"2019",4,0,9,13
231300,"2020",2,3,5,10
231300,"2021",2,0,5,7
231300,"2022",4,3,7,14
231300,"2023",2,0,3,5
231310,"2015",15,4,27,46
231310,"2016",13,2,17,32
231310,"2017",13,2,23,38
231310,"2018",17,1,28,46
231310,"2019",15,6,21,42
231310,"2020",17,2,20,39
231310,"2021",13,2,19,34
231310,"2022",8,4,9,21
231310,"2023",5,4,5,14
231320,"2015",7,3,12,22
231320,"2016",4,0,13,17
231320,"2017",8,1,13,22
231320,"2018",2,1,8,11
231320,"2019",7,3,10,20
231320,"2020",3,2,10,15
231320,"2021",6,1,9,16
231320,"2022",3,1,6,10
231320,"2023",1,0,2,3
231325,"2015",2,0,1,3
231325,"2016",1,0,5,6
231325,"2017",5,1,5,11
231325,"2018",2,0,7,9
231325,"2019",6,0,1,7
231325,"2020",4,0,7,11
231325,"2021",3,2,4,9
231325,"2022",1,1,1,3
231325,"2023",2,1,1,4
231330,"2015",1,0,4,5
231330,"2016",3,0,7,10
231330,"2017",9,1,10,20
231330,"2018",5,2,16,23
231330,"2019",8,2,10,20
231330,"2020",16,4,18,38
231330,"2021",23,4,28,55
231330,"2022",21,6,17,44
231330,"2023",11,1,6,18
231335,"2015",0,1,4,5
231335,"2016",1,1,2,4
231335,"2017",2,0,2,4
231335,"2018",1,0,2,3
231335,"2019",3,2,1,6
231335,"2020",2,0,3,5
231335,"2021",1,0,1,2
231335,"2022",1,1,1,3
231340,"2015",48,10,79,137
231340,"2016",41,6,51,98
231340,"2017",35,10,68,113
231340,"2018",25,11,79,115
231340,"2019",32,11,62,105
231340,"2020",22,4,33,59
231340,"2021",22,9,49,80
231340,"2022",37,6,36,79
231340,"2023",22,4,24,50
231350,"2015",10,6,30,46
231350,"2016",19,1,29,49
231350,"2017",21,9,47,77
231350,"2018",25,1,43,69
231350,"2019",11,8,32,51
231350,"2020",14,4,30,48
231350,"2021",11,0,30,41
231350,"2022",20,3,29,52
231350,"2023",11,1,17,29
231355,"2015",4,2,5,11
231355,"2016",2,0,5,7
231355,"2017",6,1,6,13
231355,"2018",5,2,7,14
231355,"2019",4,2,6,12
231355,"2020",5,1,9,15
231355,"2021",4,1,7,12
231355,"2022",6,0,7,13
231355,"2023",1,2,3,6
231360,"2015",10,4,16,30
231360,"2016",8,6,16,30
231360,"2017",15,4,19,38
231360,"2018",16,5,14,35
231360,"2019",13,4,11,28
231360,"2020",13,5,18,36
231360,"2021",20,4,32,56
231360,"2022",8,1,14,23
231360,"2023",10,1,5,16
231370,"2015",0,0,1,1
231370,"2016",0,0,2,2
231370,"2017",4,1,3,8
231370,"2018",0,2,3,5
231370,"2019",1,2,2,5
231370,"2021",2,1,2,5
231370,"2022",1,1,1,3
231375,"2015",7,1,10,18
231375,"2016",5,0,12,17
231375,"2017",3,2,8,13
231375,"2018",2,2,11,15
231375,"2019",4,2,11,17
231375,"2020",6,1,11,18
231375,"2021",4,2,5,11
231375,"2022",4,0,9,13
231375,"2023",5,0,3,8
231380,"2015",6,2,17,25
231380,"2016",7,1,13,21
231380,"2017",6,0,8,14
231380,"2018",9,1,14,24
231380,"2019",7,1,11,19
231380,"2020",3,2,9,14
231380,"2021",6,0,7,13
231380,"2022",10,1,7,18
231380,"2023",7,0,8,15
231390,"2015",4,0,6,10
231390,"2016",1,1,2,4
231390,"2017",2,0,8,10
231390,"2018",3,2,6,11
231390,"2019",5,0,4,9
231390,"2020",4,0,3,7
231390,"2021",3,0,3,6
231390,"2022",2,0,4,6
231390,"2023",2,0,3,5
231395,"2015",7,0,4,11
231395,"2016",3,1,11,15
231395,"2017",4,2,4,10
231395,"2018",5,0,11,16
231395,"2019",7,1,9,17
231395,"2020",9,1,6,16
231395,"2021",3,3,6,12
231395,"2022",4,2,6,12
231395,"2023",2,1,6,9
231400,"2015",11,1,20,32
231400,"2016",8,3,17,28
231400,"2017",6,2,12,20
231400,"2018",18,4,35,57
231400,"2019",13,8,32,53
231400,"2020",8,3,18,29
231400,"2021",6,0,16,22
231400,"2022",6,2,9,17
231400,"2023",6,1,4,11
231410,"2015",11,2,48,61
231410,"2016",14,7,34,55
231410,"2017",26,10,38,74
231410,"2018",30,10,48,88
231410,"2019",23,5,45,73
231410,"2020",22,7,39,68
231410,"2021",22,6,30,58
231410,"2022",31,6,31,68
231410,"2023",17,4,28,49
240010,"2015",2,0,1,3
240010,"2016",5,1,6,12
240010,"2017",3,1,2,6
240010,"2018",3,3,1,7
240010,"2019",3,1,0,4
240010,"2020",0,0,1,1
240010,"2021",1,0,6,7
240010,"2022",2,0,0,2
240010,"2023",2,0,1,3
240020,"2015",17,5,41,63
240020,"2016",14,2,35,51
240020,"2017",24,2,46,72
240020,"2018",28,2,36,66
240020,"2019",28,8,33,69
240020,"2020",13,4,35,52
240020,"2021",21,6,22,49
240020,"2022",13,9,36,58
240020,"2023",11,3,20,34
240030,"2015",1,0,1,2
240030,"2016",0,0,4,4
240030,"2017",0,3,8,11
240030,"2018",3,0,3,6
240030,"2019",4,1,4,9
240030,"2020",2,1,4,7
240030,"2021",1,0,10,11
240030,"2022",0,0,3,3
240030,"2023",0,0,2,2
240040,"2017",3,0,0,3
240040,"2018",1,0,2,3
240040,"2019",2,0,1,3
240040,"2020",1,0,0,1
240040,"2021",0,1,0,1
240050,"2015",0,0,2,2
240050,"2016",2,3,1,6
240050,"2017",2,1,3,6
240050,"2018",4,3,3,10
240050,"2019",1,1,4,6
240050,"2020",2,1,9,12
240050,"2021",4,3,4,11
240050,"2022",5,1,6,12
240050,"2023",1,0,3,4
240060,"2016",0,1,1,2
240060,"2017",0,0,1,1
240060,"2018",0,1,2,3
240060,"2019",0,0,1,1
240060,"2020",2,1,2,5
240060,"2021",3,0,1,4
240060,"2022",2,0,0,2
240060,"2023",2,0,2,4
240070,"2015",1,1,8,10
240070,"2016",4,1,5,10
240070,"2017",3,1,11,15
240070,"2018",7,0,10,17
240070,"2019",7,4,12,23
240070,"2020",1,0,4,5
240070,"2021",9,0,4,13
240070,"2022",6,2,8,16
240070,"2023",1,1,2,4
240080,"2015",2,0,4,6
240080,"2016",3,1,5,9
240080,"2017",6,0,3,9
240080,"2018",8,2,6,16
240080,"2019",5,0,3,8
240080,"2020",6,1,8,15
240080,"2021",6,0,5,11
240080,"2022",6,3,7,16
240080,"2023",2,0,2,4
240090,"2015",0,0,1,1
240090,"2016",0,0,1,1
240090,"2017",0,0,2,2
240090,"2018",2,0,1,3
240090,"2019",2,0,2,4
240090,"2020",2,1,3,6
240090,"2021",1,0,3,4
240090,"2022",1,0,4,5
240090,"2023",0,0,1,1
240100,"2015",19,6,32,57
240100,"2016",12,1,16,29
240100,"2017",11,2,16,29
240100,"2018",24,5,26,55
240100,"2019",12,4,16,32
240100,"2020",16,3,10,29
240100,"2021",20,4,25,49
240100,"2022",10,5,12,27
240100,"2023",9,3,7,19
240110,"2015",7,1,11,19
240110,"2016",10,2,23,35
240110,"2017",12,2,23,37
240110,"2018",15,3,24,42
240110,"2019",9,3,21,33
240110,"2020",13,2,14,29
240110,"2021",12,2,18,32
240110,"2022",11,3,6,20
240110,"2023",2,2,9,13
240120,"2015",3,2,6,11
240120,"2016",5,1,4,10
240120,"2017",5,0,6,11
240120,"2018",1,1,5,7
240120,"2019",3,0,11,14
240120,"2020",2,0,7,9
240120,"2021",3,0,3,6
240120,"2022",1,2,2,5
240120,"2023",0,0,2,2
240130,"2015",1,0,3,4
240130,"2016",1,2,2,5
240130,"2017",5,1,6,12
240130,"2018",2,1,3,6
240130,"2019",2,0,3,5
240130,"2020",2,0,0,2
240130,"2021",6,0,3,9
240130,"2022",2,1,1,4
240130,"2023",1,1,5,7
240140,"2015",3,0,5,8
240140,"2016",4,0,4,8
240140,"2017",2,0,1,3
240140,"2018",3,0,6,9
240140,"2019",2,2,3,7
240140,"2020",2,0,6,8
240140,"2021",0,0,4,4
240140,"2022",1,1,3,5
240140,"2023",2,1,2,5
240145,"2015",8,3,24,35
240145,"2016",4,1,18,23
240145,"2017",6,3,24,33
240145,"2018",8,2,24,34
240145,"2019",11,3,14,28
240145,"2020",11,8,21,40
240145,"2021",14,1,10,25
240145,"2022",7,2,16,25
240145,"2023",4,1,10,15
240150,"2016",0,0,1,1
240150,"2017",0,1,0,1
240150,"2018",1,0,0,1
240150,"2019",0,1,3,4
240150,"2020",1,0,1,2
240150,"2021",1,0,1,2
240160,"2015",2,0,2,4
240160,"2016",3,0,1,4
240160,"2017",3,0,2,5
240160,"2018",0,0,2,2
240160,"2019",3,0,6,9
240160,"2020",1,1,3,5
240160,"2021",3,1,3,7
240160,"2023",0,1,2,3
240165,"2015",0,1,0,1
240165,"2016",0,0,4,4
240165,"2017",0,0,1,1
240165,"2018",2,0,1,3
240165,"2019",1,0,0,1
240165,"2020",1,1,0,2
240165,"2021",0,0,1,1
240165,"2022",0,0,1,1
240165,"2023",1,0,1,2
240170,"2015",2,0,6,8
240170,"2016",1,1,3,5
240170,"2017",2,0,2,4
240170,"2018",1,0,2,3
240170,"2019",1,0,2,3
240170,"2020",1,3,1,5
240170,"2021",0,0,1,1
240170,"2022",4,0,4,8
240170,"2023",1,1,1,3
240180,"2015",2,0,6,8
240180,"2016",6,0,9,15
240180,"2017",3,0,4,7
240180,"2018",3,0,7,10
240180,"2019",2,3,10,15
240180,"2020",1,0,7,8
240180,"2021",2,1,9,12
240180,"2022",1,1,2,4
240180,"2023",3,0,3,6
240185,"2015",0,0,5,5
240185,"2016",1,1,2,4
240185,"2017",3,0,2,5
240185,"2018",1,0,2,3
240185,"2019",4,2,3,9
240185,"2020",1,0,6,7
240185,"2021",3,1,2,6
240185,"2022",0,0,2,2
240185,"2023",2,1,3,6
240190,"2015",1,0,4,5
240190,"2016",0,0,2,2
240190,"2017",0,0,1,1
240190,"2018",0,0,1,1
240190,"2019",4,0,0,4
240190,"2020",4,0,2,6
240190,"2021",1,1,2,4
240190,"2022",2,0,2,4
240190,"2023",0,0,2,2
240200,"2015",13,0,18,31
240200,"2016",35,7,50,92
240200,"2017",37,7,46,90
240200,"2018",43,13,58,114
240200,"2019",29,13,39,81
240200,"2020",36,12,41,89
240200,"2021",23,7,28,58
240200,"2022",23,8,21,52
240200,"2023",15,4,18,37
240210,"2015",2,3,1,6
240210,"2016",2,0,5,7
240210,"2017",4,0,3,7
240210,"2018",3,1,1,5
240210,"2019",1,2,4,7
240210,"2020",1,0,4,5
240210,"2021",0,1,3,4
240210,"2022",1,0,1,2
240210,"2023",2,0,1,3
240220,"2015",5,3,28,36
240220,"2016",3,2,21,26
240220,"2017",5,1,10,16
240220,"2018",12,2,28,42
240220,"2019",17,3,19,39
240220,"2020",3,1,13,17
240220,"2021",6,1,12,19
240220,"2022",10,1,4,15
240220,"2023",6,1,6,13
240230,"2015",5,2,13,20
240230,"2016",4,0,9,13
240230,"2017",11,5,3,19
240230,"2018",4,4,9,17
240230,"2019",8,3,12,23
240230,"2020",3,2,3,8
240230,"2021",6,1,4,11
240230,"2022",3,0,4,7
240230,"2023",1,1,5,7
240240,"2015",0,1,3,4
240240,"2016",2,0,2,4
240240,"2017",1,1,0,2
240240,"2018",2,0,2,4
240240,"2019",1,0,0,1
240240,"2020",1,0,2,3
240240,"2021",4,2,0,6
240240,"2022",1,1,1,3
240240,"2023",1,0,0,1
240250,"2015",2,0,7,9
240250,"2016",1,0,3,4
240250,"2017",4,1,1,6
240250,"2018",2,0,5,7
240250,"2019",2,0,5,7
240250,"2020",4,0,7,11
240250,"2021",2,5,11,18
240250,"2022",1,0,0,1
240250,"2023",0,0,2,2
240260,"2015",17,4,55,76
240260,"2016",21,10,46,77
240260,"2017",31,5,46,82
240260,"2018",29,8,43,80
240260,"2019",34,11,39,84
240260,"2020",34,8,45,87
240260,"2021",25,6,33,64
240260,"2022",21,6,20,47
240260,"2023",24,3,28,55
240270,"2015",6,3,4,13
240270,"2016",0,1,3,4
240270,"2017",2,0,1,3
240270,"2018",2,0,1,3
240270,"2019",6,0,2,8
240270,"2020",2,1,1,4
240270,"2021",1,0,2,3
240270,"2022",2,0,2,4
240270,"2023",0,0,3,3
240280,"2015",0,0,4,4
240280,"2017",1,0,0,1
240280,"2018",1,0,0,1
240280,"2019",1,0,1,2
240280,"2020",0,0,1,1
240280,"2021",1,0,0,1
240290,"2015",2,0,1,3
240290,"2016",1,0,1,2
240290,"2017",2,0,1,3
240290,"2018",1,1,1,3
240290,"2019",0,1,2,3
240290,"2020",0,0,3,3
240290,"2021",1,0,3,4
240290,"2022",0,0,1,1
240300,"2015",1,0,3,4
240300,"2016",3,0,5,8
240300,"2017",3,1,8,12
240300,"2018",2,1,5,8
240300,"2019",1,1,6,8
240300,"2020",3,0,1,4
240300,"2021",4,1,1,6
240300,"2022",4,2,2,8
240300,"2023",1,2,0,3
240310,"2015",10,3,18,31
240310,"2016",11,5,13,29
240310,"2017",19,2,15,36
240310,"2018",5,2,7,14
240310,"2019",7,4,9,20
240310,"2020",8,2,11,21
240310,"2021",7,5,5,17
240310,"2022",9,1,6,16
240310,"2023",4,3,8,15
240320,"2015",2,1,2,5
240320,"2016",0,0,1,1
240320,"2017",0,0,2,2
240320,"2018",2,1,2,5
240320,"2019",3,1,0,4
240320,"2020",1,0,1,2
240320,"2021",2,0,2,4
240320,"2022",2,1,0,3
240320,"2023",0,0,1,1
240325,"2015",1,1,6,8
240325,"2016",3,0,10,13
240325,"2017",1,1,6,8
240325,"2018",2,1,9,12
240325,"2019",3,2,9,14
240325,"2020",5,3,20,28
240325,"2021",3,2,8,13
240325,"2022",7,3,19,29
240325,"2023",6,1,4,11
240330,"2015",2,0,0,2
240330,"2016",0,0,1,1
240330,"2017",1,0,0,1
240330,"2018",0,1,5,6
240330,"2019",1,0,0,1
240330,"2020",1,1,4,6
240330,"2021",1,0,4,5
240330,"2022",0,0,5,5
240340,"2015",1,0,5,6
240340,"2016",0,1,1,2
240340,"2017",0,0,3,3
240340,"2018",1,0,3,4
240340,"2019",2,0,3,5
240340,"2020",1,0,2,3
240340,"2021",1,0,0,1
240340,"2022",1,0,2,3
240350,"2015",4,1,2,7
240350,"2016",0,1,4,5
240350,"2017",3,0,4,7
240350,"2018",2,0,4,6
240350,"2019",1,1,4,6
240350,"2020",2,1,5,8
240350,"2021",4,1,3,8
240350,"2022",0,2,1,3
240350,"2023",0,1,6,7
240360,"2015",16,0,19,35
240360,"2016",7,0,12,19
240360,"2017",18,2,32,52
240360,"2018",10,5,14,29
240360,"2019",12,3,25,40
240360,"2020",16,6,27,49
240360,"2021",11,7,19,37
240360,"2022",12,6,19,37
240360,"2023",20,5,10,35
240370,"2015",1,1,7,9
240370,"2016",1,1,4,6
240370,"2017",0,0,1,1
240370,"2018",1,1,3,5
240370,"2019",4,0,6,10
240370,"2020",3,0,3,6
240370,"2021",6,0,0,6
240370,"2022",0,1,1,2
240370,"2023",0,0,2,2
240375,"2015",1,0,1,2
240375,"2017",0,0,3,3
240375,"2018",0,0,1,1
240375,"2019",2,0,1,3
240375,"2020",0,0,4,4
240375,"2021",1,0,2,3
240380,"2015",3,0,5,8
240380,"2016",4,0,3,7
240380,"2017",1,0,1,2
240380,"2018",2,0,4,6
240380,"2019",0,0,2,2
240380,"2020",2,0,3,5
240380,"2021",0,0,2,2
240380,"2022",0,0,3,3
240380,"2023",1,0,0,1
240390,"2017",1,0,0,1
240390,"2019",0,1,0,1
240390,"2020",2,0,0,2
240390,"2021",0,1,2,3
240390,"2022",2,0,0,2
240390,"2023",0,0,1,1
240400,"2015",0,0,1,1
240400,"2016",1,0,0,1
240400,"2017",1,0,4,5
240400,"2018",2,1,0,3
240400,"2019",1,0,0,1
240400,"2020",1,3,1,5
240400,"2021",2,0,2,4
240400,"2022",0,1,1,2
240400,"2023",2,0,0,2
240410,"2015",0,0,2,2
240410,"2016",1,0,2,3
240410,"2017",1,0,2,3
240410,"2019",1,0,0,1
240410,"2020",4,0,1,5
240410,"2021",1,0,1,2
240410,"2022",0,0,1,1
240410,"2023",1,0,1,2
240420,"2015",2,1,34,37
240420,"2016",4,2,15,21
240420,"2017",5,1,8,14
240420,"2018",4,2,13,19
240420,"2019",15,3,15,33
240420,"2020",6,0,9,15
240420,"2021",9,0,6,15
240420,"2022",1,2,3,6
240420,"2023",7,1,7,15
240430,"2015",2,0,11,13
240430,"2016",2,1,3,6
240430,"2017",4,2,8,14
240430,"2018",5,0,5,10
240430,"2019",3,1,4,8
240430,"2020",3,1,3,7
240430,"2021",6,0,7,13
240430,"2022",3,1,4,8
240430,"2023",3,0,1,4
240440,"2015",7,1,2,10
240440,"2016",2,0,3,5
240440,"2017",6,0,5,11
240440,"2018",6,2,6,14
240440,"2019",0,2,5,7
240440,"2020",2,0,5,7
240440,"2021",3,2,7,12
240440,"2022",6,0,6,12
240440,"2023",2,0,4,6
240450,"2015",6,1,3,10
240450,"2016",6,0,5,11
240450,"2017",7,1,15,23
240450,"2018",4,0,6,10
240450,"2019",8,0,16,24
240450,"2020",6,0,15,21
240450,"2021",11,4,13,28
240450,"2022",4,2,9,15
240450,"2023",2,0,4,6
240460,"2015",2,0,1,3
240460,"2016",5,0,5,10
240460,"2017",1,2,3,6
240460,"2018",2,0,3,5
240460,"2019",5,2,6,13
240460,"2020",5,2,0,7
240460,"2021",2,1,2,5
240460,"2022",0,1,6,7
240460,"2023",0,1,3,4
240470,"2015",2,1,3,6
240470,"2016",4,0,2,6
240470,"2017",4,0,15,19
240470,"2018",7,1,10,18
240470,"2019",6,0,8,14
240470,"2020",2,2,8,12
240470,"2021",2,2,5,9
240470,"2022",6,1,4,11
240470,"2023",4,2,4,10
240480,"2017",1,1,3,5
240480,"2018",0,0,2,2
240480,"2019",1,0,0,1
240480,"2020",2,0,4,6
240480,"2021",0,0,1,1
240480,"2022",1,0,0,1
240480,"2023",0,0,1,1
240485,"2015",1,0,2,3
240485,"2016",2,0,2,4
240485,"2017",3,0,7,10
240485,"2018",3,0,2,5
240485,"2019",3,0,5,8
240485,"2020",0,0,5,5
240485,"2021",3,0,6,9
240485,"2022",2,1,2,5
240490,"2015",2,0,2,4
240490,"2016",1,0,3,4
240490,"2017",3,0,5,8
240490,"2018",0,0,2,2
240490,"2020",1,2,1,4
240490,"2021",0,0,3,3
240490,"2022",5,0,3,8
240490,"2023",0,0,1,1
240500,"2015",0,1,1,2
240500,"2016",2,0,3,5
240500,"2017",0,0,1,1
240500,"2018",1,0,6,7
240500,"2019",0,1,4,5
240500,"2020",1,1,1,3
240500,"2021",3,1,0,4
240500,"2023",1,0,1,2
240510,"2015",6,0,2,8
240510,"2016",1,0,2,3
240510,"2017",0,0,5,5
240510,"2018",2,0,2,4
240510,"2019",4,2,0,6
240510,"2020",1,2,2,5
240510,"2021",1,1,4,6
240510,"2022",1,0,3,4
240510,"2023",2,0,4,6
240520,"2015",2,0,3,5
240520,"2016",1,1,1,3
240520,"2017",1,0,2,3
240520,"2018",3,1,5,9
240520,"2019",1,1,3,5
240520,"2020",0,1,1,2
240520,"2021",1,2,7,10
240520,"2022",1,1,3,5
240520,"2023",3,0,1,4
240530,"2015",1,2,5,8
240530,"2016",1,0,2,3
240530,"2017",5,0,1,6
240530,"2018",1,0,6,7
240530,"2019",0,1,2,3
240530,"2020",0,0,3,3
240530,"2021",0,0,1,1
240530,"2022",0,0,1,1
240540,"2015",3,0,3,6
240540,"2016",2,0,1,3
240540,"2017",1,0,3,4
240540,"2018",0,0,2,2
240540,"2019",0,1,3,4
240540,"2020",1,0,2,3
240540,"2021",1,0,0,1
240540,"2022",2,0,1,3
240540,"2023",0,0,1,1
240550,"2015",0,1,1,2
240550,"2016",1,0,0,1
240550,"2018",0,0,2,2
240550,"2019",2,0,4,6
240550,"2022",0,0,2,2
240560,"2015",1,2,3,6
240560,"2016",10,2,12,24
240560,"2017",7,2,6,15
240560,"2018",10,0,10,20
240560,"2019",5,0,6,11
240560,"2020",2,0,10,12
240560,"2021",4,0,6,10
240560,"2022",3,2,6,11
240560,"2023",2,0,4,6
240570,"2015",4,0,3,7
240570,"2016",2,1,2,5
240570,"2017",9,0,5,14
240570,"2018",0,1,1,2
240570,"2019",4,1,4,9
240570,"2020",3,1,3,7
240570,"2021",5,0,2,7
240570,"2022",1,1,4,6
240570,"2023",0,0,2,2
240580,"2015",5,6,35,46
240580,"2016",10,1,24,35
240580,"2017",10,2,20,32
240580,"2018",9,4,20,33
240580,"2019",9,5,21,35
240580,"2020",7,2,18,27
240580,"2021",9,1,19,29
240580,"2022",6,2,9,17
240580,"2023",4,1,11,16
240590,"2015",1,0,0,1
240590,"2018",0,0,4,4
240590,"2019",2,0,0,2
240590,"2020",0,0,1,1
240590,"2021",0,1,3,4
240590,"2022",1,1,1,3
240590,"2023",0,0,1,1
240600,"2015",1,0,2,3
240600,"2016",0,0,1,1
240600,"2017",1,2,0,3
240600,"2018",0,1,1,2
240600,"2019",1,1,3,5
240600,"2020",2,0,3,5
240600,"2021",1,1,1,3
240600,"2022",1,0,2,3
240610,"2015",0,0,1,1
240610,"2016",5,2,6,13
240610,"2017",10,1,7,18
240610,"2018",7,3,10,20
240610,"2019",5,2,11,18
240610,"2020",8,1,5,14
240610,"2021",8,0,8,16
240610,"2022",11,2,5,18
240610,"2023",5,1,4,10
240615,"2015",0,0,1,1
240615,"2018",0,1,0,1
240615,"2019",1,0,0,1
240615,"2020",1,0,1,2
240615,"2021",1,0,0,1
240615,"2022",1,0,1,2
240615,"2023",0,0,1,1
240620,"2016",2,1,1,4
240620,"2017",0,0,1,1
240620,"2018",1,0,5,6
240620,"2019",1,1,2,4
240620,"2020",1,0,3,4
240620,"2021",2,0,1,3
240620,"2022",0,0,2,2
240630,"2015",6,0,6,12
240630,"2016",1,0,4,5
240630,"2017",1,1,2,4
240630,"2018",0,2,3,5
240630,"2019",2,2,2,6
240630,"2020",2,0,3,5
240630,"2021",2,2,4,8
240630,"2022",1,0,2,3
240630,"2023",0,1,1,2
240640,"2015",0,1,2,3
240640,"2016",0,0,1,1
240640,"2017",1,0,0,1
240640,"2018",0,1,1,2
240640,"2020",4,0,1,5
240650,"2015",3,1,9,13
240650,"2016",6,4,5,15
240650,"2017",1,1,7,9
240650,"2018",8,1,0,9
240650,"2019",5,1,0,6
240650,"2020",1,0,4,5
240650,"2021",1,0,6,7
240650,"2022",2,0,1,3
240650,"2023",2,1,1,4
240660,"2015",4,0,7,11
240660,"2016",5,1,8,14
240660,"2017",0,0,3,3
240660,"2018",6,0,8,14
240660,"2019",3,1,3,7
240660,"2020",1,0,7,8
240660,"2021",3,0,4,7
240660,"2022",2,0,1,3
240660,"2023",1,0,0,1
240670,"2015",4,0,10,14
240670,"2016",1,0,4,5
240670,"2017",1,0,3,4
240670,"2018",2,0,4,6
240670,"2019",5,2,5,12
240670,"2020",2,0,2,4
240670,"2021",6,1,6,13
240670,"2022",1,1,7,9
240670,"2023",1,0,2,3
240680,"2015",0,0,3,3
240680,"2016",3,1,2,6
240680,"2017",2,1,3,6
240680,"2018",3,0,0,3
240680,"2019",2,0,1,3
240680,"2020",2,0,2,4
240680,"2021",1,0,0,1
240680,"2023",0,1,3,4
240690,"2015",0,0,1,1
240690,"2017",0,0,1,1
240690,"2018",0,0,2,2
240690,"2019",3,0,1,4
240690,"2020",0,1,0,1
240690,"2021",1,0,1,2
240690,"2022",1,0,1,2
240690,"2023",1,1,0,2
240700,"2015",1,0,2,3
240700,"2017",0,0,4,4
240700,"2018",3,1,3,7
240700,"2019",0,0,1,1
240700,"2020",1,0,2,3
240700,"2021",2,1,3,6
240700,"2022",0,0,3,3
240700,"2023",2,1,2,5
240710,"2015",13,5,37,55
240710,"2016",18,7,38,63
240710,"2017",28,3,47,78
240710,"2018",32,7,46,85
240710,"2019",43,11,50,104
240710,"2020",29,11,52,92
240710,"2021",39,2,42,83
240710,"2022",28,9,35,72
240710,"2023",20,6,14,40
240720,"2015",6,2,19,27
240720,"2016",6,1,6,13
240720,"2017",6,2,8,16
240720,"2018",6,0,17,23
240720,"2019",7,1,12,20
240720,"2020",5,0,7,12
240720,"2021",7,1,15,23
240720,"2022",2,0,5,7
240720,"2023",4,1,8,13
240725,"2015",0,0,1,1
240725,"2016",0,0,1,1
240725,"2017",3,0,0,3
240725,"2018",2,0,1,3
240725,"2019",2,0,0,2
240725,"2020",1,0,4,5
240725,"2021",0,1,1,2
240725,"2022",0,2,1,3
240725,"2023",0,0,1,1
240730,"2015",0,0,2,2
240730,"2016",1,0,1,2
240730,"2017",0,0,1,1
240730,"2018",2,2,5,9
240730,"2019",1,2,2,5
240730,"2020",0,0,4,4
240730,"2021",3,1,2,6
240730,"2022",1,0,5,6
240730,"2023",1,0,3,4
240740,"2015",0,0,1,1
240740,"2016",1,0,0,1
240740,"2017",0,0,1,1
240740,"2018",0,0,1,1
240740,"2019",3,0,2,5
240740,"2020",1,0,2,3
240740,"2021",2,1,2,5
240740,"2022",1,1,3,5
240740,"2023",3,0,0,3
240750,"2015",2,1,8,11
240750,"2016",3,0,4,7
240750,"2017",4,2,2,8
240750,"2018",0,1,2,3
240750,"2019",3,0,9,12
240750,"2020",5,2,5,12
240750,"2021",1,0,4,5
240750,"2022",0,0,6,6
240750,"2023",4,0,1,5
240760,"2015",5,0,2,7
240760,"2016",1,0,2,3
240760,"2017",0,0,3,3
240760,"2018",0,0,4,4
240760,"2019",1,0,1,2
240760,"2020",2,0,5,7
240760,"2021",0,0,2,2
240760,"2022",1,0,0,1
240760,"2023",1,0,1,2
240770,"2015",2,1,6,9
240770,"2016",1,1,2,4
240770,"2017",4,1,5,10
240770,"2018",1,1,5,7
240770,"2019",4,2,9,15
240770,"2020",7,1,4,12
240770,"2021",6,3,1,10
240770,"2022",1,1,6,8
240770,"2023",0,0,2,2
240780,"2015",8,0,14,22
240780,"2016",5,1,10,16
240780,"2017",1,3,15,19
240780,"2018",3,3,6,12
240780,"2019",4,0,12,16
240780,"2020",4,1,5,10
240780,"2021",3,0,6,9
240780,"2022",3,0,5,8
240780,"2023",4,1,3,8
240790,"2015",1,0,0,1
240790,"2017",1,1,0,2
240790,"2019",0,1,0,1
240790,"2020",0,0,2,2
240790,"2021",1,0,2,3
240800,"2015",117,23,182,322
240800,"2016",110,22,177,309
240800,"2017",140,34,240,414
240800,"2018",152,37,196,385
240800,"2019",155,37,179,371
240800,"2020",113,39,159,311
240800,"2021",124,34,147,305
240800,"2022",110,47,136,293
240800,"2023",50,13,69,132
240810,"2015",306,68,562,936
240810,"2016",275,84,507,866
240810,"2017",308,75,515,898
240810,"2018",325,77,421,823
240810,"2019",296,79,417,792
240810,"2020",214,53,280,547
240810,"2021",193,63,273,529
240810,"2022",143,41,251,435
240810,"2023",128,34,199,361
240820,"2015",4,2,9,15
240820,"2016",4,6,9,19
240820,"2017",8,4,10,22
240820,"2018",6,1,11,18
240820,"2019",10,6,15,31
240820,"2020",4,1,4,9
240820,"2021",8,1,15,24
240820,"2022",2,1,3,6
240820,"2023",4,0,7,11
240830,"2015",13,2,29,44
240830,"2016",8,1,14,23
240830,"2017",13,1,11,25
240830,"2018",10,1,13,24
240830,"2019",12,7,14,33
240830,"2020",10,1,8,19
240830,"2021",8,0,7,15
240830,"2022",7,1,6,14
240830,"2023",2,2,6,10
240840,"2017",0,0,1,1
240840,"2018",0,0,1,1
240840,"2019",0,0,1,1
240840,"2020",0,0,1,1
240840,"2021",1,0,2,3
240840,"2023",1,0,1,2
240850,"2015",0,0,2,2
240850,"2016",2,0,3,5
240850,"2017",4,0,4,8
240850,"2018",3,0,3,6
240850,"2019",3,0,1,4
240850,"2020",0,0,4,4
240850,"2021",2,0,0,2
240850,"2022",0,0,3,3
240850,"2023",0,0,1,1
240860,"2016",0,1,0,1
240860,"2017",0,0,1,1
240860,"2018",0,1,0,1
240860,"2019",1,0,2,3
240860,"2020",2,1,2,5
240860,"2021",0,0,3,3
240860,"2022",4,0,1,5
240860,"2023",3,0,2,5
240870,"2015",1,0,0,1
240870,"2016",1,0,1,2
240870,"2017",0,0,2,2
240870,"2018",1,0,3,4
240870,"2019",0,0,1,1
240870,"2020",0,0,1,1
240870,"2021",2,0,1,3
240870,"2022",1,0,3,4
240870,"2023",1,0,1,2
240880,"2015",0,2,3,5
240880,"2016",2,0,2,4
240880,"2017",1,1,2,4
240880,"2018",3,1,4,8
240880,"2019",2,0,4,6
240880,"2020",2,0,2,4
240880,"2021",4,0,1,5
240880,"2022",1,0,1,2
240880,"2023",0,0,1,1
240890,"2015",4,2,9,15
240890,"2016",6,3,7,16
240890,"2017",3,1,11,15
240890,"2018",4,0,2,6
240890,"2019",6,1,5,12
240890,"2020",3,1,5,9
240890,"2021",5,2,7,14
240890,"2022",1,1,6,8
240890,"2023",0,0,1,1
240895,"2015",3,0,3,6
240895,"2016",3,1,10,14
240895,"2017",7,0,5,12
240895,"2018",3,1,2,6
240895,"2019",3,1,6,10
240895,"2020",2,1,4,7
240895,"2021",3,0,4,7
240895,"2022",2,1,5,8
240895,"2023",2,0,5,7
240910,"2015",1,1,6,8
240910,"2016",1,1,4,6
240910,"2017",4,0,1,5
240910,"2018",0,1,5,6
240910,"2019",4,2,4,10
240910,"2020",0,1,3,4
240910,"2021",2,0,0,2
240910,"2022",2,1,3,6
240910,"2023",2,0,2,4
240920,"2015",0,0,3,3
240920,"2016",0,0,1,1
240920,"2017",0,0,2,2
240920,"2018",0,1,1,2
240920,"2019",0,2,2,4
240920,"2020",0,0,3,3
240920,"2021",1,0,0,1
240930,"2015",3,1,5,9
240930,"2016",1,0,3,4
240930,"2018",2,0,7,9
240930,"2019",2,0,5,7
240930,"2020",0,0,6,6
240930,"2021",4,0,5,9
240930,"2022",2,0,0,2
240930,"2023",1,0,4,5
240933,"2015",3,0,2,5
240933,"2016",1,0,1,2
240933,"2017",0,0,2,2
240933,"2018",0,0,2,2
240933,"2019",2,3,3,8
240933,"2020",2,0,2,4
240933,"2021",1,1,0,2
240933,"2023",1,0,2,3
240940,"2015",4,0,12,16
240940,"2016",2,1,2,5
240940,"2017",5,1,12,18
240940,"2018",5,1,13,19
240940,"2019",8,0,11,19
240940,"2020",16,2,10,28
240940,"2021",8,2,20,30
240940,"2022",17,2,14,33
240940,"2023",7,2,11,20
240950,"2015",2,0,1,3
240950,"2016",2,0,4,6
240950,"2017",0,0,2,2
240950,"2018",0,0,2,2
240950,"2019",1,0,3,4
240950,"2020",2,0,2,4
240950,"2021",2,0,2,4
240950,"2022",1,0,0,1
240950,"2023",0,0,1,1
240960,"2015",1,0,1,2
240960,"2016",1,0,3,4
240960,"2017",1,0,1,2
240960,"2018",1,0,0,1
240960,"2019",2,0,3,5
240960,"2020",1,1,0,2
240960,"2022",0,0,2,2
240960,"2023",1,0,1,2
240970,"2015",0,0,3,3
240970,"2016",0,0,1,1
240970,"2017",0,0,4,4
240970,"2018",2,0,0,2
240970,"2019",1,1,0,2
240970,"2020",3,0,5,8
240970,"2021",1,0,2,3
240970,"2022",0,0,1,1
240970,"2023",1,0,0,1
240980,"2015",3,1,8,12
240980,"2016",8,0,4,12
240980,"2017",3,1,4,8
240980,"2018",4,1,9,14
240980,"2019",6,2,9,17
240980,"2020",1,2,4,7
240980,"2021",3,1,7,11
240980,"2022",2,1,1,4
240980,"2023",4,1,3,8
240990,"2015",0,2,6,8
240990,"2016",5,0,9,14
240990,"2017",4,0,10,14
240990,"2018",2,1,7,10
240990,"2019",2,4,5,11
240990,"2020",3,1,6,10
240990,"2021",1,1,8,10
240990,"2022",8,2,4,14
240990,"2023",1,0,5,6
241000,"2015",1,0,3,4
241000,"2017",1,0,1,2
241000,"2018",1,0,3,4
241000,"2019",1,0,0,1
241000,"2020",0,0,1,1
241000,"2021",2,0,1,3
241000,"2022",0,0,1,1
241000,"2023",1,1,2,4
241010,"2015",5,1,12,18
241010,"2016",1,2,4,7
241010,"2017",4,3,11,18
241010,"2018",5,0,6,11
241010,"2019",7,0,4,11
241010,"2020",3,0,7,10
241010,"2021",0,1,5,6
241010,"2022",2,3,7,12
241010,"2023",3,1,3,7
241020,"2015",1,0,2,3
241020,"2016",1,0,1,2
241020,"2017",1,1,2,4
241020,"2018",2,0,0,2
241020,"2019",2,0,4,6
241020,"2020",1,1,1,3
241020,"2021",0,1,5,6
241020,"2022",0,3,3,6
241020,"2023",3,1,2,6
241025,"2015",3,0,4,7
241025,"2016",2,0,0,2
241025,"2017",0,0,5,5
241025,"2018",2,0,5,7
241025,"2019",1,0,10,11
241025,"2020",2,0,5,7
241025,"2021",0,0,2,2
241025,"2022",2,1,3,6
241025,"2023",0,2,2,4
241030,"2015",1,0,1,2
241030,"2016",1,0,3,4
241030,"2017",2,0,2,4
241030,"2018",1,1,2,4
241030,"2019",3,0,3,6
241030,"2020",3,0,2,5
241030,"2021",1,1,5,7
241030,"2022",0,1,3,4
241030,"2023",1,0,1,2
241040,"2015",2,1,3,6
241040,"2016",2,2,2,6
241040,"2017",4,2,7,13
241040,"2018",2,0,9,11
241040,"2019",4,1,5,10
241040,"2020",2,3,2,7
241040,"2021",1,0,6,7
241040,"2022",2,1,3,6
241040,"2023",2,1,0,3
241050,"2015",0,1,0,1
241050,"2016",1,0,0,1
241050,"2018",2,0,1,3
241050,"2019",1,0,2,3
241050,"2020",1,0,1,2
241050,"2021",2,0,1,3
241050,"2022",1,1,3,5
241050,"2023",2,0,1,3
241060,"2017",1,0,1,2
241060,"2018",0,0,3,3
241060,"2019",1,0,1,2
241060,"2020",2,0,3,5
241060,"2021",2,1,1,4
241060,"2022",0,0,1,1
241060,"2023",1,0,1,2
241070,"2017",3,0,0,3
241070,"2018",1,0,1,2
241070,"2020",1,0,0,1
241070,"2022",0,1,1,2
241070,"2023",0,0,4,4
241080,"2015",0,1,2,3
241080,"2016",0,0,1,1
241080,"2017",0,1,2,3
241080,"2018",2,0,1,3
241080,"2019",1,0,2,3
241080,"2020",1,1,0,2
241080,"2021",1,0,3,4
241080,"2022",2,0,0,2
241080,"2023",1,0,1,2
241090,"2015",0,0,5,5
241090,"2017",0,0,3,3
241090,"2018",0,0,3,3
241090,"2019",0,2,5,7
241090,"2020",1,1,4,6
241090,"2021",1,0,2,3
241090,"2022",1,0,2,3
241090,"2023",0,0,1,1
241100,"2015",2,1,2,5
241100,"2016",1,0,2,3
241100,"2017",1,0,2,3
241100,"2018",0,0,2,2
241100,"2019",1,1,1,3
241100,"2020",1,0,1,2
241100,"2021",1,1,2,4
241100,"2022",0,0,1,1
241105,"2015",0,0,5,5
241105,"2016",1,0,2,3
241105,"2017",5,0,3,8
241105,"2018",4,1,2,7
241105,"2019",4,0,3,7
241105,"2020",2,2,2,6
241105,"2021",4,0,6,10
241105,"2022",3,0,8,11
241105,"2023",1,1,5,7
241110,"2015",1,1,1,3
241110,"2016",0,1,1,2
241110,"2017",0,0,1,1
241110,"2018",1,1,1,3
241110,"2020",1,1,2,4
241110,"2021",0,0,2,2
241110,"2022",0,1,1,2
241110,"2023",0,0,1,1
241120,"2015",16,2,27,45
241120,"2016",7,2,14,23
241120,"2017",7,0,15,22
241120,"2018",6,2,11,19
241120,"2019",10,1,12,23
241120,"2020",6,4,9,19
241120,"2021",5,0,9,14
241120,"2022",7,4,10,21
241120,"2023",4,2,4,10
241140,"2015",1,0,8,9
241140,"2016",0,1,5,6
241140,"2017",1,0,7,8
241140,"2018",2,1,6,9
241140,"2019",5,2,3,10
241140,"2020",4,2,4,10
241140,"2021",3,2,8,13
241140,"2022",2,5,2,9
241140,"2023",0,0,1,1
241142,"2015",0,0,2,2
241142,"2016",0,1,1,2
241142,"2017",3,0,0,3
241142,"2022",0,1,0,1
241150,"2015",8,1,19,28
241150,"2016",9,1,13,23
241150,"2017",9,0,10,19
241150,"2018",10,1,17,28
241150,"2019",13,4,16,33
241150,"2020",9,0,7,16
241150,"2021",6,2,9,17
241150,"2022",6,0,3,9
241150,"2023",1,0,7,8
241160,"2015",0,0,1,1
241160,"2016",0,1,1,2
241160,"2017",0,0,2,2
241160,"2018",2,0,2,4
241160,"2019",1,1,2,4
241160,"2020",2,0,4,6
241160,"2021",1,0,1,2
241160,"2023",1,0,0,1
241170,"2016",1,0,0,1
241170,"2019",1,2,1,4
241170,"2022",0,0,1,1
241170,"2023",0,0,2,2
241180,"2015",1,0,1,2
241180,"2016",0,0,4,4
241180,"2017",1,0,2,3
241180,"2018",1,0,1,2
241180,"2019",3,1,1,5
241180,"2020",3,1,1,5
241180,"2021",4,0,2,6
241180,"2022",0,0,1,1
241180,"2023",2,0,3,5
241190,"2016",1,0,2,3
241190,"2017",1,0,1,2
241190,"2018",0,0,2,2
241190,"2019",1,0,4,5
241190,"2020",1,0,1,2
241190,"2021",2,0,0,2
241190,"2022",0,2,3,5
241190,"2023",0,0,1,1
241200,"2015",32,10,82,124
241200,"2016",38,13,91,142
241200,"2017",53,12,75,140
241200,"2018",47,10,53,110
241200,"2019",46,10,56,112
241200,"2020",36,13,66,115
241200,"2021",41,25,57,123
241200,"2022",28,13,48,89
241200,"2023",19,8,23,50
241210,"2015",3,0,0,3
241210,"2016",2,3,6,11
241210,"2017",6,0,3,9
241210,"2018",3,1,5,9
241210,"2019",3,1,2,6
241210,"2020",3,1,4,8
241210,"2021",2,0,2,4
241210,"2022",3,1,3,7
241210,"2023",2,0,1,3
241220,"2015",13,4,36,53
241220,"2016",14,1,31,46
241220,"2017",16,2,11,29
241220,"2018",15,3,24,42
241220,"2019",23,3,26,52
241220,"2020",10,2,24,36
241220,"2021",9,5,15,29
241220,"2022",5,0,5,10
241220,"2023",4,2,7,13
241230,"2015",0,0,6,6
241230,"2016",2,0,6,8
241230,"2017",1,0,8,9
241230,"2018",2,0,1,3
241230,"2019",0,0,1,1
241230,"2020",3,1,1,5
241230,"2021",3,1,2,6
241230,"2022",0,0,1,1
241230,"2023",1,0,2,3
241240,"2015",0,0,1,1
241240,"2016",0,1,3,4
241240,"2017",1,1,4,6
241240,"2018",0,0,3,3
241240,"2019",1,2,2,5
241240,"2020",3,1,2,6
241240,"2021",1,1,0,2
241240,"2022",0,0,3,3
241240,"2023",0,0,1,1
241250,"2015",4,0,7,11
241250,"2016",0,1,1,2
241250,"2017",5,0,9,14
241250,"2018",4,1,7,12
241250,"2019",7,0,7,14
241250,"2020",2,1,10,13
241250,"2021",3,0,7,10
241250,"2022",7,1,6,14
241250,"2023",7,0,6,13
241255,"2015",4,1,8,13
241255,"2016",1,0,4,5
241255,"2017",3,0,7,10
241255,"2018",1,0,1,2
241255,"2019",2,2,16,20
241255,"2020",6,1,10,17
241255,"2021",4,2,4,10
241255,"2022",2,3,3,8
241255,"2023",3,1,1,5
241260,"2015",1,4,7,12
241260,"2016",3,0,3,6
241260,"2017",6,3,6,15
241260,"2018",3,0,4,7
241260,"2019",1,0,7,8
241260,"2020",3,0,3,6
241260,"2021",0,3,4,7
241260,"2022",2,1,1,4
241260,"2023",0,0,2,2
241270,"2015",1,1,4,6
241270,"2016",0,1,1,2
241270,"2017",0,1,2,3
241270,"2018",1,0,2,3
241270,"2019",2,0,1,3
241270,"2020",1,0,1,2
241270,"2021",1,0,1,2
241270,"2022",1,1,2,4
241270,"2023",1,0,0,1
241280,"2015",2,0,2,4
241280,"2016",1,0,5,6
241280,"2017",2,0,3,5
241280,"2018",3,0,5,8
241280,"2019",4,1,4,9
241280,"2020",0,1,1,2
241280,"2021",3,1,5,9
241280,"2022",2,0,3,5
241280,"2023",0,1,1,2
241290,"2015",1,0,5,6
241290,"2016",0,2,2,4
241290,"2017",0,0,4,4
241290,"2018",3,1,0,4
241290,"2019",0,3,0,3
241290,"2020",3,1,0,4
241290,"2022",2,0,2,4
241290,"2023",0,0,1,1
241300,"2015",2,0,1,3
241300,"2016",1,0,3,4
241300,"2017",0,0,3,3
241300,"2018",0,1,3,4
241300,"2019",2,1,2,5
241300,"2020",1,0,1,2
241300,"2021",2,1,0,3
241300,"2022",0,1,0,1
241300,"2023",1,0,0,1
241310,"2015",0,1,1,2
241310,"2016",4,1,2,7
241310,"2017",0,0,3,3
241310,"2018",2,1,4,7
241310,"2019",1,0,2,3
241310,"2020",0,1,1,2
241310,"2021",0,0,1,1
241310,"2022",1,0,3,4
241320,"2015",3,0,3,6
241320,"2016",2,1,3,6
241320,"2017",0,0,3,3
241320,"2018",2,1,4,7
241320,"2019",0,0,1,1
241320,"2020",1,0,1,2
241320,"2021",0,1,1,2
241320,"2022",0,0,1,1
241330,"2015",0,0,4,4
241330,"2016",0,0,1,1
241330,"2017",1,0,0,1
241330,"2019",1,2,1,4
241330,"2020",1,1,2,4
241330,"2021",2,0,1,3
241330,"2022",1,0,1,2
241330,"2023",1,0,2,3
241335,"2015",1,0,4,5
241335,"2016",4,0,9,13
241335,"2017",3,0,10,13
241335,"2018",4,2,13,19
241335,"2019",4,1,17,22
241335,"2020",9,0,11,20
241335,"2021",9,3,11,23
241335,"2022",7,2,12,21
241335,"2023",1,0,4,5
241340,"2015",2,0,1,3
241340,"2016",2,2,2,6
241340,"2017",4,0,6,10
241340,"2018",4,2,4,10
241340,"2019",3,1,3,7
241340,"2020",4,1,2,7
241340,"2021",0,1,3,4
241340,"2022",1,0,2,3
241340,"2023",0,0,2,2
241350,"2015",2,0,6,8
241350,"2016",1,1,6,8
241350,"2017",1,0,3,4
241350,"2018",1,0,0,1
241350,"2019",0,3,3,6
241350,"2020",2,0,2,4
241350,"2021",1,1,1,3
241350,"2022",2,0,0,2
241350,"2023",0,0,3,3
241355,"2015",2,1,0,3
241355,"2017",4,0,2,6
241355,"2018",1,2,1,4
241355,"2019",1,1,3,5
241355,"2020",0,0,1,1
241355,"2021",1,2,4,7
241355,"2022",2,0,1,3
241360,"2015",1,0,0,1
241360,"2017",0,1,1,2
241360,"2018",1,0,4,5
241360,"2019",1,0,3,4
241360,"2020",0,0,3,3
241360,"2021",1,0,1,2
241360,"2022",1,0,1,2
241360,"2023",0,0,1,1
241370,"2015",2,0,2,4
241370,"2016",1,0,1,2
241370,"2017",1,0,1,2
241370,"2018",1,0,2,3
241370,"2019",0,0,1,1
241370,"2020",0,0,1,1
241370,"2022",0,0,2,2
241370,"2023",1,1,2,4
241380,"2015",1,1,0,2
241380,"2016",1,1,1,3
241380,"2017",0,0,1,1
241380,"2018",0,0,2,2
241380,"2019",0,0,2,2
241380,"2020",0,0,1,1
241380,"2022",0,0,2,2
241380,"2023",1,0,1,2
241390,"2015",1,0,8,9
241390,"2016",0,0,3,3
241390,"2017",1,1,3,5
241390,"2018",2,0,7,9
241390,"2019",1,1,5,7
241390,"2020",4,0,5,9
241390,"2021",2,0,7,9
241390,"2022",0,0,2,2
241390,"2023",1,0,2,3
241400,"2015",4,2,8,14
241400,"2016",3,0,7,10
241400,"2017",3,0,6,9
241400,"2018",5,0,3,8
241400,"2019",2,1,1,4
241400,"2020",2,0,6,8
241400,"2021",1,0,3,4
241400,"2022",2,1,2,5
241400,"2023",1,0,1,2
241410,"2015",5,2,3,10
241410,"2016",1,0,1,2
241410,"2017",3,0,8,11
241410,"2018",2,0,7,9
241410,"2019",2,0,8,10
241410,"2020",4,0,2,6
241410,"2021",1,0,7,8
241410,"2022",0,1,1,2
241410,"2023",2,0,2,4
241415,"2015",1,1,1,3
241415,"2016",2,2,1,5
241415,"2017",2,0,1,3
241415,"2018",3,0,1,4
241415,"2019",1,0,1,2
241415,"2020",3,0,2,5
241415,"2021",0,0,2,2
241415,"2022",0,0,1,1
241420,"2015",9,0,17,26
241420,"2016",5,3,8,16
241420,"2017",5,1,5,11
241420,"2018",8,2,6,16
241420,"2019",5,7,8,20
241420,"2020",5,2,6,13
241420,"2021",6,1,12,19
241420,"2022",4,1,4,9
241420,"2023",2,2,6,10
241430,"2015",1,0,0,1
241430,"2016",0,0,3,3
241430,"2017",1,0,1,2
241430,"2019",2,0,0,2
241430,"2021",1,0,0,1
241430,"2022",0,1,0,1
241440,"2015",12,4,14,30
241440,"2016",6,3,16,25
241440,"2017",6,0,20,26
241440,"2018",7,4,17,28
241440,"2019",15,0,28,43
241440,"2020",9,1,11,21
241440,"2021",10,3,14,27
241440,"2022",10,1,11,22
241440,"2023",3,4,8,15
241445,"2015",0,0,2,2
241445,"2016",3,0,3,6
241445,"2017",0,0,1,1
241445,"2018",0,1,3,4
241445,"2019",0,1,3,4
241445,"2020",2,0,4,6
241445,"2021",7,1,0,8
241445,"2022",2,0,1,3
241445,"2023",0,0,2,2
241450,"2015",1,1,5,7
241450,"2016",0,1,1,2
241450,"2017",6,0,2,8
241450,"2018",3,1,2,6
241450,"2019",2,1,0,3
241450,"2020",2,0,2,4
241450,"2021",3,1,5,9
241450,"2022",2,0,0,2
241450,"2023",3,0,3,6
241460,"2015",4,1,9,14
241460,"2016",4,1,3,8
241460,"2017",9,1,8,18
241460,"2018",3,2,7,12
241460,"2019",2,1,8,11
241460,"2020",4,0,7,11
241460,"2021",2,2,3,7
241460,"2022",3,4,5,12
241460,"2023",5,1,3,9
241470,"2015",3,1,1,5
241470,"2016",1,0,2,3
241470,"2017",0,0,3,3
241470,"2018",2,0,2,4
241470,"2019",2,0,2,4
241470,"2020",0,1,1,2
241470,"2021",1,0,3,4
241470,"2022",0,1,1,2
241470,"2023",0,0,1,1
241475,"2015",1,0,1,2
241475,"2016",0,1,0,1
241475,"2017",2,0,0,2
241475,"2018",1,0,2,3
241475,"2019",0,0,4,4
241475,"2020",0,0,1,1
241475,"2021",1,0,0,1
241475,"2022",2,0,1,3
241480,"2015",4,1,9,14
241480,"2016",3,1,5,9
241480,"2017",3,1,6,10
241480,"2018",4,0,3,7
241480,"2019",2,2,11,15
241480,"2020",1,1,3,5
241480,"2021",5,0,6,11
241480,"2022",0,0,3,3
241480,"2023",1,0,9,10
241490,"2018",2,0,0,2
241490,"2022",0,1,0,1
241500,"2015",0,0,1,1
241500,"2016",0,0,2,2
241500,"2017",0,0,2,2
241500,"2018",1,0,1,2
241500,"2019",1,0,3,4
241500,"2020",2,1,1,4
241500,"2023",1,0,2,3
250010,"2015",1,0,7,8
250010,"2016",1,3,5,9
250010,"2017",3,2,4,9
250010,"2018",2,1,4,7
250010,"2019",0,1,8,9
250010,"2020",2,0,4,6
250010,"2021",3,1,4,8
250010,"2022",6,0,6,12
250010,"2023",1,1,2,4
250020,"2015",1,1,2,4
250020,"2016",3,1,5,9
250020,"2017",1,0,4,5
250020,"2018",1,0,2,3
250020,"2019",0,1,0,1
250020,"2020",5,0,3,8
250020,"2021",0,0,1,1
250020,"2022",1,0,1,2
250020,"2023",1,0,1,2
250030,"2015",6,3,19,28
250030,"2016",8,1,21,30
250030,"2017",10,0,21,31
250030,"2018",8,2,15,25
250030,"2019",10,1,14,25
250030,"2020",1,1,2,4
250030,"2021",4,0,6,10
250030,"2022",2,1,3,6
250030,"2023",1,2,6,9
250040,"2015",9,0,11,20
250040,"2016",5,3,8,16
250040,"2017",9,1,8,18
250040,"2018",9,1,17,27
250040,"2019",10,2,17,29
250040,"2020",4,0,2,6
250040,"2021",2,0,6,8
250040,"2022",5,0,3,8
250040,"2023",0,0,1,1
250050,"2015",2,1,12,15
250050,"2016",10,2,11,23
250050,"2017",3,1,16,20
250050,"2018",4,2,7,13
250050,"2019",9,1,8,18
250050,"2020",5,2,10,17
250050,"2021",3,0,2,5
250050,"2022",1,1,1,3
250050,"2023",1,0,3,4
250053,"2015",2,2,7,11
250053,"2016",2,1,2,5
250053,"2017",6,1,2,9
250053,"2018",0,0,2,2
250053,"2019",4,1,1,6
250053,"2020",1,0,1,2
250053,"2021",1,0,1,2
250053,"2022",4,0,2,6
250053,"2023",0,1,2,3
250057,"2015",2,0,3,5
250057,"2016",0,1,1,2
250057,"2017",1,1,0,2
250057,"2018",7,0,4,11
250057,"2019",1,1,3,5
250057,"2022",0,0,1,1
250057,"2023",1,0,0,1
250060,"2015",6,2,22,30
250060,"2016",9,1,16,26
250060,"2017",7,1,10,18
250060,"2018",8,2,14,24
250060,"2019",6,2,12,20
250060,"2020",4,2,13,19
250060,"2021",5,2,5,12
250060,"2022",2,0,9,11
250060,"2023",2,0,7,9
250070,"2015",2,2,2,6
250070,"2016",2,2,2,6
250070,"2017",3,3,5,11
250070,"2018",4,3,11,18
250070,"2019",6,0,1,7
250070,"2020",6,2,6,14
250070,"2021",6,0,5,11
250070,"2022",7,1,6,14
250070,"2023",2,1,6,9
250073,"2015",0,0,1,1
250073,"2016",0,0,1,1
250073,"2018",0,0,2,2
250073,"2019",0,0,2,2
250073,"2020",1,0,1,2
250073,"2021",1,1,1,3
250073,"2022",0,0,2,2
250073,"2023",0,0,1,1
250077,"2015",1,0,0,1
250077,"2016",1,0,0,1
250077,"2022",0,0,1,1
250077,"2023",1,0,1,2
250080,"2015",3,1,5,9
250080,"2016",1,0,8,9
250080,"2017",7,0,12,19
250080,"2018",9,0,12,21
250080,"2019",8,0,9,17
250080,"2020",5,3,8,16
250080,"2021",1,0,1,2
250080,"2022",4,2,4,10
250080,"2023",4,2,7,13
250090,"2015",3,0,3,6
250090,"2016",4,0,4,8
250090,"2017",5,0,4,9
250090,"2018",1,0,5,6
250090,"2019",7,1,6,14
250090,"2020",1,0,2,3
250090,"2021",1,0,0,1
250090,"2022",2,0,0,2
250090,"2023",0,0,1,1
250100,"2015",4,1,4,9
250100,"2016",5,1,12,18
250100,"2017",4,0,17,21
250100,"2018",11,1,6,18
250100,"2019",4,1,10,15
250100,"2020",6,3,5,14
250100,"2021",1,0,4,5
250100,"2022",3,0,3,6
250100,"2023",6,1,2,9
250110,"2015",7,3,12,22
250110,"2016",9,4,14,27
250110,"2017",13,2,13,28
250110,"2018",10,4,13,27
250110,"2019",10,2,11,23
250110,"2020",1,3,1,5
250110,"2021",2,1,5,8
250110,"2022",4,0,6,10
250110,"2023",1,1,2,4
250115,"2015",0,0,1,1
250115,"2017",2,0,2,4
250115,"2021",1,0,2,3
250115,"2022",2,0,0,2
250120,"2015",5,0,14,19
250120,"2016",2,2,4,8
250120,"2017",1,0,5,6
250120,"2018",2,0,5,7
250120,"2019",3,1,3,7
250120,"2020",2,0,1,3
250120,"2021",1,0,0,1
250120,"2022",1,1,1,3
250120,"2023",0,0,2,2
250130,"2015",8,3,13,24
250130,"2016",5,2,12,19
250130,"2017",7,2,16,25
250130,"2018",8,0,8,16
250130,"2019",9,5,15,29
250130,"2020",3,1,3,7
250130,"2021",0,0,4,4
250130,"2022",8,0,4,12
250130,"2023",0,0,3,3
250135,"2015",1,1,2,4
250135,"2016",2,2,1,5
250135,"2017",0,0,2,2
250135,"2018",0,0,3,3
250135,"2019",0,0,4,4
250135,"2021",1,0,0,1
250135,"2022",1,0,1,2
250140,"2015",1,0,4,5
250140,"2016",2,0,3,5
250140,"2017",0,0,3,3
250140,"2018",5,3,5,13
250140,"2019",0,1,6,7
250140,"2020",2,1,6,9
250140,"2021",3,1,11,15
250140,"2022",0,0,2,2
250140,"2023",1,0,0,1
250150,"2015",7,2,7,16
250150,"2016",9,2,5,16
250150,"2017",5,3,9,17
250150,"2018",6,1,6,13
250150,"2019",7,2,6,15
250150,"2020",8,0,8,16
250150,"2021",2,2,3,7
250150,"2022",1,0,3,4
250150,"2023",8,0,4,12
250153,"2015",0,0,1,1
250153,"2016",1,0,1,2
250153,"2017",2,0,3,5
250153,"2018",0,0,1,1
250153,"2019",3,0,2,5
250153,"2020",0,0,1,1
250153,"2021",1,1,3,5
250153,"2022",0,1,2,3
250153,"2023",2,0,3,5
250157,"2015",3,2,6,11
250157,"2016",2,1,6,9
250157,"2017",3,3,6,12
250157,"2018",2,2,4,8
250157,"2019",2,0,2,4
250157,"2020",0,2,0,2
250157,"2021",4,2,2,8
250157,"2022",2,0,3,5
250157,"2023",0,1,0,1
250160,"2015",5,2,4,11
250160,"2016",1,1,4,6
250160,"2017",3,0,3,6
250160,"2018",4,2,1,7
250160,"2019",7,0,4,11
250160,"2020",4,0,2,6
250160,"2021",1,0,5,6
250160,"2022",0,0,3,3
250160,"2023",3,1,3,7
250170,"2015",1,0,3,4
250170,"2016",0,1,2,3
250170,"2017",1,1,1,3
250170,"2018",1,2,1,4
250170,"2019",3,1,2,6
250170,"2020",3,0,2,5
250170,"2021",2,0,0,2
250170,"2022",3,0,2,5
250170,"2023",0,0,2,2
250180,"2015",21,1,59,81
250180,"2016",30,2,39,71
250180,"2017",17,6,38,61
250180,"2018",36,2,59,97
250180,"2019",33,7,51,91
250180,"2020",28,3,49,80
250180,"2021",25,7,66,98
250180,"2022",26,4,50,80
250180,"2023",14,4,18,36
250190,"2015",2,0,13,15
250190,"2016",6,3,6,15
250190,"2017",5,2,10,17
250190,"2018",12,3,13,28
250190,"2019",10,2,8,20
250190,"2020",3,1,5,9
250190,"2021",1,0,1,2
250190,"2022",4,1,8,13
250190,"2023",1,1,2,4
250200,"2016",1,0,0,1
250200,"2017",2,2,3,7
250200,"2018",1,0,4,5
250200,"2019",2,1,2,5
250200,"2020",1,2,1,4
250200,"2021",4,1,3,8
250200,"2022",7,2,3,12
250200,"2023",0,2,3,5
250205,"2016",1,0,0,1
250205,"2017",1,0,3,4
250205,"2018",4,1,2,7
250205,"2019",2,0,0,2
250205,"2020",3,0,1,4
250205,"2021",1,0,0,1
250205,"2022",4,0,1,5
250205,"2023",1,1,1,3
250210,"2015",1,0,2,3
250210,"2016",4,1,1,6
250210,"2017",3,0,4,7
250210,"2018",4,0,4,8
250210,"2019",6,1,4,11
250210,"2020",4,1,3,8
250210,"2021",3,1,4,8
250210,"2022",2,0,2,4
250210,"2023",1,0,1,2
250215,"2015",1,2,5,8
250215,"2016",6,1,6,13
250215,"2017",3,0,7,10
250215,"2018",1,0,2,3
250215,"2019",0,1,5,6
250215,"2020",3,0,0,3
250215,"2021",1,0,1,2
250215,"2022",1,0,1,2
250215,"2023",0,1,0,1
250220,"2015",1,0,0,1
250220,"2016",1,0,0,1
250220,"2017",0,0,2,2
250220,"2018",0,1,1,2
250220,"2020",2,0,0,2
250220,"2021",0,0,1,1
250220,"2022",1,0,1,2
250220,"2023",1,0,1,2
250230,"2016",1,0,0,1
250230,"2017",0,0,3,3
250230,"2018",0,1,3,4
250230,"2019",2,0,6,8
250230,"2020",1,0,2,3
250230,"2021",1,0,3,4
250230,"2022",0,0,3,3
250230,"2023",0,0,3,3
250240,"2015",0,0,4,4
250240,"2016",1,0,1,2
250240,"2017",3,0,6,9
250240,"2018",1,0,6,7
250240,"2019",1,1,5,7
250240,"2020",4,1,4,9
250240,"2021",2,0,10,12
250240,"2022",0,1,5,6
250240,"2023",0,0,2,2
250250,"2015",7,1,17,25
250250,"2016",8,2,11,21
250250,"2017",8,0,9,17
250250,"2018",7,3,12,22
250250,"2019",11,1,7,19
250250,"2020",2,0,1,3
250250,"2021",3,1,6,10
250250,"2022",0,1,5,6
250250,"2023",0,1,3,4
250260,"2015",0,0,3,3
250260,"2016",0,1,3,4
250260,"2017",1,0,3,4
250260,"2018",0,0,1,1
250260,"2019",1,0,5,6
250260,"2020",3,0,1,4
250260,"2021",3,0,3,6
250260,"2022",2,2,6,10
250260,"2023",3,0,0,3
250270,"2015",3,0,4,7
250270,"2016",2,0,5,7
250270,"2017",2,0,4,6
250270,"2018",2,1,4,7
250270,"2019",3,1,2,6
250270,"2020",2,0,7,9
250270,"2021",0,1,1,2
250270,"2022",3,0,2,5
250270,"2023",1,0,0,1
250280,"2015",0,0,1,1
250280,"2016",2,0,9,11
250280,"2017",3,1,12,16
250280,"2018",6,0,6,12
250280,"2019",7,1,10,18
250280,"2020",1,2,5,8
250280,"2021",4,1,4,9
250280,"2022",5,0,4,9
250280,"2023",1,1,5,7
250290,"2015",1,0,2,3
250290,"2016",1,0,1,2
250290,"2017",1,1,2,4
250290,"2018",3,0,2,5
250290,"2019",0,0,3,3
250290,"2020",0,1,2,3
250290,"2021",2,0,2,4
250290,"2022",2,0,7,9
250290,"2023",2,0,0,2
250300,"2015",4,1,11,16
250300,"2016",6,1,8,15
250300,"2017",3,0,14,17
250300,"2018",5,2,12,19
250300,"2019",4,1,8,13
250300,"2020",7,1,10,18
250300,"2021",4,1,9,14
250300,"2022",6,0,1,7
250300,"2023",3,1,3,7
250310,"2015",1,0,5,6
250310,"2016",2,1,2,5
250310,"2017",1,1,1,3
250310,"2018",1,0,1,2
250310,"2019",1,0,3,4
250310,"2021",1,0,0,1
250310,"2022",0,1,1,2
250320,"2015",22,3,23,48
250320,"2016",4,2,11,17
250320,"2017",7,0,15,22
250320,"2018",16,0,16,32
250320,"2019",7,0,10,17
250320,"2020",10,2,17,29
250320,"2021",0,1,6,7
250320,"2022",6,0,6,12
250320,"2023",5,2,4,11
250330,"2015",0,0,4,4
250330,"2016",1,0,3,4
250330,"2017",3,0,5,8
250330,"2018",2,0,4,6
250330,"2019",3,0,2,5
250330,"2020",2,0,3,5
250330,"2021",5,0,2,7
250330,"2022",4,0,2,6
250330,"2023",0,1,4,5
250340,"2015",2,0,3,5
250340,"2016",0,0,2,2
250340,"2017",2,0,1,3
250340,"2018",1,1,0,2
250340,"2019",2,0,3,5
250340,"2020",3,0,5,8
250340,"2021",0,1,3,4
250340,"2022",1,0,0,1
250350,"2015",4,1,10,15
250350,"2016",5,1,12,18
250350,"2017",1,1,15,17
250350,"2018",7,3,5,15
250350,"2019",4,1,8,13
250350,"2020",10,1,5,16
250350,"2021",0,0,2,2
250350,"2022",2,4,1,7
250350,"2023",3,2,5,10
250355,"2015",0,0,7,7
250355,"2016",5,1,4,10
250355,"2017",3,1,6,10
250355,"2018",1,1,2,4
250355,"2019",1,1,1,3
250355,"2020",5,0,2,7
250355,"2021",1,0,4,5
250355,"2022",2,1,1,4
250355,"2023",1,1,1,3
250360,"2015",1,0,5,6
250360,"2016",5,1,0,6
250360,"2017",2,0,5,7
250360,"2018",2,1,5,8
250360,"2019",10,2,5,17
250360,"2020",2,1,5,8
250360,"2021",0,0,3,3
250360,"2022",1,0,2,3
250360,"2023",1,0,1,2
250370,"2015",3,0,10,13
250370,"2016",10,2,26,38
250370,"2017",13,4,29,46
250370,"2018",31,3,45,79
250370,"2019",19,5,28,52
250370,"2020",20,6,27,53
250370,"2021",26,7,46,79
250370,"2022",32,8,33,73
250370,"2023",22,8,30,60
250375,"2015",0,1,2,3
250375,"2016",0,0,1,1
250375,"2017",0,0,3,3
250375,"2018",2,0,5,7
250375,"2019",1,2,1,4
250375,"2020",0,0,2,2
250375,"2021",1,0,0,1
250375,"2022",0,1,0,1
250375,"2023",0,0,2,2
250380,"2015",1,0,3,4
250380,"2016",0,0,1,1
250380,"2017",2,0,2,4
250380,"2018",0,1,1,2
250380,"2019",0,0,3,3
250380,"2020",1,0,1,2
250380,"2021",0,0,1,1
250380,"2023",0,1,0,1
250390,"2015",0,0,1,1
250390,"2016",2,0,3,5
250390,"2017",2,1,2,5
250390,"2018",2,0,1,3
250390,"2019",1,0,6,7
250390,"2020",1,0,4,5
250390,"2021",4,1,0,5
250390,"2022",3,0,3,6
250390,"2023",1,0,2,3
250400,"2015",231,64,373,668
250400,"2016",190,58,315,563
250400,"2017",186,56,306,548
250400,"2018",196,55,275,526
250400,"2019",179,52,323,554
250400,"2020",72,14,100,186
250400,"2021",43,19,85,147
250400,"2022",58,14,93,165
250400,"2023",33,16,71,120
250403,"2015",2,0,2,4
250403,"2016",0,1,0,1
250403,"2017",1,0,3,4
250403,"2018",0,0,7,7
250403,"2019",2,1,0,3
250403,"2020",1,0,2,3
250403,"2021",4,0,3,7
250403,"2022",2,0,1,3
250403,"2023",1,0,1,2
250407,"2015",0,1,0,1
250407,"2016",2,0,1,3
250407,"2018",0,0,1,1
250407,"2019",2,0,2,4
250407,"2020",0,1,1,2
250407,"2021",2,0,5,7
250407,"2022",1,0,3,4
250407,"2023",0,0,2,2
250410,"2018",0,0,2,2
250410,"2019",1,0,0,1
250410,"2020",0,0,2,2
250410,"2022",1,0,0,1
250415,"2015",4,1,1,6
250415,"2016",1,0,3,4
250415,"2017",0,0,2,2
250415,"2018",1,2,1,4
250415,"2019",3,2,3,8
250415,"2020",0,1,1,2
250415,"2021",3,0,1,4
250415,"2022",2,0,0,2
250415,"2023",1,0,0,1
250420,"2015",2,0,3,5
250420,"2016",1,0,2,3
250420,"2017",2,1,3,6
250420,"2018",1,0,0,1
250420,"2019",1,0,4,5
250420,"2020",3,1,6,10
250420,"2021",1,1,1,3
250430,"2015",2,0,4,6
250430,"2016",4,1,5,10
250430,"2017",18,3,29,50
250430,"2018",16,3,15,34
250430,"2019",24,5,25,54
250430,"2020",11,1,20,32
250430,"2021",13,2,8,23
250430,"2022",19,3,26,48
250430,"2023",12,3,10,25
250435,"2015",3,2,4,9
250435,"2016",3,1,4,8
250435,"2017",1,1,3,5
250435,"2018",0,0,3,3
250435,"2019",0,1,1,2
250435,"2020",1,0,0,1
250435,"2021",0,0,1,1
250435,"2022",1,0,0,1
250435,"2023",1,0,1,2
250440,"2015",2,0,11,13
250440,"2016",7,1,12,20
250440,"2017",4,1,10,15
250440,"2018",3,0,1,4
250440,"2019",5,0,11,16
250440,"2020",5,0,6,11
250440,"2021",2,1,8,11
250440,"2022",5,1,13,19
250440,"2023",2,1,2,5
250450,"2015",2,0,3,5
250450,"2016",4,0,2,6
250450,"2017",0,0,2,2
250450,"2018",0,0,3,3
250450,"2019",1,1,2,4
250450,"2020",1,1,2,4
250450,"2021",2,1,3,6
250450,"2022",0,2,2,4
250450,"2023",0,0,2,2
250460,"2015",10,2,16,28
250460,"2016",4,1,17,22
250460,"2017",8,3,21,32
250460,"2018",12,1,17,30
250460,"2019",4,4,19,27
250460,"2020",9,3,14,26
250460,"2021",11,2,12,25
250460,"2022",9,4,14,27
250460,"2023",6,2,9,17
250470,"2015",0,0,6,6
250470,"2016",1,0,1,2
250470,"2017",0,1,1,2
250470,"2018",2,0,1,3
250470,"2019",1,2,0,3
250470,"2020",1,1,2,4
250470,"2021",6,2,6,14
250470,"2022",1,1,4,6
250470,"2023",1,0,0,1
250480,"2015",3,1,2,6
250480,"2016",5,0,5,10
250480,"2017",3,0,7,10
250480,"2018",3,0,4,7
250480,"2019",1,1,4,6
250480,"2020",2,0,7,9
250480,"2021",3,0,2,5
250480,"2022",2,0,1,3
250480,"2023",0,0,2,2
250485,"2015",0,0,2,2
250485,"2016",1,0,0,1
250485,"2018",0,0,1,1
250485,"2022",0,1,0,1
250490,"2015",6,0,19,25
250490,"2016",4,1,13,18
250490,"2017",8,0,12,20
250490,"2018",4,1,16,21
250490,"2019",5,1,14,20
250490,"2020",3,1,19,23
250490,"2021",4,2,15,21
250490,"2022",4,1,13,18
250490,"2023",10,0,7,17
250500,"2015",2,0,0,2
250500,"2016",1,1,5,7
250500,"2017",3,0,12,15
250500,"2018",6,1,7,14
250500,"2019",1,0,4,5
250500,"2020",0,1,0,1
250500,"2021",3,0,1,4
250500,"2022",0,0,1,1
250500,"2023",0,0,3,3
250510,"2015",6,1,6,13
250510,"2016",4,1,6,11
250510,"2017",3,1,7,11
250510,"2018",2,0,4,6
250510,"2019",4,2,6,12
250510,"2020",2,0,4,6
250510,"2021",2,1,8,11
250510,"2022",4,1,7,12
250510,"2023",1,0,7,8
250520,"2015",1,0,10,11
250520,"2016",0,2,4,6
250520,"2017",3,0,7,10
250520,"2018",5,0,8,13
250520,"2019",4,2,3,9
250520,"2020",3,0,1,4
250520,"2022",3,1,1,5
250520,"2023",0,0,2,2
250523,"2015",0,0,2,2
250523,"2016",1,0,4,5
250523,"2017",2,0,2,4
250523,"2018",2,3,5,10
250523,"2019",0,1,1,2
250523,"2020",0,0,3,3
250523,"2021",0,2,2,4
250523,"2022",1,1,4,6
250523,"2023",0,1,1,2
250527,"2015",2,0,1,3
250527,"2016",1,0,0,1
250527,"2018",1,0,0,1
250527,"2019",1,0,1,2
250527,"2020",2,1,1,4
250527,"2021",1,1,1,3
250527,"2022",2,0,2,4
250530,"2015",1,0,0,1
250530,"2016",0,0,1,1
250530,"2018",0,0,3,3
250530,"2019",1,0,0,1
250530,"2020",0,1,4,5
250530,"2022",2,0,0,2
250535,"2015",0,0,3,3
250535,"2016",1,0,1,2
250535,"2017",3,1,1,5
250535,"2018",1,0,4,5
250535,"2019",4,0,0,4
250535,"2020",1,0,3,4
250535,"2021",1,0,1,2
250535,"2022",0,0,1,1
250535,"2023",1,0,0,1
250540,"2015",3,1,8,12
250540,"2016",7,3,4,14
250540,"2017",4,3,6,13
250540,"2018",1,0,1,2
250540,"2019",2,0,6,8
250540,"2020",1,0,5,6
250540,"2021",0,1,4,5
250540,"2022",1,0,3,4
250540,"2023",0,1,0,1
250550,"2015",4,0,1,5
250550,"2016",0,1,1,2
250550,"2017",0,2,4,6
250550,"2018",0,1,0,1
250550,"2019",1,1,0,2
250550,"2020",1,0,1,2
250550,"2021",1,0,1,2
250550,"2022",0,0,1,1
250550,"2023",0,1,1,2
250560,"2015",5,0,2,7
250560,"2016",2,1,2,5
250560,"2017",5,0,3,8
250560,"2018",3,0,4,7
250560,"2019",2,0,5,7
250560,"2020",0,0,4,4
250560,"2021",6,3,7,16
250560,"2022",0,0,2,2
250560,"2023",1,1,3,5
250570,"2015",2,0,7,9
250570,"2016",3,1,11,15
250570,"2017",10,1,6,17
250570,"2018",8,1,7,16
250570,"2019",2,0,3,5
250570,"2020",5,1,3,9
250570,"2021",0,0,3,3
250570,"2022",1,0,0,1
250570,"2023",3,1,1,5
250580,"2015",2,1,0,3
250580,"2016",1,0,2,3
250580,"2017",1,0,3,4
250580,"2018",2,0,4,6
250580,"2019",1,0,2,3
250580,"2020",4,0,4,8
250580,"2021",1,0,2,3
250580,"2022",0,0,1,1
250580,"2023",0,0,1,1
250590,"2015",1,0,2,3
250590,"2016",1,0,2,3
250590,"2017",2,0,2,4
250590,"2018",0,0,1,1
250590,"2019",1,0,1,2
250590,"2020",0,0,1,1
250590,"2021",2,0,1,3
250590,"2022",1,0,0,1
250600,"2015",19,5,30,54
250600,"2016",8,5,19,32
250600,"2017",11,4,25,40
250600,"2018",7,4,22,33
250600,"2019",19,2,18,39
250600,"2020",5,2,4,11
250600,"2021",3,1,6,10
250600,"2022",7,1,6,14
250600,"2023",2,0,3,5
250610,"2015",8,1,10,19
250610,"2016",1,4,3,8
250610,"2017",11,1,3,15
250610,"2018",4,0,5,9
250610,"2019",7,3,5,15
250610,"2020",0,0,3,3
250610,"2021",1,0,3,4
250610,"2023",1,0,0,1
250620,"2015",0,1,0,1
250620,"2017",2,1,1,4
250620,"2018",0,1,1,2
250620,"2019",0,0,2,2
250620,"2022",1,0,0,1
250625,"2015",5,1,6,12
250625,"2016",5,1,8,14
250625,"2017",2,0,4,6
250625,"2018",5,0,6,11
250625,"2019",3,1,5,9
250625,"2020",2,1,3,6
250625,"2021",1,1,3,5
250625,"2022",3,0,1,4
250625,"2023",2,1,0,3
250630,"2015",28,3,38,69
250630,"2016",22,2,24,48
250630,"2017",12,6,44,62
250630,"2018",27,11,46,84
250630,"2019",38,12,41,91
250630,"2020",26,1,36,63
250630,"2021",7,1,8,16
250630,"2022",21,4,18,43
250630,"2023",16,6,15,37
250640,"2015",2,0,2,4
250640,"2016",2,1,2,5
250640,"2017",1,0,5,6
250640,"2018",3,0,2,5
250640,"2019",0,0,1,1
250640,"2021",0,1,0,1
250640,"2023",0,0,1,1
250650,"2015",2,0,1,3
250650,"2016",4,1,4,9
250650,"2017",4,0,2,6
250650,"2018",2,1,0,3
250650,"2019",4,2,3,9
250650,"2021",3,0,0,3
250650,"2022",1,0,1,2
250650,"2023",1,0,1,2
250660,"2015",0,0,6,6
250660,"2016",4,1,2,7
250660,"2017",2,1,6,9
250660,"2018",2,0,5,7
250660,"2019",1,0,2,3
250660,"2020",1,0,6,7
250660,"2021",1,1,1,3
250660,"2022",2,0,3,5
250660,"2023",2,0,1,3
250670,"2015",2,0,7,9
250670,"2016",0,2,4,6
250670,"2017",3,0,3,6
250670,"2018",0,0,1,1
250670,"2019",2,0,5,7
250670,"2020",6,0,5,11
250670,"2021",1,0,1,2
250670,"2022",1,0,4,5
250670,"2023",1,0,1,2
250680,"2015",9,4,16,29
250680,"2016",9,4,12,25
250680,"2017",7,2,15,24
250680,"2018",10,4,12,26
250680,"2019",4,4,9,17
250680,"2020",0,1,10,11
250680,"2021",2,1,7,10
250680,"2022",3,1,8,12
250680,"2023",1,0,7,8
250690,"2015",2,1,6,9
250690,"2016",0,0,3,3
250690,"2017",1,2,0,3
250690,"2018",0,0,3,3
250690,"2019",1,0,3,4
250690,"2020",3,0,2,5
250690,"2022",0,0,2,2
250690,"2023",0,0,3,3
250700,"2015",4,0,10,14
250700,"2016",5,1,14,20
250700,"2017",11,1,20,32
250700,"2018",10,2,17,29
250700,"2019",13,3,17,33
250700,"2020",16,6,9,31
250700,"2021",16,3,19,38
250700,"2022",17,2,17,36
250700,"2023",4,3,9,16
250710,"2015",2,1,5,8
250710,"2016",1,0,3,4
250710,"2017",1,0,10,11
250710,"2018",10,0,5,15
250710,"2019",4,1,12,17
250710,"2020",4,4,10,18
250710,"2021",7,2,5,14
250710,"2022",5,2,8,15
250710,"2023",1,0,0,1
250720,"2015",2,4,15,21
250720,"2016",2,1,5,8
250720,"2017",3,0,2,5
250720,"2018",3,3,7,13
250720,"2019",3,2,3,8
250720,"2020",1,0,0,1
250720,"2021",0,2,2,4
250720,"2022",2,1,1,4
250720,"2023",2,1,0,3
250730,"2015",4,1,6,11
250730,"2016",1,0,6,7
250730,"2017",7,2,5,14
250730,"2018",3,0,2,5
250730,"2019",1,1,4,6
250730,"2020",3,0,6,9
250730,"2021",5,0,2,7
250730,"2022",4,1,3,8
250730,"2023",0,2,1,3
250740,"2015",0,1,3,4
250740,"2016",0,0,1,1
250740,"2017",2,2,3,7
250740,"2018",2,0,4,6
250740,"2019",1,0,9,10
250740,"2020",5,1,4,10
250740,"2021",4,0,6,10
250740,"2022",3,0,2,5
250740,"2023",1,0,0,1
250750,"2015",227,33,382,642
250750,"2016",182,64,334,580
250750,"2017",240,55,432,727
250750,"2018",243,67,410,720
250750,"2019",216,65,378,659
250750,"2020",208,61,291,560
250750,"2021",170,55,270,495
250750,"2022",126,48,229,403
250750,"2023",107,39,139,285
250760,"2015",5,3,6,14
250760,"2016",6,4,2,12
250760,"2017",5,1,3,9
250760,"2018",1,1,1,3
250760,"2019",0,1,3,4
250760,"2021",0,0,1,1
250760,"2022",0,0,1,1
250770,"2015",8,1,17,26
250770,"2016",8,1,12,21
250770,"2017",7,5,15,27
250770,"2018",6,5,12,23
250770,"2019",8,1,17,26
250770,"2020",0,1,3,4
250770,"2021",3,0,5,8
250770,"2022",1,1,3,5
250770,"2023",0,1,3,4
250780,"2015",2,2,6,10
250780,"2016",0,1,5,6
250780,"2017",2,1,2,5
250780,"2018",0,0,4,4
250780,"2019",2,0,3,5
250780,"2020",1,0,2,3
250780,"2021",0,0,3,3
250780,"2022",0,0,1,1
250790,"2015",2,0,2,4
250790,"2016",0,0,2,2
250790,"2017",1,1,2,4
250790,"2018",1,0,3,4
250790,"2019",1,0,1,2
250790,"2021",1,0,0,1
250790,"2022",0,0,2,2
250790,"2023",4,0,1,5
250800,"2015",2,0,3,5
250800,"2017",3,0,1,4
250800,"2018",2,0,0,2
250800,"2019",6,0,3,9
250800,"2020",2,0,3,5
250800,"2021",1,1,5,7
250800,"2022",2,1,3,6
250800,"2023",1,0,1,2
250810,"2015",2,0,4,6
250810,"2016",2,0,2,4
250810,"2017",3,0,3,6
250810,"2018",2,0,1,3
250810,"2019",2,0,3,5
250810,"2020",2,0,3,5
250810,"2021",0,0,1,1
250810,"2022",1,0,3,4
250810,"2023",0,0,2,2
250820,"2015",1,3,5,9
250820,"2016",4,2,7,13
250820,"2017",7,2,5,14
250820,"2018",2,2,9,13
250820,"2019",5,1,3,9
250820,"2020",1,2,2,5
250820,"2021",1,0,0,1
250820,"2022",2,0,3,5
250820,"2023",2,0,2,4
250830,"2015",11,4,15,30
250830,"2016",13,3,29,45
250830,"2017",10,2,17,29
250830,"2018",11,5,18,34
250830,"2019",13,4,15,32
250830,"2020",4,0,3,7
250830,"2021",4,2,4,10
250830,"2022",3,1,2,6
250830,"2023",2,1,3,6
250840,"2017",0,0,1,1
250850,"2015",1,1,4,6
250850,"2016",6,1,6,13
250850,"2017",3,1,5,9
250850,"2018",2,0,4,6
250850,"2019",3,0,4,7
250850,"2020",3,0,1,4
250850,"2021",0,0,1,1
250850,"2022",3,0,2,5
250850,"2023",2,0,1,3
250855,"2015",2,0,3,5
250855,"2016",0,0,3,3
250855,"2017",4,0,1,5
250855,"2018",2,0,1,3
250855,"2019",5,0,6,11
250855,"2020",0,0,1,1
250855,"2021",1,1,0,2
250855,"2022",0,0,2,2
250855,"2023",2,0,0,2
250860,"2015",7,0,9,16
250860,"2016",1,1,7,9
250860,"2017",1,2,4,7
250860,"2018",1,1,6,8
250860,"2019",8,0,5,13
250860,"2020",0,0,8,8
250860,"2021",4,0,6,10
250860,"2022",3,0,8,11
250860,"2023",1,1,9,11
250870,"2015",2,0,3,5
250870,"2016",0,0,4,4
250870,"2017",1,0,2,3
250870,"2018",1,0,1,2
250870,"2019",2,0,1,3
250870,"2020",0,0,1,1
250870,"2021",2,1,1,4
250880,"2015",3,0,6,9
250880,"2016",2,1,3,6
250880,"2017",0,0,4,4
250880,"2018",2,0,1,3
250880,"2019",3,0,2,5
250880,"2020",2,2,3,7
250880,"2021",2,0,3,5
250880,"2023",0,0,1,1
250890,"2015",6,3,14,23
250890,"2016",2,3,9,14
250890,"2017",8,3,14,25
250890,"2018",20,8,31,59
250890,"2019",13,3,20,36
250890,"2020",11,2,13,26
250890,"2021",11,4,15,30
250890,"2022",6,5,14,25
250890,"2023",4,1,2,7
250900,"2015",0,1,6,7
250900,"2016",0,0,4,4
250900,"2017",2,0,5,7
250900,"2018",3,0,4,7
250900,"2019",0,2,5,7
250900,"2020",5,0,3,8
250900,"2021",1,0,1,2
250900,"2022",4,0,4,8
250900,"2023",1,1,1,3
250905,"2015",0,0,2,2
250905,"2016",1,1,0,2
250905,"2017",0,1,6,7
250905,"2018",1,1,9,11
250905,"2019",1,1,3,5
250905,"2020",2,2,8,12
250905,"2021",1,1,8,10
250905,"2022",1,0,3,4
250910,"2015",5,2,12,19
250910,"2016",1,2,13,16
250910,"2017",8,1,13,22
250910,"2018",11,0,8,19
250910,"2019",6,0,13,19
250910,"2020",5,1,13,19
250910,"2021",5,1,7,13
250910,"2022",3,0,9,12
250910,"2023",2,1,12,15
250915,"2017",0,0,1,1
250915,"2022",1,0,0,1
250920,"2015",2,0,6,8
250920,"2016",4,2,3,9
250920,"2017",5,2,8,15
250920,"2018",4,1,11,16
250920,"2019",7,3,8,18
250920,"2020",2,2,5,9
250920,"2021",5,0,2,7
250920,"2022",2,1,4,7
250920,"2023",1,0,1,2
250930,"2015",3,0,1,4
250930,"2016",4,0,4,8
250930,"2017",3,0,4,7
250930,"2018",1,0,3,4
250930,"2019",2,0,2,4
250930,"2020",4,0,1,5
250930,"2021",2,0,8,10
250930,"2022",1,0,4,5
250933,"2015",1,0,4,5
250933,"2016",2,0,2,4
250933,"2017",0,2,11,13
250933,"2018",3,1,5,9
250933,"2019",1,3,3,7
250933,"2020",2,0,0,2
250933,"2021",0,0,1,1
250933,"2022",2,0,0,2
250933,"2023",0,0,1,1
250937,"2016",1,0,1,2
250937,"2017",0,0,3,3
250937,"2018",1,0,1,2
250937,"2019",3,0,1,4
250937,"2020",1,0,3,4
250937,"2022",1,0,0,1
250939,"2015",4,0,3,7
250939,"2016",2,0,7,9
250939,"2017",3,0,2,5
250939,"2018",1,0,1,2
250939,"2019",5,0,4,9
250939,"2020",4,0,2,6
250939,"2021",7,0,2,9
250939,"2022",1,0,1,2
250939,"2023",1,0,2,3
250940,"2015",5,0,4,9
250940,"2016",2,0,3,5
250940,"2017",3,0,3,6
250940,"2018",5,0,1,6
250940,"2019",5,0,10,15
250940,"2021",1,0,0,1
250940,"2022",2,0,1,3
250950,"2015",10,0,4,14
250950,"2016",2,0,1,3
250950,"2017",5,1,2,8
250950,"2018",4,0,2,6
250950,"2019",3,1,1,5
250950,"2020",0,0,3,3
250950,"2021",1,1,0,2
250950,"2022",2,1,2,5
250950,"2023",1,0,1,2
250960,"2015",1,0,0,1
250960,"2016",0,0,2,2
250960,"2017",1,0,4,5
250960,"2018",2,0,6,8
250960,"2019",2,0,1,3
250960,"2020",1,0,0,1
250960,"2021",1,0,2,3
250960,"2022",1,1,3,5
250960,"2023",0,0,1,1
250970,"2015",5,0,20,25
250970,"2016",11,2,13,26
250970,"2017",10,1,11,22
250970,"2018",7,1,8,16
250970,"2019",5,1,16,22
250970,"2020",11,4,14,29
250970,"2021",8,1,20,29
250970,"2022",15,6,27,48
250970,"2023",16,3,23,42
250980,"2015",5,1,9,15
250980,"2016",2,0,4,6
250980,"2017",4,0,6,10
250980,"2018",5,1,4,10
250980,"2019",3,1,8,12
250980,"2020",2,0,4,6
250980,"2022",2,1,3,6
250980,"2023",6,0,2,8
250990,"2015",1,1,2,4
250990,"2016",2,1,2,5
250990,"2017",3,0,3,6
250990,"2018",1,1,4,6
250990,"2019",2,0,2,4
250990,"2020",2,1,2,5
250990,"2021",0,0,2,2
250990,"2022",1,1,4,6
251000,"2017",1,0,2,3
251000,"2023",1,0,0,1
251010,"2015",1,0,5,6
251010,"2016",1,0,2,3
251010,"2017",2,1,1,4
251010,"2018",4,0,3,7
251010,"2019",3,0,7,10
251010,"2020",1,0,1,2
251010,"2021",2,0,0,2
251010,"2022",3,0,2,5
251010,"2023",1,0,1,2
251020,"2015",1,0,7,8
251020,"2016",2,0,5,7
251020,"2017",2,0,4,6
251020,"2018",1,0,4,5
251020,"2019",3,0,4,7
251020,"2020",3,0,4,7
251020,"2021",2,0,2,4
251020,"2022",2,0,2,4
251020,"2023",3,0,2,5
251030,"2015",0,0,4,4
251030,"2016",0,0,2,2
251030,"2017",0,0,1,1
251030,"2018",0,0,2,2
251030,"2019",1,0,1,2
251030,"2020",0,0,1,1
251030,"2021",1,0,0,1
251030,"2022",0,0,1,1
251040,"2015",4,1,4,9
251040,"2016",1,0,2,3
251040,"2017",3,0,1,4
251040,"2019",1,0,2,3
251040,"2020",3,0,7,10
251040,"2021",2,1,3,6
251040,"2022",1,0,1,2
251050,"2015",1,0,6,7
251050,"2016",2,1,3,6
251050,"2017",2,1,1,4
251050,"2018",0,0,1,1
251050,"2019",1,2,3,6
251050,"2021",0,0,2,2
251050,"2023",1,0,0,1
251060,"2016",0,0,2,2
251060,"2017",2,0,0,2
251060,"2019",2,0,1,3
251060,"2020",0,0,2,2
251060,"2021",1,0,0,1
251060,"2022",0,0,3,3
251060,"2023",1,0,0,1
251065,"2015",0,0,2,2
251065,"2016",0,0,4,4
251065,"2017",3,0,0,3
251065,"2019",3,1,1,5
251065,"2022",0,0,1,1
251065,"2023",1,0,1,2
251070,"2015",1,0,1,2
251070,"2016",1,0,3,4
251070,"2017",1,2,1,4
251070,"2018",0,0,1,1
251070,"2019",2,0,3,5
251070,"2020",3,0,0,3
251070,"2021",0,0,1,1
251070,"2022",0,0,2,2
251070,"2023",0,0,1,1
251080,"2015",45,8,78,131
251080,"2016",44,3,63,110
251080,"2017",50,6,75,131
251080,"2018",17,4,35,56
251080,"2019",38,7,53,98
251080,"2020",48,19,75,142
251080,"2021",47,11,44,102
251080,"2022",18,6,36,60
251080,"2023",8,6,16,30
251090,"2015",5,1,8,14
251090,"2016",5,0,3,8
251090,"2017",2,2,7,11
251090,"2018",5,3,6,14
251090,"2019",8,3,9,20
251090,"2020",3,3,5,11
251090,"2021",6,0,2,8
251090,"2022",3,1,4,8
251090,"2023",1,0,1,2
251100,"2015",1,1,1,3
251100,"2016",0,0,2,2
251100,"2017",0,1,4,5
251100,"2018",2,1,0,3
251100,"2019",2,1,3,6
251100,"2020",0,0,1,1
251100,"2021",1,1,1,3
251100,"2022",1,0,3,4
251110,"2015",1,0,4,5
251110,"2016",0,0,4,4
251110,"2017",2,0,5,7
251110,"2018",2,0,3,5
251110,"2019",3,0,5,8
251110,"2020",3,0,3,6
251110,"2021",1,0,2,3
251110,"2023",2,0,0,2
251120,"2015",5,1,18,24
251120,"2016",8,0,16,24
251120,"2017",8,2,23,33
251120,"2018",9,1,14,24
251120,"2019",17,3,16,36
251120,"2020",10,1,14,25
251120,"2021",7,0,8,15
251120,"2022",6,3,9,18
251120,"2023",7,1,5,13
251130,"2015",1,0,7,8
251130,"2016",2,0,6,8
251130,"2017",4,0,9,13
251130,"2018",0,2,4,6
251130,"2019",4,2,7,13
251130,"2020",1,2,4,7
251130,"2021",5,1,2,8
251130,"2022",5,1,6,12
251130,"2023",5,0,3,8
251140,"2015",1,0,5,6
251140,"2016",0,1,2,3
251140,"2017",5,2,10,17
251140,"2018",2,0,7,9
251140,"2019",6,2,5,13
251140,"2020",6,1,5,12
251140,"2021",6,2,6,14
251140,"2022",2,2,8,12
251140,"2023",2,1,4,7
251150,"2015",2,0,1,3
251150,"2016",2,0,5,7
251150,"2017",0,0,4,4
251150,"2018",2,0,3,5
251150,"2019",2,1,1,4
251150,"2020",0,0,2,2
251150,"2022",1,1,2,4
251150,"2023",0,0,2,2
251160,"2015",1,2,2,5
251160,"2016",3,0,3,6
251160,"2017",3,1,6,10
251160,"2018",5,1,7,13
251160,"2019",3,2,5,10
251160,"2020",1,2,2,5
251160,"2021",2,0,0,2
251160,"2022",1,0,1,2
251160,"2023",4,1,1,6
251170,"2015",1,0,2,3
251170,"2016",1,0,3,4
251170,"2017",4,0,3,7
251170,"2018",5,0,2,7
251170,"2019",3,0,2,5
251170,"2020",0,0,6,6
251170,"2021",0,0,1,1
251170,"2022",0,1,0,1
251170,"2023",1,1,1,3
251180,"2015",4,0,4,8
251180,"2016",4,0,8,12
251180,"2017",3,0,6,9
251180,"2018",9,2,5,16
251180,"2019",4,1,7,12
251180,"2020",0,1,8,9
251180,"2022",5,1,4,10
251180,"2023",0,1,2,3
251190,"2015",9,0,9,18
251190,"2016",9,2,9,20
251190,"2017",5,1,9,15
251190,"2018",4,1,5,10
251190,"2019",2,0,8,10
251190,"2020",6,1,10,17
251190,"2021",2,1,9,12
251190,"2022",1,2,7,10
251190,"2023",1,0,2,3
251200,"2015",6,3,15,24
251200,"2016",8,1,8,17
251200,"2017",7,4,11,22
251200,"2018",8,4,10,22
251200,"2019",14,3,8,25
251200,"2020",1,0,2,3
251200,"2021",1,0,4,5
251200,"2022",0,2,8,10
251200,"2023",2,0,3,5
251203,"2016",2,0,2,4
251203,"2017",6,0,2,8
251203,"2018",1,0,3,4
251203,"2019",0,1,1,2
251203,"2020",2,0,0,2
251203,"2021",1,0,3,4
251203,"2022",1,0,1,2
251203,"2023",4,0,0,4
251207,"2015",0,0,1,1
251207,"2016",2,0,1,3
251207,"2017",0,0,3,3
251207,"2020",2,0,2,4
251207,"2021",4,0,0,4
251207,"2022",3,0,3,6
251207,"2023",4,0,0,4
251210,"2015",12,2,17,31
251210,"2016",14,6,25,45
251210,"2017",21,2,18,41
251210,"2018",11,1,30,42
251210,"2019",11,3,18,32
251210,"2020",14,3,24,41
251210,"2021",12,7,18,37
251210,"2022",17,1,16,34
251210,"2023",9,4,15,28
251220,"2015",1,1,2,4
251220,"2017",0,0,1,1
251220,"2018",1,0,1,2
251220,"2019",2,0,2,4
251220,"2020",0,0,4,4
251220,"2021",0,0,5,5
251220,"2022",3,0,3,6
251220,"2023",0,1,2,3
251230,"2015",5,2,15,22
251230,"2016",2,3,4,9
251230,"2017",4,0,6,10
251230,"2018",3,0,3,6
251230,"2019",3,2,6,11
251230,"2020",4,2,6,12
251230,"2021",4,3,8,15
251230,"2022",8,2,7,17
251230,"2023",3,2,2,7
251240,"2015",4,0,10,14
251240,"2016",4,1,10,15
251240,"2017",5,2,10,17
251240,"2018",6,3,6,15
251240,"2019",10,1,13,24
251240,"2021",1,1,2,4
251240,"2022",2,1,1,4
251240,"2023",0,1,1,2
251250,"2015",13,5,33,51
251250,"2016",13,10,29,52
251250,"2017",21,2,25,48
251250,"2018",17,6,25,48
251250,"2019",21,6,26,53
251250,"2020",7,1,6,14
251250,"2021",6,2,9,17
251250,"2022",8,4,17,29
251250,"2023",7,2,9,18
251260,"2015",1,1,1,3
251260,"2016",1,0,1,2
251260,"2017",0,0,2,2
251260,"2019",1,0,0,1
251260,"2020",0,2,4,6
251260,"2021",1,0,0,1
251260,"2023",1,0,1,2
251270,"2015",8,3,7,18
251270,"2016",4,1,10,15
251270,"2017",9,7,8,24
251270,"2018",11,1,9,21
251270,"2019",4,3,12,19
251270,"2020",3,0,2,5
251270,"2021",0,0,6,6
251270,"2022",1,0,4,5
251270,"2023",0,0,1,1
251272,"2015",0,0,1,1
251272,"2016",0,0,1,1
251272,"2017",2,0,3,5
251272,"2018",0,0,4,4
251272,"2019",0,1,1,2
251272,"2020",1,0,3,4
251272,"2021",0,1,3,4
251272,"2022",2,1,4,7
251272,"2023",0,0,1,1
251274,"2015",1,0,0,1
251274,"2018",2,0,3,5
251274,"2019",1,0,3,4
251274,"2020",0,0,4,4
251274,"2022",1,0,0,1
251274,"2023",0,0,2,2
251275,"2015",2,0,5,7
251275,"2016",0,0,4,4
251275,"2017",3,0,1,4
251275,"2018",1,1,5,7
251275,"2019",2,0,0,2
251275,"2020",0,0,1,1
251275,"2021",2,0,1,3
251275,"2022",1,0,4,5
251276,"2016",2,0,3,5
251276,"2017",1,1,6,8
251276,"2018",3,1,2,6
251276,"2019",2,0,3,5
251276,"2020",1,0,3,4
251276,"2021",2,0,2,4
251276,"2022",0,0,1,1
251276,"2023",1,0,0,1
251278,"2015",0,0,1,1
251278,"2016",0,1,5,6
251278,"2017",2,0,0,2
251278,"2018",1,0,2,3
251278,"2019",0,0,3,3
251278,"2022",1,0,1,2
251280,"2016",1,1,2,4
251280,"2017",8,2,9,19
251280,"2018",4,1,6,11
251280,"2019",3,1,4,8
251280,"2020",5,0,2,7
251280,"2021",2,1,3,6
251280,"2022",4,2,3,9
251280,"2023",1,0,2,3
251290,"2015",4,0,8,12
251290,"2016",4,0,6,10
251290,"2017",1,3,9,13
251290,"2018",9,2,20,31
251290,"2019",3,1,6,10
251290,"2020",3,2,10,15
251290,"2021",5,1,10,16
251290,"2022",4,4,13,21
251290,"2023",0,3,3,6
251300,"2015",0,1,2,3
251300,"2016",1,1,1,3
251300,"2017",1,0,0,1
251300,"2018",1,1,1,3
251300,"2019",0,0,1,1
251300,"2020",0,1,2,3
251300,"2021",0,0,1,1
251310,"2015",2,0,2,4
251310,"2016",0,0,2,2
251310,"2018",0,0,2,2
251310,"2019",0,0,1,1
251310,"2020",0,0,2,2
251310,"2021",1,0,1,2
251310,"2022",1,0,0,1
251310,"2023",0,0,1,1
251315,"2015",3,0,4,7
251315,"2016",1,1,5,7
251315,"2017",2,0,7,9
251315,"2018",1,1,7,9
251315,"2019",1,3,6,10
251315,"2020",1,0,2,3
251315,"2021",2,1,2,5
251315,"2022",2,0,5,7
251315,"2023",2,0,2,4
251320,"2015",1,0,2,3
251320,"2018",1,0,0,1
251320,"2019",1,0,0,1
251330,"2016",0,0,1,1
251330,"2017",2,1,1,4
251330,"2018",2,2,2,6
251330,"2019",0,0,2,2
251330,"2020",2,0,0,2
251330,"2021",0,0,1,1
251330,"2022",2,1,2,5
251330,"2023",0,1,0,1
251335,"2015",0,0,2,2
251335,"2016",1,0,0,1
251335,"2017",0,1,1,2
251335,"2019",1,0,1,2
251335,"2020",1,0,2,3
251335,"2021",1,0,0,1
251335,"2022",0,1,1,2
251335,"2023",0,0,2,2
251340,"2015",5,1,7,13
251340,"2016",3,0,7,10
251340,"2017",3,1,8,12
251340,"2018",1,1,2,4
251340,"2019",3,0,6,9
251340,"2020",2,3,6,11
251340,"2021",2,1,5,8
251340,"2022",3,2,5,10
251340,"2023",0,1,1,2
251350,"2015",0,0,5,5
251350,"2016",1,0,1,2
251350,"2017",2,0,4,6
251350,"2018",1,0,4,5
251350,"2019",0,0,4,4
251350,"2020",0,2,5,7
251350,"2021",1,0,2,3
251350,"2022",1,0,0,1
251350,"2023",1,0,3,4
251360,"2015",0,0,2,2
251360,"2016",0,0,1,1
251360,"2017",1,0,3,4
251360,"2018",0,0,1,1
251360,"2019",3,0,5,8
251360,"2020",2,0,3,5
251360,"2021",0,0,5,5
251360,"2022",1,0,2,3
251360,"2023",1,0,1,2
251365,"2017",1,0,1,2
251365,"2018",0,0,1,1
251365,"2019",0,0,2,2
251365,"2020",0,1,0,1
251365,"2021",0,1,0,1
251365,"2022",2,0,0,2
251365,"2023",1,0,1,2
251370,"2015",41,7,119,167
251370,"2016",47,11,96,154
251370,"2017",52,8,124,184
251370,"2018",67,19,134,220
251370,"2019",50,10,124,184
251370,"2020",59,13,92,164
251370,"2021",54,22,100,176
251370,"2022",54,10,90,154
251370,"2023",37,15,74,126
251380,"2015",1,0,1,2
251380,"2016",3,0,1,4
251380,"2017",1,1,2,4
251380,"2018",1,0,1,2
251380,"2019",5,2,0,7
251380,"2020",4,0,0,4
251380,"2021",1,0,0,1
251380,"2023",1,1,1,3
251385,"2015",0,0,3,3
251385,"2016",1,0,0,1
251385,"2017",0,2,0,2
251385,"2018",4,0,0,4
251385,"2019",1,0,1,2
251385,"2021",0,0,2,2
251385,"2023",1,0,0,1
251390,"2015",1,0,2,3
251390,"2016",7,1,10,18
251390,"2017",10,4,17,31
251390,"2018",7,2,14,23
251390,"2019",9,4,13,26
251390,"2020",10,4,14,28
251390,"2021",6,0,9,15
251390,"2022",3,2,7,12
251390,"2023",1,2,15,18
251392,"2015",1,0,3,4
251392,"2016",1,0,0,1
251392,"2017",2,1,2,5
251392,"2018",1,0,2,3
251392,"2019",2,2,3,7
251392,"2020",5,0,1,6
251392,"2021",1,0,2,3
251392,"2022",1,0,1,2
251392,"2023",1,0,1,2
251394,"2015",1,0,1,2
251394,"2016",0,1,0,1
251394,"2017",3,0,0,3
251394,"2018",2,1,2,5
251394,"2019",0,1,0,1
251394,"2020",0,1,2,3
251396,"2015",0,0,2,2
251396,"2016",1,0,1,2
251396,"2017",0,1,0,1
251396,"2018",0,1,1,2
251396,"2022",0,0,1,1
251398,"2017",0,0,1,1
251398,"2023",1,0,0,1
251400,"2015",0,1,1,2
251400,"2016",1,1,1,3
251400,"2017",1,0,4,5
251400,"2018",2,2,4,8
251400,"2019",4,0,5,9
251400,"2021",1,0,0,1
251400,"2022",0,0,2,2
251410,"2015",0,0,2,2
251410,"2016",1,0,0,1
251410,"2017",0,0,3,3
251410,"2018",1,1,1,3
251410,"2019",0,1,3,4
251410,"2020",2,0,0,2
251410,"2021",0,0,1,1
251410,"2022",1,0,0,1
251410,"2023",1,0,0,1
251420,"2016",1,0,1,2
251420,"2017",1,0,0,1
251420,"2018",2,0,0,2
251430,"2015",2,0,2,4
251430,"2016",0,0,3,3
251430,"2017",5,0,3,8
251430,"2018",0,0,9,9
251430,"2019",5,0,5,10
251430,"2020",1,1,2,4
251430,"2021",4,0,5,9
251430,"2022",1,1,3,5
251430,"2023",1,0,2,3
251440,"2015",0,0,2,2
251440,"2016",1,0,3,4
251440,"2017",1,0,6,7
251440,"2018",0,0,2,2
251440,"2019",1,0,1,2
251440,"2020",3,1,2,6
251440,"2021",1,0,2,3
251440,"2022",1,0,0,1
251445,"2015",5,0,3,8
251445,"2016",0,0,1,1
251445,"2017",0,0,1,1
251445,"2021",0,0,1,1
251450,"2015",0,0,2,2
251450,"2016",3,1,6,10
251450,"2017",3,1,8,12
251450,"2018",8,0,11,19
251450,"2019",6,1,8,15
251450,"2020",4,0,12,16
251450,"2021",9,0,8,17
251450,"2022",4,2,5,11
251450,"2023",8,0,9,17
251455,"2015",1,0,2,3
251455,"2016",1,0,2,3
251455,"2017",1,0,0,1
251455,"2018",0,0,1,1
251455,"2020",2,0,0,2
251455,"2021",1,0,0,1
251455,"2022",0,0,1,1
251460,"2015",1,0,2,3
251460,"2016",1,0,1,2
251460,"2017",3,0,5,8
251460,"2018",2,0,0,2
251460,"2019",0,0,1,1
251460,"2020",1,0,3,4
251460,"2021",1,0,1,2
251460,"2022",2,0,3,5
251460,"2023",0,1,0,1
251465,"2016",0,0,1,1
251465,"2017",1,0,1,2
251465,"2018",0,0,1,1
251465,"2019",1,1,0,2
251465,"2020",2,1,0,3
251465,"2021",1,0,0,1
251465,"2022",0,0,2,2
251465,"2023",1,0,0,1
251470,"2015",4,0,3,7
251470,"2016",1,0,4,5
251470,"2017",0,0,2,2
251470,"2018",0,2,0,2
251470,"2019",2,0,0,2
251470,"2020",3,0,0,3
251470,"2021",1,1,1,3
251470,"2023",1,0,0,1
251480,"2015",0,0,1,1
251480,"2016",2,1,2,5
251480,"2017",0,0,1,1
251480,"2018",2,0,1,3
251480,"2019",2,0,1,3
251480,"2020",0,1,3,4
251480,"2021",0,1,0,1
251480,"2022",2,0,1,3
251490,"2015",2,2,4,8
251490,"2016",1,2,5,8
251490,"2017",2,0,4,6
251490,"2018",1,0,4,5
251490,"2019",2,0,1,3
251490,"2020",1,1,4,6
251490,"2021",3,0,3,6
251490,"2022",1,0,2,3
251500,"2015",1,0,6,7
251500,"2016",1,0,3,4
251500,"2017",1,0,4,5
251500,"2018",0,0,3,3
251500,"2019",2,1,0,3
251500,"2020",0,0,3,3
251500,"2021",3,0,1,4
251500,"2022",1,0,1,2
251500,"2023",2,0,3,5
251510,"2015",4,1,1,6
251510,"2016",4,2,13,19
251510,"2017",8,0,3,11
251510,"2018",2,1,8,11
251510,"2019",6,1,8,15
251510,"2020",1,0,2,3
251510,"2021",1,0,1,2
251510,"2022",1,0,4,5
251520,"2015",1,0,3,4
251520,"2016",1,0,0,1
251520,"2017",1,0,2,3
251520,"2018",1,0,0,1
251520,"2019",1,0,1,2
251520,"2020",1,0,0,1
251520,"2021",0,2,3,5
251520,"2022",1,1,4,6
251520,"2023",2,1,0,3
251530,"2015",9,1,23,33
251530,"2016",8,3,21,32
251530,"2017",11,2,20,33
251530,"2018",10,0,17,27
251530,"2019",10,2,27,39
251530,"2020",10,4,23,37
251530,"2021",12,0,18,30
251530,"2022",6,2,14,22
251530,"2023",5,1,14,20
251540,"2015",6,1,6,13
251540,"2016",3,2,8,13
251540,"2017",4,0,10,14
251540,"2018",2,0,7,9
251540,"2019",6,1,9,16
251540,"2020",2,0,1,3
251540,"2021",3,1,3,7
251540,"2022",3,0,2,5
251540,"2023",2,1,2,5
251550,"2015",4,3,8,15
251550,"2016",5,1,6,12
251550,"2017",3,2,2,7
251550,"2018",3,1,6,10
251550,"2019",4,1,8,13
251550,"2020",1,0,8,9
251550,"2021",2,0,2,4
251550,"2022",1,0,2,3
251550,"2023",1,0,3,4
251560,"2015",0,0,2,2
251560,"2016",0,0,1,1
251560,"2017",0,0,2,2
251560,"2018",0,1,0,1
251560,"2019",0,1,0,1
251560,"2020",2,1,0,3
251560,"2021",0,1,0,1
251560,"2022",0,0,2,2
251570,"2016",0,0,1,1
251570,"2017",2,1,4,7
251570,"2019",1,0,2,3
251570,"2020",1,0,1,2
251570,"2021",1,0,3,4
251570,"2022",0,1,2,3
251570,"2023",0,1,1,2
251580,"2015",3,1,3,7
251580,"2016",3,0,2,5
251580,"2017",4,0,4,8
251580,"2018",1,0,2,3
251580,"2019",4,1,6,11
251580,"2020",2,0,2,4
251580,"2021",1,0,1,2
251580,"2022",1,1,1,3
251590,"2015",2,2,7,11
251590,"2016",2,0,5,7
251590,"2017",0,1,2,3
251590,"2018",0,0,2,2
251590,"2019",2,0,2,4
251590,"2020",1,0,0,1
251590,"2021",0,0,1,1
251590,"2022",2,0,0,2
251593,"2015",3,1,4,8
251593,"2016",3,1,1,5
251593,"2017",5,0,6,11
251593,"2018",3,2,1,6
251593,"2019",3,1,3,7
251593,"2020",3,2,2,7
251593,"2021",1,0,0,1
251593,"2022",2,2,0,4
251593,"2023",1,1,1,3
251597,"2015",4,0,4,8
251597,"2016",3,0,1,4
251597,"2017",7,1,3,11
251597,"2018",5,1,3,9
251597,"2019",6,0,4,10
251597,"2020",4,3,3,10
251597,"2021",1,2,9,12
251597,"2022",3,0,2,5
251597,"2023",0,0,3,3
251600,"2015",9,0,10,19
251600,"2016",8,2,15,25
251600,"2017",11,1,22,34
251600,"2018",8,1,9,18
251600,"2019",7,7,18,32
251600,"2020",14,2,5,21
251600,"2021",7,3,8,18
251600,"2022",7,2,15,24
251600,"2023",5,2,5,12
251610,"2015",5,2,9,16
251610,"2016",2,1,9,12
251610,"2017",5,1,5,11
251610,"2018",3,0,6,9
251610,"2019",9,1,7,17
251610,"2020",5,0,3,8
251610,"2021",1,0,3,4
251610,"2022",4,0,1,5
251610,"2023",1,0,1,2
251615,"2015",1,0,3,4
251615,"2016",1,1,2,4
251615,"2017",2,0,3,5
251615,"2018",0,1,1,2
251615,"2019",0,0,1,1
251615,"2020",0,0,1,1
251615,"2021",1,0,3,4
251615,"2022",2,0,0,2
251615,"2023",1,0,1,2
251620,"2015",1,0,4,5
251620,"2016",1,0,4,5
251620,"2017",3,0,7,10
251620,"2018",0,0,4,4
251620,"2019",0,1,1,2
251620,"2020",1,0,0,1
251620,"2021",0,0,1,1
251620,"2023",1,0,1,2
251630,"2015",7,0,6,13
251630,"2016",1,1,9,11
251630,"2017",3,0,6,9
251630,"2018",6,2,7,15
251630,"2019",3,3,13,19
251630,"2020",8,1,6,15
251630,"2021",10,2,15,27
251630,"2022",7,4,9,20
251630,"2023",1,1,2,4
251640,"2015",3,1,3,7
251640,"2016",0,0,5,5
251640,"2017",5,1,4,10
251640,"2018",3,0,5,8
251640,"2019",5,0,5,10
251640,"2020",2,0,3,5
251640,"2021",1,1,2,4
251640,"2022",3,0,2,5
251640,"2023",1,0,5,6
251650,"2015",6,0,7,13
251650,"2016",2,0,5,7
251650,"2017",10,1,11,22
251650,"2018",5,2,6,13
251650,"2019",8,1,6,15
251650,"2020",5,0,1,6
251650,"2021",2,2,0,4
251650,"2022",0,0,2,2
251650,"2023",1,0,0,1
251660,"2015",1,1,1,3
251660,"2016",2,1,10,13
251660,"2017",3,2,6,11
251660,"2018",2,1,1,4
251660,"2019",4,0,3,7
251660,"2020",3,1,8,12
251660,"2021",3,1,6,10
251660,"2022",3,2,4,9
251660,"2023",0,2,1,3
251670,"2015",8,3,13,24
251670,"2016",7,1,7,15
251670,"2017",6,0,9,15
251670,"2018",1,1,2,4
251670,"2019",5,2,13,20
251670,"2020",7,2,6,15
251670,"2021",7,0,5,12
251670,"2022",2,3,6,11
251670,"2023",4,1,2,7
251675,"2015",2,0,1,3
251675,"2016",1,0,2,3
251675,"2017",1,0,1,2
251675,"2018",0,0,4,4
251675,"2019",1,1,1,3
251675,"2020",2,0,1,3
251675,"2021",0,0,1,1
251675,"2022",1,0,1,2
251675,"2023",1,0,1,2
251680,"2015",0,1,0,1
251680,"2016",0,0,1,1
251680,"2017",2,1,2,5
251680,"2018",2,1,3,6
251680,"2019",1,1,3,5
251680,"2020",3,1,4,8
251680,"2021",1,0,3,4
251680,"2022",4,2,1,7
251680,"2023",2,1,2,5
251690,"2016",1,1,2,4
251690,"2017",1,0,4,5
251690,"2018",6,1,2,9
251690,"2019",1,1,3,5
251690,"2020",2,0,2,4
251690,"2021",4,2,6,12
251690,"2022",4,0,7,11
251690,"2023",3,0,5,8
251700,"2015",1,1,9,11
251700,"2016",1,0,4,5
251700,"2017",4,2,3,9
251700,"2018",2,0,5,7
251700,"2019",2,2,1,5
251700,"2020",0,1,4,5
251700,"2021",3,1,0,4
251700,"2022",1,0,1,2
251700,"2023",1,0,1,2
251710,"2015",0,0,1,1
251710,"2016",0,0,4,4
251710,"2017",0,0,1,1
251710,"2018",1,1,0,2
251710,"2019",2,1,2,5
251710,"2020",2,0,3,5
251710,"2021",0,1,2,3
251710,"2022",1,1,1,3
251740,"2017",0,0,1,1
251740,"2019",2,0,0,2
251740,"2020",0,0,2,2
251740,"2021",0,0,1,1
251740,"2022",1,2,2,5
251740,"2023",4,1,0,5
260005,"2015",15,5,38,58
260005,"2016",14,6,44,64
260005,"2017",21,11,37,69
260005,"2018",12,3,33,48
260005,"2019",8,2,24,34
260005,"2020",9,1,22,32
260005,"2021",18,4,28,50
260005,"2022",16,4,23,43
260005,"2023",9,5,24,38
260010,"2015",24,2,47,73
260010,"2016",13,8,55,76
260010,"2017",20,4,45,69
260010,"2018",24,4,38,66
260010,"2019",28,9,39,76
260010,"2020",28,8,51,87
260010,"2021",28,10,41,79
260010,"2022",19,8,49,76
260010,"2023",18,7,25,50
260020,"2015",2,0,12,14
260020,"2016",1,0,10,11
260020,"2017",4,0,4,8
260020,"2018",0,1,9,10
260020,"2019",4,3,7,14
260020,"2020",1,1,9,11
260020,"2021",5,1,6,12
260020,"2022",2,1,5,8
260020,"2023",2,1,5,8
260030,"2015",2,0,5,7
260030,"2016",0,0,4,4
260030,"2017",1,1,3,5
260030,"2018",3,0,8,11
260030,"2019",1,1,7,9
260030,"2020",4,3,8,15
260030,"2021",4,0,6,10
260030,"2022",2,1,3,6
260030,"2023",2,0,5,7
260040,"2015",7,0,21,28
260040,"2016",11,1,20,32
260040,"2017",7,2,18,27
260040,"2018",11,1,20,32
260040,"2019",7,0,18,25
260040,"2020",6,0,16,22
260040,"2021",6,1,14,21
260040,"2022",5,2,7,14
260040,"2023",7,0,6,13
260050,"2015",12,1,24,37
260050,"2016",8,3,14,25
260050,"2017",9,2,26,37
260050,"2018",17,3,17,37
260050,"2019",15,1,20,36
260050,"2020",14,3,23,40
260050,"2021",17,2,26,45
260050,"2022",11,3,21,35
260050,"2023",14,4,26,44
260060,"2015",2,1,7,10
260060,"2016",1,0,4,5
260060,"2017",1,1,6,8
260060,"2018",3,2,10,15
260060,"2019",4,1,3,8
260060,"2020",2,1,9,12
260060,"2021",6,1,10,17
260060,"2022",3,1,7,11
260060,"2023",2,0,2,4
260070,"2015",2,1,11,14
260070,"2016",3,0,9,12
260070,"2017",2,1,8,11
260070,"2018",5,0,6,11
260070,"2019",3,0,6,9
260070,"2020",2,0,5,7
260070,"2021",1,0,6,7
260070,"2022",1,1,2,4
260070,"2023",3,0,6,9
260080,"2015",2,1,3,6
260080,"2016",1,2,5,8
260080,"2017",2,0,6,8
260080,"2018",2,2,7,11
260080,"2019",3,1,8,12
260080,"2020",5,0,3,8
260080,"2021",2,0,4,6
260080,"2022",1,1,3,5
260080,"2023",3,2,3,8
260090,"2015",5,1,9,15
260090,"2016",1,0,10,11
260090,"2017",4,0,8,12
260090,"2018",4,1,7,12
260090,"2019",2,0,9,11
260090,"2020",4,1,12,17
260090,"2021",2,0,4,6
260090,"2022",4,0,5,9
260090,"2023",5,2,5,12
260100,"2015",5,0,12,17
260100,"2016",2,1,8,11
260100,"2017",4,1,9,14
260100,"2018",3,2,10,15
260100,"2019",3,2,5,10
260100,"2020",4,0,5,9
260100,"2021",3,2,5,10
260100,"2022",1,1,3,5
260100,"2023",3,1,6,10
260105,"2015",2,1,5,8
260105,"2016",2,0,2,4
260105,"2017",0,0,9,9
260105,"2018",1,0,7,8
260105,"2019",1,0,5,6
260105,"2020",2,1,5,8
260105,"2021",1,1,2,4
260105,"2022",1,0,5,6
260105,"2023",0,0,1,1
260110,"2015",34,7,86,127
260110,"2016",27,10,64,101
260110,"2017",42,6,78,126
260110,"2018",41,9,88,138
260110,"2019",32,7,75,114
260110,"2020",29,3,47,79
260110,"2021",42,6,64,112
260110,"2022",32,14,58,104
260110,"2023",38,13,65,116
260120,"2015",32,2,59,93
260120,"2016",24,6,53,83
260120,"2017",34,5,50,89
260120,"2018",39,8,74,121
260120,"2019",30,12,48,90
260120,"2020",34,5,40,79
260120,"2021",25,11,50,86
260120,"2022",24,6,50,80
260120,"2023",22,4,46,72
260130,"2015",1,0,4,5
260130,"2016",1,0,5,6
260130,"2017",1,0,5,6
260130,"2018",4,0,5,9
260130,"2019",1,1,5,7
260130,"2020",3,0,3,6
260130,"2021",0,0,2,2
260130,"2022",1,0,1,2
260130,"2023",0,1,2,3
260140,"2015",11,0,33,44
260140,"2016",11,2,29,42
260140,"2017",12,2,24,38
260140,"2018",10,3,36,49
260140,"2019",12,3,21,36
260140,"2020",9,5,30,44
260140,"2021",2,4,14,20
260140,"2022",5,1,12,18
260140,"2023",4,0,16,20
260150,"2015",2,0,4,6
260150,"2016",1,0,2,3
260150,"2017",4,0,6,10
260150,"2018",1,0,7,8
260150,"2019",2,0,5,7
260150,"2020",1,0,2,3
260150,"2021",2,0,1,3
260150,"2022",0,0,1,1
260150,"2023",2,0,2,4
260160,"2015",9,2,19,30
260160,"2016",5,0,12,17
260160,"2017",8,0,21,29
260160,"2018",4,1,18,23
260160,"2019",5,2,12,19
260160,"2020",4,2,7,13
260160,"2021",8,0,10,18
260160,"2022",4,1,6,11
260160,"2023",7,4,9,20
260170,"2015",11,0,18,29
260170,"2016",26,7,46,79
260170,"2017",14,1,28,43
260170,"2018",25,10,32,67
260170,"2019",19,1,30,50
260170,"2020",11,1,22,34
260170,"2021",10,2,18,30
260170,"2022",5,2,15,22
260170,"2023",5,4,21,30
260180,"2015",3,1,2,6
260180,"2016",1,0,7,8
260180,"2017",3,0,5,8
260180,"2018",1,0,6,7
260180,"2019",5,1,8,14
260180,"2020",6,1,3,10
260180,"2021",4,1,5,10
260180,"2022",4,0,5,9
260180,"2023",2,0,5,7
260190,"2015",5,2,9,16
260190,"2016",2,1,11,14
260190,"2017",3,0,7,10
260190,"2018",10,5,12,27
260190,"2019",5,4,16,25
260190,"2020",2,1,13,16
260190,"2021",6,1,15,22
260190,"2022",4,3,6,13
260190,"2023",4,0,5,9
260200,"2015",14,4,25,43
260200,"2016",14,5,21,40
260200,"2017",15,3,24,42
260200,"2018",12,8,27,47
260200,"2019",18,8,26,52
260200,"2020",15,6,22,43
260200,"2021",13,0,22,35
260200,"2022",8,2,24,34
260200,"2023",11,2,20,33
260210,"2015",5,4,20,29
260210,"2016",7,5,26,38
260210,"2017",14,4,28,46
260210,"2018",13,4,27,44
260210,"2019",12,3,18,33
260210,"2020",14,2,16,32
260210,"2021",12,4,16,32
260210,"2022",8,4,18,30
260210,"2023",11,1,12,24
260220,"2015",4,1,24,29
260220,"2016",9,0,9,18
260220,"2017",4,1,15,20
260220,"2018",7,2,6,15
260220,"2019",12,2,8,22
260220,"2020",7,2,16,25
260220,"2021",11,0,10,21
260220,"2022",4,1,5,10
260220,"2023",4,1,7,12
260230,"2015",7,3,21,31
260230,"2016",11,3,10,24
260230,"2017",8,1,8,17
260230,"2018",10,0,9,19
260230,"2019",6,1,13,20
260230,"2020",9,1,14,24
260230,"2021",4,2,15,21
260230,"2022",4,2,9,15
260230,"2023",5,1,8,14
260240,"2015",4,1,10,15
260240,"2016",4,1,11,16
260240,"2017",3,0,9,12
260240,"2018",4,1,7,12
260240,"2019",6,0,7,13
260240,"2020",8,0,8,16
260240,"2021",6,3,9,18
260240,"2022",3,0,6,9
260240,"2023",3,0,7,10
260250,"2015",1,0,2,3
260250,"2016",3,0,3,6
260250,"2017",3,0,5,8
260250,"2018",1,0,3,4
260250,"2019",4,2,4,10
260250,"2020",5,0,5,10
260250,"2021",1,0,8,9
260250,"2022",3,1,5,9
260250,"2023",1,2,5,8
260260,"2015",9,0,12,21
260260,"2016",4,1,13,18
260260,"2017",3,0,14,17
260260,"2018",9,3,17,29
260260,"2019",4,1,19,24
260260,"2020",9,2,17,28
260260,"2021",5,0,10,15
260260,"2022",4,1,6,11
260260,"2023",4,2,14,20
260270,"2015",1,0,2,3
260270,"2016",0,0,1,1
260270,"2017",2,1,1,4
260270,"2018",2,0,1,3
260270,"2019",0,0,2,2
260270,"2020",1,0,0,1
260270,"2022",1,0,3,4
260270,"2023",1,0,1,2
260280,"2015",23,2,28,53
260280,"2016",12,3,33,48
260280,"2017",15,1,22,38
260280,"2018",15,2,36,53
260280,"2019",21,8,26,55
260280,"2020",18,4,38,60
260280,"2021",19,5,38,62
260280,"2022",17,4,36,57
260280,"2023",13,2,14,29
260290,"2015",72,15,145,232
260290,"2016",43,9,147,199
260290,"2017",61,7,148,216
260290,"2018",39,8,133,180
260290,"2019",47,21,95,163
260290,"2020",42,11,103,156
260290,"2021",33,12,98,143
260290,"2022",47,10,94,151
260290,"2023",37,8,53,98
260300,"2015",13,3,29,45
260300,"2016",6,2,35,43
260300,"2017",9,3,22,34
260300,"2018",10,1,19,30
260300,"2019",8,1,11,20
260300,"2020",5,1,14,20
260300,"2021",5,1,15,21
260300,"2022",7,1,15,23
260300,"2023",4,0,5,9
260310,"2015",5,0,7,12
260310,"2016",1,1,1,3
260310,"2017",3,1,10,14
260310,"2018",4,3,7,14
260310,"2019",4,0,8,12
260310,"2020",4,0,3,7
260310,"2021",3,0,4,7
260310,"2022",4,0,6,10
260310,"2023",2,1,7,10
260320,"2015",15,4,15,34
260320,"2016",18,1,14,33
260320,"2017",12,4,19,35
260320,"2018",14,4,12,30
260320,"2019",10,5,15,30
260320,"2020",13,6,17,36
260320,"2021",12,6,11,29
260320,"2022",15,6,10,31
260320,"2023",7,2,12,21
260330,"2015",3,3,8,14
260330,"2016",3,2,1,6
260330,"2017",6,1,1,8
260330,"2018",6,1,5,12
260330,"2019",5,0,8,13
260330,"2020",1,2,7,10
260330,"2021",4,0,7,11
260330,"2022",5,1,3,9
260330,"2023",2,0,2,4
260340,"2015",1,1,1,3
260340,"2016",0,2,3,5
260340,"2017",1,0,0,1
260340,"2018",1,1,1,3
260340,"2019",2,1,6,9
260340,"2020",0,0,3,3
260340,"2021",2,1,5,8
260340,"2022",2,1,3,6
260340,"2023",0,0,1,1
260345,"2015",39,12,74,125
260345,"2016",19,1,34,54
260345,"2017",27,6,70,103
260345,"2018",48,9,75,132
260345,"2019",34,2,51,87
260345,"2020",20,6,44,70
260345,"2021",26,7,32,65
260345,"2022",22,6,37,65
260345,"2023",13,4,20,37
260350,"2015",2,2,5,9
260350,"2016",1,0,7,8
260350,"2017",1,0,4,5
260350,"2018",1,1,4,6
260350,"2019",4,0,8,12
260350,"2020",1,0,5,6
260350,"2021",2,0,5,7
260350,"2022",4,0,3,7
260350,"2023",0,0,4,4
260360,"2015",0,0,3,3
260360,"2016",2,1,0,3
260360,"2019",1,0,3,4
260360,"2020",1,1,1,3
260360,"2022",1,0,0,1
260370,"2015",9,1,16,26
260370,"2016",7,1,13,21
260370,"2017",7,3,18,28
260370,"2018",5,1,19,25
260370,"2019",7,2,11,20
260370,"2020",6,0,13,19
260370,"2021",9,2,14,25
260370,"2022",10,2,21,33
260370,"2023",6,2,12,20
260380,"2015",8,4,10,22
260380,"2016",5,1,17,23
260380,"2017",5,2,17,24
260380,"2018",6,0,13,19
260380,"2019",11,4,5,20
260380,"2020",7,3,13,23
260380,"2021",6,0,8,14
260380,"2022",7,4,11,22
260380,"2023",5,2,8,15
260390,"2015",6,1,20,27
260390,"2016",7,3,14,24
260390,"2017",8,2,15,25
260390,"2018",10,3,13,26
260390,"2019",11,2,15,28
260390,"2020",11,4,22,37
260390,"2021",10,2,25,37
260390,"2022",15,3,13,31
260390,"2023",7,2,6,15
260392,"2015",5,2,14,21
260392,"2016",4,0,9,13
260392,"2017",3,1,11,15
260392,"2018",5,0,9,14
260392,"2019",4,1,7,12
260392,"2020",3,1,7,11
260392,"2021",3,1,14,18
260392,"2022",3,0,11,14
260392,"2023",1,0,4,5
260400,"2015",7,2,20,29
260400,"2016",2,3,9,14
260400,"2017",8,2,15,25
260400,"2018",12,4,11,27
260400,"2019",11,1,11,23
260400,"2020",3,3,10,16
260400,"2021",8,2,11,21
260400,"2022",2,1,8,11
260400,"2023",3,1,10,14
260410,"2015",105,28,305,438
260410,"2016",119,15,264,398
260410,"2017",140,33,259,432
260410,"2018",133,40,311,484
260410,"2019",158,47,277,482
260410,"2020",155,38,285,478
260410,"2021",182,39,274,495
260410,"2022",156,39,258,453
260410,"2023",129,31,197,357
260415,"2015",1,1,5,7
260415,"2016",1,0,7,8
260415,"2017",2,2,5,9
260415,"2018",1,0,5,6
260415,"2019",7,0,11,18
260415,"2020",0,0,3,3
260415,"2021",3,0,1,4
260415,"2022",2,0,1,3
260415,"2023",3,0,2,5
260420,"2015",4,1,24,29
260420,"2016",6,0,18,24
260420,"2017",8,2,31,41
260420,"2018",14,1,20,35
260420,"2019",9,2,22,33
260420,"2020",7,0,21,28
260420,"2021",5,2,18,25
260420,"2022",10,1,14,25
260420,"2023",10,1,10,21
260430,"2015",3,1,10,14
260430,"2016",5,1,14,20
260430,"2017",8,2,5,15
260430,"2018",5,0,7,12
260430,"2019",6,0,9,15
260430,"2020",1,0,8,9
260430,"2021",1,0,1,2
260430,"2022",4,0,4,8
260430,"2023",2,0,4,6
260440,"2015",3,2,8,13
260440,"2016",5,0,9,14
260440,"2017",3,1,4,8
260440,"2018",3,0,4,7
260440,"2019",5,0,9,14
260440,"2020",3,0,4,7
260440,"2021",4,0,6,10
260440,"2022",1,1,1,3
260440,"2023",3,1,3,7
260450,"2015",5,0,8,13
260450,"2016",4,0,12,16
260450,"2017",8,1,4,13
260450,"2018",2,1,4,7
260450,"2019",1,0,5,6
260450,"2020",5,0,13,18
260450,"2021",4,1,10,15
260450,"2022",2,0,7,9
260450,"2023",1,1,4,6
260460,"2015",4,0,17,21
260460,"2016",6,0,12,18
260460,"2017",1,1,8,10
260460,"2018",2,1,12,15
260460,"2019",4,1,5,10
260460,"2020",3,0,8,11
260460,"2021",4,0,6,10
260460,"2022",6,4,4,14
260460,"2023",2,1,4,7
260470,"2015",1,3,13,17
260470,"2016",3,1,16,20
260470,"2017",10,0,11,21
260470,"2018",6,1,11,18
260470,"2019",9,4,12,25
260470,"2020",7,1,8,16
260470,"2021",2,2,15,19
260470,"2022",6,1,9,16
260470,"2023",3,0,2,5
260480,"2015",2,0,2,4
260480,"2016",2,0,9,11
260480,"2017",1,0,7,8
260480,"2018",6,0,10,16
260480,"2019",2,0,6,8
260480,"2020",3,0,3,6
260480,"2021",3,0,2,5
260480,"2022",3,0,1,4
260480,"2023",1,0,1,2
260490,"2015",4,0,8,12
260490,"2016",2,0,3,5
260490,"2017",2,0,2,4
260490,"2018",2,1,4,7
260490,"2019",1,0,4,5
260490,"2020",2,0,2,4
260490,"2021",3,0,6,9
260490,"2022",5,0,1,6
260490,"2023",1,1,3,5
260500,"2015",2,0,5,7
260500,"2016",1,0,3,4
260500,"2017",7,3,9,19
260500,"2018",4,2,4,10
260500,"2019",1,0,4,5
260500,"2020",4,1,8,13
260500,"2021",5,0,4,9
260500,"2022",2,0,2,4
260500,"2023",3,0,5,8
260510,"2015",6,0,12,18
260510,"2016",2,0,16,18
260510,"2017",8,0,10,18
260510,"2018",4,1,10,15
260510,"2019",5,1,11,17
260510,"2020",4,0,20,24
260510,"2021",22,2,20,44
260510,"2022",18,4,26,48
260510,"2023",3,3,9,15
260515,"2015",4,2,14,20
260515,"2016",4,0,6,10
260515,"2017",4,0,6,10
260515,"2018",2,0,11,13
260515,"2019",2,2,8,12
260515,"2020",1,1,5,7
260515,"2021",0,0,5,5
260515,"2022",3,0,4,7
260515,"2023",1,0,1,2
260520,"2015",15,2,39,56
260520,"2016",10,0,26,36
260520,"2017",10,3,34,47
260520,"2018",9,0,22,31
260520,"2019",13,0,22,35
260520,"2020",11,0,19,30
260520,"2021",4,0,13,17
260520,"2022",4,1,19,24
260520,"2023",9,2,10,21
260530,"2015",12,4,21,37
260530,"2016",7,2,26,35
260530,"2017",14,3,19,36
260530,"2018",15,4,28,47
260530,"2019",11,3,28,42
260530,"2020",16,2,20,38
260530,"2021",17,2,18,37
260530,"2022",12,6,11,29
260530,"2023",10,2,13,25
260540,"2015",2,0,17,19
260540,"2016",3,0,3,6
260540,"2017",5,2,11,18
260540,"2018",4,3,9,16
260540,"2019",5,2,8,15
260540,"2020",7,0,8,15
260540,"2021",2,0,7,9
260540,"2022",2,0,3,5
260540,"2023",5,1,7,13
260545,"2015",1,0,2,3
260545,"2016",0,0,1,1
260545,"2017",2,0,1,3
260545,"2018",1,0,1,2
260545,"2021",1,0,1,2
260545,"2022",1,0,0,1
260550,"2015",0,3,6,9
260550,"2016",1,0,1,2
260550,"2017",2,0,1,3
260550,"2018",1,1,1,3
260550,"2019",1,0,1,2
260550,"2021",3,0,1,4
260550,"2022",2,0,0,2
260550,"2023",3,0,1,4
260560,"2015",2,0,6,8
260560,"2016",2,0,4,6
260560,"2017",4,0,5,9
260560,"2018",7,1,12,20
260560,"2019",6,2,13,21
260560,"2020",6,0,9,15
260560,"2021",12,3,12,27
260560,"2022",6,3,4,13
260560,"2023",4,3,9,16
260570,"2015",11,3,33,47
260570,"2016",4,1,21,26
260570,"2017",13,1,32,46
260570,"2018",9,2,25,36
260570,"2019",6,3,14,23
260570,"2020",9,4,35,48
260570,"2021",10,5,33,48
260570,"2022",9,1,16,26
260570,"2023",2,0,7,9
260580,"2015",2,1,2,5
260580,"2016",1,0,3,4
260580,"2017",4,1,3,8
260580,"2018",3,0,2,5
260580,"2019",5,0,4,9
260580,"2020",4,0,2,6
260580,"2021",3,0,2,5
260580,"2022",2,1,3,6
260580,"2023",2,0,3,5
260590,"2015",1,2,9,12
260590,"2016",2,0,14,16
260590,"2017",9,4,12,25
260590,"2018",5,0,14,19
260590,"2019",4,3,13,20
260590,"2020",3,0,12,15
260590,"2021",2,1,7,10
260590,"2022",1,2,7,10
260590,"2023",2,0,7,9
260600,"2015",62,12,119,193
260600,"2016",52,13,96,161
260600,"2017",59,10,88,157
260600,"2018",45,17,92,154
260600,"2019",50,15,87,152
260600,"2020",39,10,80,129
260600,"2021",61,8,80,149
260600,"2022",44,19,76,139
260600,"2023",51,13,56,120
260610,"2015",8,2,17,27
260610,"2016",5,1,7,13
260610,"2017",2,0,17,19
260610,"2018",6,2,15,23
260610,"2019",5,5,10,20
260610,"2020",4,4,10,18
260610,"2021",6,0,12,18
260610,"2022",5,2,12,19
260610,"2023",2,1,9,12
260620,"2015",8,6,33,47
260620,"2016",13,3,49,65
260620,"2017",19,5,29,53
260620,"2018",27,7,58,92
260620,"2019",17,8,36,61
260620,"2020",14,5,34,53
260620,"2021",17,5,34,56
260620,"2022",17,4,29,50
260620,"2023",15,3,23,41
260630,"2015",1,0,5,6
260630,"2016",0,1,3,4
260630,"2017",7,1,9,17
260630,"2018",7,1,8,16
260630,"2019",4,1,8,13
260630,"2020",6,2,4,12
260630,"2021",2,2,4,8
260630,"2022",3,1,8,12
260630,"2023",4,0,3,7
260640,"2015",18,2,36,56
260640,"2016",9,2,28,39
260640,"2017",12,1,26,39
260640,"2018",16,5,29,50
260640,"2019",11,6,22,39
260640,"2020",10,6,24,40
260640,"2021",19,3,32,54
260640,"2022",3,6,17,26
260640,"2023",6,3,15,24
260650,"2015",10,0,15,25
260650,"2016",7,0,13,20
260650,"2017",6,2,11,19
260650,"2018",4,4,5,13
260650,"2019",8,2,14,24
260650,"2020",8,4,9,21
260650,"2021",9,2,8,19
260650,"2022",8,1,2,11
260650,"2023",6,3,8,17
260660,"2015",8,1,20,29
260660,"2016",6,1,14,21
260660,"2017",16,3,19,38
260660,"2018",8,6,7,21
260660,"2019",7,1,11,19
260660,"2020",5,2,7,14
260660,"2021",13,2,16,31
260660,"2022",5,3,11,19
260660,"2023",3,0,14,17
260670,"2015",0,0,3,3
260670,"2016",1,0,0,1
260670,"2017",1,0,2,3
260670,"2018",1,0,1,2
260670,"2019",1,0,3,4
260670,"2020",1,0,3,4
260670,"2021",1,0,1,2
260670,"2022",1,0,2,3
260670,"2023",0,0,4,4
260680,"2015",26,7,35,68
260680,"2016",33,6,30,69
260680,"2017",24,5,50,79
260680,"2018",14,6,43,63
260680,"2019",6,1,22,29
260680,"2020",14,0,29,43
260680,"2021",24,6,34,64
260680,"2022",26,5,37,68
260680,"2023",11,2,18,31
260690,"2015",2,2,8,12
260690,"2016",0,1,3,4
260690,"2017",5,1,12,18
260690,"2018",3,0,10,13
260690,"2019",4,2,11,17
260690,"2020",4,0,9,13
260690,"2021",4,2,3,9
260690,"2022",3,2,8,13
260690,"2023",8,2,5,15
260700,"2015",2,1,13,16
260700,"2016",3,0,8,11
260700,"2017",6,2,9,17
260700,"2018",9,2,13,24
260700,"2019",6,0,7,13
260700,"2020",4,1,9,14
260700,"2021",2,0,15,17
260700,"2022",5,2,13,20
260700,"2023",0,2,8,10
260710,"2015",1,0,4,5
260710,"2016",2,0,3,5
260710,"2017",1,2,4,7
260710,"2018",3,1,7,11
260710,"2019",3,1,5,9
260710,"2020",4,0,3,7
260710,"2021",0,0,4,4
260710,"2022",1,0,4,5
260710,"2023",1,1,2,4
260720,"2015",25,4,69,98
260720,"2016",14,0,54,68
260720,"2017",21,2,69,92
260720,"2018",31,9,65,105
260720,"2019",25,10,54,89
260720,"2020",27,5,77,109
260720,"2021",23,4,85,112
260720,"2022",28,9,57,94
260720,"2023",14,3,32,49
260730,"2015",12,6,20,38
260730,"2016",9,2,20,31
260730,"2017",17,5,31,53
260730,"2018",14,3,21,38
260730,"2019",14,2,28,44
260730,"2020",6,1,11,18
260730,"2021",10,2,23,35
260730,"2022",13,6,25,44
260730,"2023",11,3,17,31
260740,"2015",1,0,0,1
260740,"2016",1,0,3,4
260740,"2017",2,0,5,7
260740,"2018",1,0,4,5
260740,"2019",1,0,2,3
260740,"2020",2,0,9,11
260740,"2021",5,0,0,5
260740,"2022",0,0,2,2
260740,"2023",1,0,2,3
260750,"2015",6,4,2,12
260750,"2016",1,4,8,13
260750,"2017",5,2,16,23
260750,"2018",9,2,13,24
260750,"2019",9,2,12,23
260750,"2020",7,4,12,23
260750,"2021",5,4,14,23
260750,"2022",13,3,14,30
260750,"2023",4,2,7,13
260760,"2015",6,1,12,19
260760,"2016",2,0,9,11
260760,"2017",3,0,6,9
260760,"2018",2,2,7,11
260760,"2019",1,1,7,9
260760,"2020",4,0,9,13
260760,"2021",0,1,9,10
260760,"2022",4,2,4,10
260760,"2023",0,0,4,4
260765,"2015",3,1,16,20
260765,"2016",4,0,17,21
260765,"2017",3,1,21,25
260765,"2018",2,0,14,16
260765,"2019",7,3,8,18
260765,"2020",5,0,6,11
260765,"2021",1,2,10,13
260765,"2022",2,2,8,12
260765,"2023",3,0,8,11
260770,"2015",4,2,5,11
260770,"2016",3,0,7,10
260770,"2017",3,3,8,14
260770,"2018",3,3,8,14
260770,"2019",4,1,9,14
260770,"2020",7,0,11,18
260770,"2021",8,1,13,22
260770,"2022",2,2,11,15
260770,"2023",4,2,12,18
260775,"2015",1,2,8,11
260775,"2016",3,0,15,18
260775,"2017",2,1,12,15
260775,"2018",2,0,5,7
260775,"2019",3,0,7,10
260775,"2020",5,0,16,21
260775,"2021",2,2,13,17
260775,"2022",4,0,9,13
260775,"2023",2,0,13,15
260780,"2015",4,0,5,9
260780,"2016",1,0,6,7
260780,"2017",4,0,5,9
260780,"2018",2,0,3,5
260780,"2019",2,1,6,9
260780,"2020",2,1,4,7
260780,"2021",1,0,2,3
260780,"2022",1,1,9,11
260780,"2023",2,0,1,3
260790,"2015",217,34,410,661
260790,"2016",158,27,357,542
260790,"2017",169,41,383,593
260790,"2018",149,33,321,503
260790,"2019",159,44,299,502
260790,"2020",125,23,275,423
260790,"2021",125,26,230,381
260790,"2022",96,26,227,349
260790,"2023",81,28,216,325
260795,"2015",3,0,3,6
260795,"2016",1,0,6,7
260795,"2017",3,0,5,8
260795,"2018",2,0,2,4
260795,"2019",3,0,4,7
260795,"2020",0,0,12,12
260795,"2021",0,0,2,2
260795,"2022",0,1,6,7
260795,"2023",2,0,2,4
260800,"2015",2,0,5,7
260800,"2016",1,1,7,9
260800,"2017",3,3,3,9
260800,"2018",3,0,3,6
260800,"2019",3,1,9,13
260800,"2020",2,0,1,3
260800,"2021",2,1,6,9
260800,"2022",4,0,5,9
260800,"2023",3,0,4,7
260805,"2015",3,0,3,6
260805,"2016",3,1,3,7
260805,"2017",0,1,3,4
260805,"2018",2,0,0,2
260805,"2019",2,0,4,6
260805,"2020",1,1,3,5
260805,"2021",3,0,3,6
260805,"2022",2,0,5,7
260805,"2023",4,1,3,8
260810,"2015",6,2,11,19
260810,"2016",2,2,12,16
260810,"2017",4,2,14,20
260810,"2018",3,1,10,14
260810,"2019",3,3,5,11
260810,"2020",6,0,6,12
260810,"2021",4,0,8,12
260810,"2022",5,1,11,17
260810,"2023",3,0,8,11
260820,"2015",0,0,11,11
260820,"2016",5,1,8,14
260820,"2017",3,1,6,10
260820,"2018",2,1,7,10
260820,"2019",5,1,7,13
260820,"2020",4,2,5,11
260820,"2021",1,3,8,12
260820,"2022",4,2,3,9
260820,"2023",2,0,6,8
260825,"2015",2,2,10,14
260825,"2016",4,0,4,8
260825,"2017",4,0,7,11
260825,"2018",6,0,7,13
260825,"2019",4,1,10,15
260825,"2020",2,0,6,8
260825,"2021",5,0,5,10
260825,"2022",1,0,7,8
260825,"2023",5,2,7,14
260830,"2015",6,4,23,33
260830,"2016",3,0,13,16
260830,"2017",8,2,15,25
260830,"2018",9,1,10,20
260830,"2019",6,2,18,26
260830,"2020",3,2,8,13
260830,"2021",3,1,8,12
260830,"2022",7,3,9,19
260830,"2023",5,1,8,14
260840,"2015",1,1,6,8
260840,"2016",5,1,8,14
260840,"2017",0,0,4,4
260840,"2018",3,0,2,5
260840,"2019",7,1,7,15
260840,"2020",2,0,7,9
260840,"2021",2,3,3,8
260840,"2022",1,1,8,10
260840,"2023",5,0,1,6
260845,"2015",6,0,1,7
260845,"2016",3,0,1,4
260845,"2017",2,0,6,8
260845,"2018",1,1,6,8
260845,"2019",1,2,3,6
260845,"2020",0,0,4,4
260845,"2021",2,2,8,12
260845,"2022",2,0,2,4
260845,"2023",0,0,3,3
260850,"2015",3,0,11,14
260850,"2016",0,1,6,7
260850,"2017",1,1,6,8
260850,"2018",2,0,8,10
260850,"2019",3,1,4,8
260850,"2020",3,2,4,9
260850,"2021",2,0,3,5
260850,"2022",1,0,3,4
260850,"2023",2,1,2,5
260860,"2015",7,1,7,15
260860,"2016",4,0,2,6
260860,"2017",2,0,8,10
260860,"2018",1,1,8,10
260860,"2019",3,1,6,10
260860,"2020",6,1,8,15
260860,"2021",2,1,3,6
260860,"2022",7,3,4,14
260860,"2023",2,1,5,8
260870,"2015",1,0,4,5
260870,"2016",0,0,2,2
260870,"2017",2,0,5,7
260870,"2018",0,1,5,6
260870,"2019",1,1,3,5
260870,"2020",2,2,5,9
260870,"2021",3,3,2,8
260870,"2022",2,2,0,4
260870,"2023",2,0,4,6
260875,"2015",9,1,25,35
260875,"2016",7,1,7,15
260875,"2017",1,1,14,16
260875,"2018",4,1,21,26
260875,"2019",6,3,12,21
260875,"2020",3,3,19,25
260875,"2021",2,0,9,11
260875,"2022",6,0,6,12
260875,"2023",3,0,6,9
260880,"2015",25,5,41,71
260880,"2016",16,2,18,36
260880,"2017",37,2,30,69
260880,"2018",24,4,30,58
260880,"2019",20,1,30,51
260880,"2020",18,10,16,44
260880,"2021",29,7,28,64
260880,"2022",23,7,20,50
260880,"2023",23,2,11,36
260890,"2015",26,4,35,65
260890,"2016",19,7,29,55
260890,"2017",18,1,45,64
260890,"2018",15,6,31,52
260890,"2019",20,4,25,49
260890,"2020",20,2,21,43
260890,"2021",22,8,28,58
260890,"2022",19,4,26,49
260890,"2023",13,2,21,36
260900,"2015",3,0,5,8
260900,"2016",6,0,6,12
260900,"2017",7,0,2,9
260900,"2018",2,1,7,10
260900,"2019",1,0,5,6
260900,"2020",0,0,8,8
260900,"2021",4,0,5,9
260900,"2022",0,1,3,4
260900,"2023",1,0,3,4
260910,"2015",3,0,5,8
260910,"2016",2,1,5,8
260910,"2017",5,2,3,10
260910,"2018",8,1,6,15
260910,"2019",1,0,6,7
260910,"2020",3,0,3,6
260910,"2021",4,0,3,7
260910,"2022",3,0,2,5
260910,"2023",0,1,3,4
260915,"2015",7,4,7,18
260915,"2016",4,2,7,13
260915,"2017",5,0,6,11
260915,"2018",7,1,7,15
260915,"2019",7,2,8,17
260915,"2020",8,3,10,21
260915,"2021",4,3,4,11
260915,"2022",4,1,9,14
260915,"2023",7,1,3,11
260920,"2015",5,1,8,14
260920,"2016",4,0,8,12
260920,"2017",4,2,5,11
260920,"2018",2,1,8,11
260920,"2019",1,2,4,7
260920,"2020",3,1,5,9
260920,"2021",3,0,7,10
260920,"2022",2,0,2,4
260920,"2023",3,1,3,7
260930,"2015",11,0,14,25
260930,"2016",7,1,5,13
260930,"2017",10,1,13,24
260930,"2018",3,0,9,12
260930,"2019",5,0,19,24
260930,"2020",3,1,13,17
260930,"2021",4,0,10,14
260930,"2022",6,2,11,19
260930,"2023",4,1,6,11
260940,"2015",7,5,26,38
260940,"2016",4,0,23,27
260940,"2017",14,1,26,41
260940,"2018",11,1,23,35
260940,"2019",6,2,17,25
260940,"2020",9,3,27,39
260940,"2021",11,5,27,43
260940,"2022",8,2,18,28
260940,"2023",6,1,7,14
260950,"2015",3,0,5,8
260950,"2016",1,0,3,4
260950,"2017",3,0,5,8
260950,"2018",4,2,4,10
260950,"2019",4,1,5,10
260950,"2020",1,0,2,3
260950,"2021",5,1,2,8
260950,"2022",0,0,2,2
260950,"2023",0,2,1,3
260960,"2015",115,20,231,366
260960,"2016",97,22,225,344
260960,"2017",103,19,237,359
260960,"2018",118,22,194,334
260960,"2019",97,21,209,327
260960,"2020",78,9,178,265
260960,"2021",90,13,160,263
260960,"2022",73,16,173,262
260960,"2023",59,16,126,201
260970,"2015",2,1,8,11
260970,"2016",5,1,10,16
260970,"2017",6,2,12,20
260970,"2018",3,1,8,12
260970,"2019",1,1,9,11
260970,"2020",2,1,4,7
260970,"2021",7,1,7,15
260970,"2022",0,0,6,6
260970,"2023",5,0,5,10
260980,"2015",5,0,10,15
260980,"2016",2,2,8,12
260980,"2017",6,0,7,13
260980,"2018",1,2,11,14
260980,"2019",5,1,7,13
260980,"2020",2,0,10,12
260980,"2021",2,4,11,17
260980,"2022",1,1,7,9
260980,"2023",0,1,4,5
260990,"2015",35,9,74,118
260990,"2016",25,9,75,109
260990,"2017",35,9,76,120
260990,"2018",34,6,78,118
260990,"2019",32,11,58,101
260990,"2020",29,9,57,95
260990,"2021",28,8,60,96
260990,"2022",23,10,49,82
260990,"2023",25,5,33,63
261000,"2015",22,9,46,77
261000,"2016",16,4,51,71
261000,"2017",19,6,39,64
261000,"2018",21,4,37,62
261000,"2019",26,5,46,77
261000,"2020",21,4,36,61
261000,"2021",16,2,40,58
261000,"2022",12,5,17,34
261000,"2023",18,3,11,32
261010,"2015",2,1,4,7
261010,"2016",1,2,4,7
261010,"2017",1,1,4,6
261010,"2018",2,2,5,9
261010,"2019",2,0,6,8
261010,"2020",1,2,7,10
261010,"2021",4,1,5,10
261010,"2022",3,0,3,6
261010,"2023",0,1,0,1
261020,"2015",2,2,9,13
261020,"2016",2,0,12,14
261020,"2017",3,2,12,17
261020,"2018",6,3,5,14
261020,"2019",3,0,5,8
261020,"2020",5,2,4,11
261020,"2021",7,1,5,13
261020,"2022",2,0,5,7
261020,"2023",6,2,5,13
261030,"2015",6,1,10,17
261030,"2016",4,0,11,15
261030,"2017",8,1,8,17
261030,"2018",1,2,4,7
261030,"2019",2,4,7,13
261030,"2020",6,0,5,11
261030,"2021",5,2,7,14
261030,"2022",3,1,5,9
261030,"2023",1,1,5,7
261040,"2015",11,2,19,32
261040,"2016",8,2,9,19
261040,"2017",9,3,6,18
261040,"2018",8,1,10,19
261040,"2019",12,1,17,30
261040,"2020",18,0,9,27
261040,"2021",8,1,10,19
261040,"2022",6,1,14,21
261040,"2023",7,3,15,25
261050,"2015",7,2,15,24
261050,"2016",0,3,11,14
261050,"2017",5,2,13,20
261050,"2018",4,0,9,13
261050,"2019",10,1,17,28
261050,"2020",7,0,15,22
261050,"2021",7,1,9,17
261050,"2022",5,1,9,15
261050,"2023",3,2,4,9
261060,"2015",7,1,29,37
261060,"2016",4,1,16,21
261060,"2017",8,1,24,33
261060,"2018",5,0,11,16
261060,"2019",4,3,13,20
261060,"2020",3,0,9,12
261060,"2021",4,2,11,17
261060,"2022",5,0,7,12
261060,"2023",1,2,7,10
261070,"2015",56,7,133,196
261070,"2016",66,8,118,192
261070,"2017",60,14,104,178
261070,"2018",46,10,81,137
261070,"2019",53,10,93,156
261070,"2020",49,9,90,148
261070,"2021",46,15,79,140
261070,"2022",44,6,91,141
261070,"2023",36,6,74,116
261080,"2015",9,1,13,23
261080,"2016",8,2,18,28
261080,"2017",4,3,16,23
261080,"2018",14,1,10,25
261080,"2019",3,4,10,17
261080,"2020",4,0,11,15
261080,"2021",4,2,13,19
261080,"2022",9,1,11,21
261080,"2023",6,1,5,12
261090,"2015",20,5,39,64
261090,"2016",19,4,42,65
261090,"2017",23,12,53,88
261090,"2018",27,12,45,84
261090,"2019",16,9,27,52
261090,"2020",14,11,26,51
261090,"2021",10,3,30,43
261090,"2022",15,4,24,43
261090,"2023",10,4,23,37
261100,"2015",13,2,33,48
261100,"2016",14,3,19,36
261100,"2017",4,0,16,20
261100,"2018",9,0,9,18
261100,"2019",7,0,15,22
261100,"2020",4,1,19,24
261100,"2021",9,3,23,35
261100,"2022",14,3,19,36
261100,"2023",6,1,8,15
261110,"2015",121,34,239,394
261110,"2016",110,20,275,405
261110,"2017",155,34,235,424
261110,"2018",132,24,244,400
261110,"2019",102,25,195,322
261110,"2020",109,25,168,302
261110,"2021",102,32,159,293
261110,"2022",82,28,138,248
261110,"2023",46,4,93,143
261120,"2015",1,0,4,5
261120,"2016",2,0,7,9
261120,"2017",0,0,4,4
261120,"2018",1,1,4,6
261120,"2019",4,1,9,14
261120,"2020",2,5,10,17
261120,"2021",2,3,8,13
261120,"2022",3,0,2,5
261120,"2023",1,0,5,6
261130,"2015",6,3,19,28
261130,"2016",3,2,17,22
261130,"2017",5,2,13,20
261130,"2018",8,0,7,15
261130,"2019",2,0,20,22
261130,"2020",9,1,9,19
261130,"2021",4,0,4,8
261130,"2022",9,3,4,16
261130,"2023",3,0,9,12
261140,"2015",3,0,13,16
261140,"2016",2,2,5,9
261140,"2017",5,0,4,9
261140,"2018",2,1,4,7
261140,"2019",3,0,5,8
261140,"2020",1,0,6,7
261140,"2021",1,1,6,8
261140,"2022",0,0,5,5
261140,"2023",1,0,2,3
261150,"2015",10,2,11,23
261150,"2016",5,1,11,17
261150,"2017",5,0,5,10
261150,"2018",6,1,11,18
261150,"2019",7,2,2,11
261150,"2020",4,1,8,13
261150,"2021",7,0,5,12
261150,"2022",4,1,2,7
261150,"2023",2,0,7,9
261153,"2015",4,1,5,10
261153,"2016",3,0,6,9
261153,"2017",3,1,2,6
261153,"2018",5,0,9,14
261153,"2019",7,2,5,14
261153,"2020",5,0,4,9
261153,"2021",5,2,8,15
261153,"2022",5,0,3,8
261153,"2023",2,2,5,9
261160,"2015",393,75,874,1342
261160,"2016",293,63,735,1091
261160,"2017",354,76,744,1174
261160,"2018",341,78,655,1074
261160,"2019",350,67,594,1011
261160,"2020",275,66,534,875
261160,"2021",267,60,526,853
261160,"2022",289,81,477,847
261160,"2023",161,53,332,546
261170,"2015",3,0,1,4
261170,"2016",1,0,6,7
261170,"2017",1,0,4,5
261170,"2018",1,1,3,5
261170,"2019",1,0,11,12
261170,"2020",1,0,5,6
261170,"2021",0,2,4,6
261170,"2022",3,2,1,6
261170,"2023",0,1,5,6
261180,"2015",4,0,26,30
261180,"2016",6,0,20,26
261180,"2017",5,0,19,24
261180,"2018",4,2,13,19
261180,"2019",5,0,11,16
261180,"2020",8,1,14,23
261180,"2021",2,6,15,23
261180,"2022",3,0,9,12
261180,"2023",6,1,5,12
261190,"2015",3,1,19,23
261190,"2016",5,0,12,17
261190,"2017",8,4,9,21
261190,"2018",2,1,21,24
261190,"2019",4,3,17,24
261190,"2020",8,0,8,16
261190,"2021",7,0,4,11
261190,"2022",2,1,8,11
261190,"2023",5,2,6,13
261200,"2015",0,0,1,1
261200,"2016",0,1,3,4
261200,"2017",4,1,4,9
261200,"2018",0,0,1,1
261200,"2019",0,2,4,6
261200,"2020",1,2,3,6
261200,"2021",0,2,3,5
261200,"2022",1,0,3,4
261200,"2023",1,0,0,1
261210,"2015",1,0,2,3
261210,"2016",3,0,1,4
261210,"2017",1,0,0,1
261210,"2018",2,0,0,2
261210,"2019",0,0,3,3
261210,"2020",1,0,1,2
261210,"2021",1,1,1,3
261210,"2023",2,0,0,2
261220,"2015",30,7,57,94
261220,"2016",29,11,38,78
261220,"2017",21,8,43,72
261220,"2018",35,7,44,86
261220,"2019",27,11,31,69
261220,"2020",15,4,26,45
261220,"2021",20,5,36,61
261220,"2022",24,2,33,59
261220,"2023",28,5,31,64
261230,"2015",9,0,6,15
261230,"2016",5,1,12,18
261230,"2017",6,0,16,22
261230,"2018",7,3,8,18
261230,"2019",7,2,11,20
261230,"2020",2,1,11,14
261230,"2021",4,0,6,10
261230,"2022",6,0,3,9
261230,"2023",5,3,2,10
261240,"2015",1,0,11,12
261240,"2016",5,0,3,8
261240,"2017",1,2,9,12
261240,"2018",4,3,5,12
261240,"2019",6,0,8,14
261240,"2020",4,0,6,10
261240,"2021",4,0,3,7
261240,"2022",1,0,11,12
261240,"2023",4,0,7,11
261245,"2015",8,2,15,25
261245,"2016",6,1,9,16
261245,"2017",5,2,6,13
261245,"2018",11,2,6,19
261245,"2019",8,1,11,20
261245,"2020",3,3,12,18
261245,"2021",5,2,9,16
261245,"2022",5,2,7,14
261245,"2023",2,2,7,11
261247,"2015",2,0,4,6
261247,"2016",1,0,2,3
261247,"2017",3,0,3,6
261247,"2018",2,0,5,7
261247,"2019",4,0,2,6
261247,"2020",0,0,3,3
261247,"2021",1,1,6,8
261247,"2022",2,1,6,9
261247,"2023",1,1,2,4
261250,"2015",9,0,12,21
261250,"2016",10,1,12,23
261250,"2017",8,1,20,29
261250,"2018",11,1,33,45
261250,"2019",10,0,13,23
261250,"2020",5,2,11,18
261250,"2021",13,4,22,39
261250,"2022",15,1,17,33
261250,"2023",11,0,21,32
261255,"2015",6,2,12,20
261255,"2016",2,0,11,13
261255,"2017",5,1,7,13
261255,"2018",5,1,9,15
261255,"2019",7,0,6,13
261255,"2020",3,2,6,11
261255,"2021",6,0,6,12
261255,"2022",4,0,7,11
261255,"2023",1,1,5,7
261260,"2015",4,1,6,11
261260,"2016",1,0,7,8
261260,"2017",14,2,21,37
261260,"2018",8,5,22,35
261260,"2019",12,4,22,38
261260,"2020",14,4,20,38
261260,"2021",15,3,26,44
261260,"2022",9,1,20,30
261260,"2023",2,0,10,12
261270,"2015",1,0,8,9
261270,"2016",1,1,6,8
261270,"2017",2,0,4,6
261270,"2018",3,1,3,7
261270,"2019",6,0,3,9
261270,"2020",3,0,9,12
261270,"2021",3,1,1,5
261270,"2022",1,0,1,2
261270,"2023",2,1,3,6
261280,"2015",7,0,12,19
261280,"2016",4,1,8,13
261280,"2017",7,0,7,14
261280,"2018",1,1,7,9
261280,"2019",7,2,6,15
261280,"2020",3,0,9,12
261280,"2021",4,1,8,13
261280,"2022",4,3,4,11
261280,"2023",1,4,5,10
261290,"2015",4,0,7,11
261290,"2016",2,0,5,7
261290,"2017",2,0,6,8
261290,"2018",1,0,5,6
261290,"2019",0,0,5,5
261290,"2020",2,0,8,10
261290,"2021",3,0,3,6
261290,"2022",1,0,1,2
261290,"2023",0,0,2,2
261300,"2015",15,2,31,48
261300,"2016",13,3,18,34
261300,"2017",20,2,18,40
261300,"2018",16,3,40,59
261300,"2019",10,6,20,36
261300,"2020",11,3,25,39
261300,"2021",11,3,20,34
261300,"2022",17,3,30,50
261300,"2023",12,5,12,29
261310,"2015",1,2,11,14
261310,"2016",2,0,13,15
261310,"2017",1,0,7,8
261310,"2018",3,2,10,15
261310,"2019",8,1,6,15
261310,"2020",4,3,12,19
261310,"2021",6,2,7,15
261310,"2022",3,0,7,10
261310,"2023",6,2,7,15
261320,"2015",13,2,17,32
261320,"2016",8,1,29,38
261320,"2017",7,4,12,23
261320,"2018",15,4,14,33
261320,"2019",13,2,13,28
261320,"2020",13,5,13,31
261320,"2021",12,2,17,31
261320,"2022",5,2,12,19
261320,"2023",4,3,6,13
261330,"2015",4,2,9,15
261330,"2016",0,2,2,4
261330,"2017",1,2,4,7
261330,"2018",7,1,2,10
261330,"2019",4,0,10,14
261330,"2020",4,1,2,7
261330,"2021",2,0,4,6
261330,"2022",1,2,4,7
261330,"2023",3,0,4,7
261340,"2015",3,0,17,20
261340,"2016",6,1,17,24
261340,"2017",5,2,6,13
261340,"2018",6,1,10,17
261340,"2019",4,1,12,17
261340,"2020",5,1,17,23
261340,"2021",2,2,10,14
261340,"2022",2,2,7,11
261340,"2023",3,2,1,6
261350,"2015",10,3,15,28
261350,"2016",5,3,16,24
261350,"2017",8,2,10,20
261350,"2018",6,3,6,15
261350,"2019",4,6,12,22
261350,"2020",13,4,24,41
261350,"2021",14,2,18,34
261350,"2022",6,0,16,22
261350,"2023",3,0,13,16
261360,"2015",22,7,42,71
261360,"2016",17,1,31,49
261360,"2017",21,1,32,54
261360,"2018",13,3,12,28
261360,"2019",15,3,19,37
261360,"2020",6,0,20,26
261360,"2021",9,6,12,27
261360,"2022",12,4,18,34
261360,"2023",7,4,10,21
261370,"2015",25,5,60,90
261370,"2016",11,1,23,35
261370,"2017",23,2,47,72
261370,"2018",33,0,46,79
261370,"2019",17,9,43,69
261370,"2020",10,4,35,49
261370,"2021",10,3,35,48
261370,"2022",8,1,8,17
261370,"2023",7,1,8,16
261380,"2015",1,2,4,7
261380,"2016",2,0,5,7
261380,"2017",0,1,2,3
261380,"2018",0,0,3,3
261380,"2019",2,1,2,5
261380,"2020",2,0,3,5
261380,"2021",0,2,4,6
261380,"2022",0,0,2,2
261380,"2023",0,1,3,4
261390,"2015",29,5,60,94
261390,"2016",24,5,42,71
261390,"2017",19,2,54,75
261390,"2018",10,1,27,38
261390,"2019",27,5,39,71
261390,"2020",25,5,42,72
261390,"2021",15,10,53,78
261390,"2022",29,7,63,99
261390,"2023",14,3,26,43
261400,"2015",3,1,2,6
261400,"2016",3,1,7,11
261400,"2017",7,1,12,20
261400,"2018",7,3,14,24
261400,"2019",8,3,16,27
261400,"2020",6,1,10,17
261400,"2021",8,2,6,16
261400,"2022",9,3,5,17
261400,"2023",5,2,13,20
261410,"2015",6,2,20,28
261410,"2016",7,0,11,18
261410,"2017",11,1,12,24
261410,"2018",11,1,14,26
261410,"2019",9,5,17,31
261410,"2020",13,1,16,30
261410,"2021",9,4,13,26
261410,"2022",2,2,16,20
261410,"2023",12,1,5,18
261420,"2015",6,0,20,26
261420,"2016",9,1,29,39
261420,"2017",5,2,29,36
261420,"2018",17,1,24,42
261420,"2019",10,3,23,36
261420,"2020",2,0,21,23
261420,"2021",5,0,15,20
261420,"2022",3,1,11,15
261420,"2023",5,1,8,14
261430,"2015",5,0,5,10
261430,"2016",3,0,4,7
261430,"2017",6,1,4,11
261430,"2018",4,1,7,12
261430,"2019",3,1,3,7
261430,"2020",3,0,2,5
261430,"2021",2,3,3,8
261430,"2022",3,2,6,11
261430,"2023",3,1,5,9
261440,"2015",2,0,6,8
261440,"2016",0,0,4,4
261440,"2017",2,0,11,13
261440,"2018",3,1,2,6
261440,"2019",4,5,6,15
261440,"2020",5,2,5,12
261440,"2021",6,0,7,13
261440,"2022",3,2,2,7
261440,"2023",2,0,2,4
261450,"2015",27,2,43,72
261450,"2016",20,4,24,48
261450,"2017",24,0,23,47
261450,"2018",18,4,24,46
261450,"2019",18,4,25,47
261450,"2020",16,3,17,36
261450,"2021",10,2,24,36
261450,"2022",18,3,12,33
261450,"2023",9,7,18,34
261460,"2015",10,4,29,43
261460,"2016",13,2,25,40
261460,"2017",6,1,21,28
261460,"2018",10,2,17,29
261460,"2019",14,2,32,48
261460,"2020",16,2,30,48
261460,"2021",22,5,31,58
261460,"2022",18,2,32,52
261460,"2023",11,2,21,34
261470,"2015",1,0,3,4
261470,"2016",0,0,3,3
261470,"2017",1,0,4,5
261470,"2018",3,1,3,7
261470,"2019",3,0,6,9
261470,"2020",1,1,5,7
261470,"2021",0,0,3,3
261470,"2022",2,0,2,4
261470,"2023",1,1,1,3
261480,"2015",3,0,8,11
261480,"2016",1,0,2,3
261480,"2017",1,3,5,9
261480,"2018",2,0,2,4
261480,"2019",2,4,1,7
261480,"2020",4,0,10,14
261480,"2021",7,0,8,15
261480,"2022",4,3,6,13
261480,"2023",3,0,7,10
261485,"2015",3,2,25,30
261485,"2016",5,0,15,20
261485,"2017",4,2,20,26
261485,"2018",4,5,23,32
261485,"2019",5,0,19,24
261485,"2020",8,1,19,28
261485,"2021",5,1,26,32
261485,"2022",4,2,11,17
261485,"2023",4,1,7,12
261500,"2015",2,2,1,5
261500,"2016",4,1,3,8
261500,"2017",5,0,6,11
261500,"2018",2,0,1,3
261500,"2019",5,0,5,10
261500,"2020",1,1,4,6
261500,"2021",3,1,2,6
261500,"2022",1,1,4,6
261500,"2023",3,0,3,6
261510,"2015",2,2,3,7
261510,"2016",2,1,2,5
261510,"2017",4,0,2,6
261510,"2018",3,0,3,6
261510,"2019",5,0,1,6
261510,"2020",3,0,1,4
261510,"2021",4,1,5,10
261510,"2022",3,2,4,9
261510,"2023",2,0,1,3
261520,"2015",7,3,13,23
261520,"2016",3,2,7,12
261520,"2017",3,2,8,13
261520,"2018",3,0,6,9
261520,"2019",1,1,6,8
261520,"2020",5,1,1,7
261520,"2021",3,2,4,9
261520,"2022",6,0,1,7
261520,"2023",5,0,2,7
261530,"2015",11,2,24,37
261530,"2016",1,2,10,13
261530,"2017",6,3,20,29
261530,"2018",2,0,7,9
261530,"2019",5,1,6,12
261530,"2020",3,2,6,11
261530,"2021",2,0,5,7
261530,"2022",2,0,2,4
261530,"2023",2,0,0,2
261540,"2015",7,0,20,27
261540,"2016",2,1,11,14
261540,"2017",3,0,17,20
261540,"2018",1,3,14,18
261540,"2019",9,0,20,29
261540,"2020",6,1,6,13
261540,"2021",3,0,13,16
261540,"2022",7,1,14,22
261540,"2023",5,0,11,16
261550,"2015",0,0,2,2
261550,"2016",1,0,3,4
261550,"2017",1,0,1,2
261550,"2018",1,2,2,5
261550,"2019",1,1,1,3
261550,"2020",1,0,1,2
261550,"2021",0,0,3,3
261550,"2022",1,0,0,1
261560,"2015",10,2,48,60
261560,"2016",12,3,49,64
261560,"2017",15,3,32,50
261560,"2018",17,6,34,57
261560,"2019",16,1,27,44
261560,"2020",7,2,20,29
261560,"2021",9,3,31,43
261560,"2022",8,1,21,30
261560,"2023",11,1,29,41
261570,"2015",4,1,7,12
261570,"2016",1,0,2,3
261570,"2017",2,0,7,9
261570,"2018",2,0,4,6
261570,"2019",2,1,13,16
261570,"2020",4,1,10,15
261570,"2021",2,0,7,9
261570,"2022",7,1,6,14
261570,"2023",4,1,6,11
261580,"2015",5,1,10,16
261580,"2016",7,2,8,17
261580,"2017",7,1,10,18
261580,"2018",7,0,15,22
261580,"2019",3,3,10,16
261580,"2020",5,0,11,16
261580,"2021",7,0,11,18
261580,"2022",7,0,11,18
261580,"2023",6,2,8,16
261590,"2015",2,0,1,3
261590,"2016",1,1,7,9
261590,"2017",3,1,5,9
261590,"2018",4,1,5,10
261590,"2019",5,2,10,17
261590,"2020",4,0,7,11
261590,"2021",3,1,11,15
261590,"2022",4,1,2,7
261590,"2023",3,0,7,10
261600,"2015",7,0,11,18
261600,"2016",8,2,8,18
261600,"2017",5,1,10,16
261600,"2018",7,0,9,16
261600,"2019",8,1,7,16
261600,"2020",6,1,10,17
261600,"2021",4,0,7,11
261600,"2022",3,3,7,13
261600,"2023",6,3,5,14
261610,"2015",4,0,12,16
261610,"2016",1,0,5,6
261610,"2017",3,0,6,9
261610,"2018",2,1,1,4
261610,"2019",2,0,8,10
261610,"2020",3,1,7,11
261610,"2021",2,0,3,5
261610,"2022",5,1,8,14
261610,"2023",0,0,2,2
261618,"2015",1,2,3,6
261618,"2016",1,0,3,4
261618,"2017",2,1,3,6
261618,"2018",1,1,2,4
261618,"2019",1,1,1,3
261618,"2020",3,0,3,6
261618,"2021",1,0,1,2
261618,"2022",2,1,1,4
261618,"2023",1,0,2,3
261620,"2015",2,1,5,8
261620,"2016",1,0,6,7
261620,"2017",1,1,4,6
261620,"2018",1,1,2,4
261620,"2019",1,0,9,10
261620,"2020",2,0,6,8
261620,"2021",5,0,2,7
261620,"2022",6,0,0,6
261620,"2023",4,1,6,11
261630,"2015",3,1,2,6
261630,"2016",0,0,2,2
261630,"2017",3,0,4,7
261630,"2018",5,0,5,10
261630,"2019",3,0,5,8
261630,"2020",5,1,3,9
261630,"2021",1,1,1,3
261630,"2022",2,0,1,3
261630,"2023",0,0,5,5
261640,"2015",44,8,100,152
261640,"2016",17,8,73,98
261640,"2017",40,5,88,133
261640,"2018",22,6,68,96
261640,"2019",27,6,65,98
261640,"2020",27,10,59,96
261640,"2021",30,8,60,98
261640,"2022",21,4,61,86
261640,"2023",28,6,30,64
261650,"2015",4,0,11,15
261650,"2016",6,2,9,17
261650,"2017",2,0,9,11
261650,"2018",6,0,9,15
261650,"2019",6,1,9,16
261650,"2020",3,2,10,15
261650,"2021",3,2,10,15
261650,"2022",3,1,3,7
261650,"2023",4,0,6,10
270010,"2015",0,0,1,1
270010,"2016",4,1,2,7
270010,"2017",3,1,1,5
270010,"2018",2,1,3,6
270010,"2019",0,0,2,2
270010,"2020",2,1,4,7
270010,"2021",5,0,4,9
270010,"2022",2,0,7,9
270010,"2023",2,2,5,9
270020,"2015",5,0,3,8
270020,"2016",2,0,3,5
270020,"2017",6,1,8,15
270020,"2018",4,1,8,13
270020,"2019",7,1,5,13
270020,"2020",4,0,7,11
270020,"2021",4,1,5,10
270020,"2022",1,0,5,6
270030,"2015",71,16,185,272
270030,"2016",69,24,134,227
270030,"2017",81,18,167,266
270030,"2018",69,15,133,217
270030,"2019",78,8,128,214
270030,"2020",61,16,96,173
270030,"2021",50,13,103,166
270030,"2022",45,5,81,131
270030,"2023",17,2,33,52
270040,"2015",7,1,32,40
270040,"2016",12,1,37,50
270040,"2017",7,1,18,26
270040,"2018",11,1,26,38
270040,"2019",11,2,15,28
270040,"2020",5,0,18,23
270040,"2021",6,3,19,28
270040,"2022",4,0,18,22
270040,"2023",10,2,13,25
270050,"2015",4,1,18,23
270050,"2016",3,0,19,22
270050,"2017",2,1,12,15
270050,"2018",7,1,13,21
270050,"2019",5,1,10,16
270050,"2020",7,1,13,21
270050,"2021",3,1,11,15
270050,"2022",6,0,11,17
270050,"2023",0,0,3,3
270060,"2015",3,1,7,11
270060,"2016",1,0,3,4
270060,"2017",2,0,9,11
270060,"2018",2,0,15,17
270060,"2019",1,0,6,7
270060,"2020",2,1,8,11
270060,"2021",3,0,6,9
270060,"2022",2,0,4,6
270060,"2023",3,0,1,4
270070,"2015",4,0,5,9
270070,"2016",0,0,6,6
270070,"2017",3,0,9,12
270070,"2018",6,3,11,20
270070,"2019",4,0,7,11
270070,"2020",6,1,8,15
270070,"2021",3,0,4,7
270070,"2022",3,2,7,12
270070,"2023",0,0,3,3
270080,"2015",2,1,8,11
270080,"2016",1,1,10,12
270080,"2017",2,0,5,7
270080,"2018",0,0,3,3
270080,"2020",2,0,2,4
270080,"2021",2,0,2,4
270080,"2022",2,2,0,4
270080,"2023",0,1,0,1
270090,"2015",0,0,5,5
270090,"2016",1,0,2,3
270090,"2017",1,0,3,4
270090,"2018",1,0,5,6
270090,"2019",3,0,3,6
270090,"2020",3,0,1,4
270090,"2021",2,0,1,3
270090,"2022",0,1,2,3
270100,"2015",5,0,7,12
270100,"2016",8,0,4,12
270100,"2017",3,0,8,11
270100,"2018",6,0,13,19
270100,"2019",0,2,9,11
270100,"2020",2,0,9,11
270100,"2021",1,0,6,7
270100,"2022",0,1,5,6
270100,"2023",1,0,0,1
270110,"2015",1,0,16,17
270110,"2016",4,0,9,13
270110,"2017",0,1,6,7
270110,"2018",3,0,2,5
270110,"2019",2,0,1,3
270110,"2020",3,1,3,7
270110,"2021",0,0,2,2
270110,"2022",1,0,0,1
270120,"2015",1,0,4,5
270120,"2016",2,0,8,10
270120,"2017",1,0,5,6
270120,"2018",1,2,4,7
270120,"2019",5,0,4,9
270120,"2020",1,0,7,8
270120,"2021",3,1,4,8
270120,"2022",2,0,1,3
270120,"2023",0,1,3,4
270130,"2015",2,1,12,15
270130,"2016",2,3,14,19
270130,"2017",2,0,12,14
270130,"2018",4,2,15,21
270130,"2019",5,3,6,14
270130,"2020",4,1,12,17
270130,"2021",2,2,9,13
270130,"2022",1,0,12,13
270130,"2023",3,0,2,5
270135,"2015",1,1,2,4
270135,"2016",1,2,3,6
270135,"2017",1,0,3,4
270135,"2018",0,0,4,4
270135,"2019",1,0,1,2
270135,"2020",1,0,7,8
270135,"2021",2,0,3,5
270135,"2022",0,0,2,2
270135,"2023",1,0,2,3
270140,"2015",5,1,9,15
270140,"2016",4,0,15,19
270140,"2017",11,1,17,29
270140,"2018",7,2,11,20
270140,"2019",9,0,10,19
270140,"2020",7,0,15,22
270140,"2021",5,2,12,19
270140,"2022",1,0,3,4
270140,"2023",1,0,3,4
270150,"2015",0,0,8,8
270150,"2016",1,1,5,7
270150,"2017",4,0,4,8
270150,"2018",2,1,5,8
270150,"2019",5,0,4,9
270150,"2020",3,0,2,5
270150,"2021",5,0,2,7
270150,"2022",3,0,1,4
270150,"2023",1,0,0,1
270160,"2015",3,1,10,14
270160,"2016",0,2,4,6
270160,"2017",1,2,4,7
270160,"2018",2,0,11,13
270160,"2019",3,0,2,5
270160,"2020",3,1,5,9
270160,"2021",4,3,9,16
270160,"2022",6,0,3,9
270160,"2023",2,0,3,5
270170,"2015",3,1,9,13
270170,"2016",3,0,5,8
270170,"2017",4,0,9,13
270170,"2018",3,1,12,16
270170,"2019",3,0,9,12
270170,"2020",1,1,10,12
270170,"2021",3,1,9,13
270170,"2022",2,0,8,10
270170,"2023",4,3,7,14
270180,"2015",4,1,1,6
270180,"2016",3,0,4,7
270180,"2017",2,0,2,4
270180,"2018",2,2,4,8
270180,"2019",5,0,4,9
270180,"2020",1,0,1,2
270180,"2021",2,1,4,7
270180,"2022",1,0,4,5
270180,"2023",0,1,4,5
270190,"2015",1,1,3,5
270190,"2016",1,1,6,8
270190,"2017",1,1,3,5
270190,"2018",0,0,2,2
270190,"2019",2,0,2,4
270190,"2020",1,1,1,3
270190,"2021",2,0,1,3
270190,"2022",0,0,2,2
270190,"2023",1,0,0,1
270200,"2015",4,0,7,11
270200,"2016",2,1,11,14
270200,"2017",2,2,3,7
270200,"2018",9,2,4,15
270200,"2019",0,1,2,3
270200,"2020",6,0,3,9
270200,"2021",3,1,3,7
270200,"2022",3,1,3,7
270200,"2023",1,0,0,1
270210,"2015",2,0,8,10
270210,"2016",3,1,11,15
270210,"2017",9,2,12,23
270210,"2018",1,2,3,6
270210,"2019",3,0,2,5
270210,"2020",2,1,10,13
270210,"2021",3,0,6,9
270210,"2022",3,0,4,7
270210,"2023",4,1,3,8
270220,"2015",1,2,5,8
270220,"2016",1,1,6,8
270220,"2017",2,1,7,10
270220,"2018",1,0,4,5
270220,"2019",1,0,3,4
270220,"2020",2,0,4,6
270220,"2021",1,0,2,3
270220,"2022",0,1,3,4
270220,"2023",0,0,2,2
270230,"2015",9,1,17,27
270230,"2016",3,0,6,9
270230,"2017",7,1,9,17
270230,"2018",6,3,5,14
270230,"2019",1,0,10,11
270230,"2020",7,0,25,32
270230,"2021",16,3,23,42
270230,"2022",8,1,9,18
270230,"2023",2,0,12,14
270235,"2015",9,3,14,26
270235,"2016",7,3,13,23
270235,"2017",11,1,14,26
270235,"2018",11,1,10,22
270235,"2019",6,2,8,16
270235,"2020",6,0,9,15
270235,"2021",4,0,10,14
270235,"2022",3,1,7,11
270235,"2023",3,0,2,5
270240,"2015",1,0,13,14
270240,"2016",3,0,13,16
270240,"2017",5,4,18,27
270240,"2018",4,0,14,18
270240,"2019",3,1,10,14
270240,"2020",8,1,15,24
270240,"2021",8,1,14,23
270240,"2022",20,3,20,43
270240,"2023",10,1,22,33
270250,"2015",1,0,5,6
270250,"2016",1,0,4,5
270250,"2017",3,0,8,11
270250,"2018",1,0,7,8
270250,"2019",0,0,2,2
270250,"2020",0,0,3,3
270250,"2021",1,1,6,8
270250,"2022",2,0,5,7
270250,"2023",3,0,2,5
270255,"2015",11,0,9,20
270255,"2016",7,2,12,21
270255,"2017",7,2,8,17
270255,"2018",5,1,8,14
270255,"2019",4,1,5,10
270255,"2020",2,1,3,6
270255,"2021",2,0,4,6
270255,"2022",6,1,1,8
270255,"2023",1,0,4,5
270260,"2015",7,0,11,18
270260,"2016",8,2,14,24
270260,"2017",7,3,10,20
270260,"2018",7,4,14,25
270260,"2019",6,3,9,18
270260,"2020",4,2,11,17
270260,"2021",6,2,10,18
270260,"2022",3,1,9,13
270260,"2023",0,2,6,8
270270,"2015",0,0,1,1
270270,"2017",0,0,2,2
270270,"2018",0,0,2,2
270270,"2020",0,0,2,2
270270,"2021",0,0,2,2
270270,"2022",0,0,1,1
270270,"2023",0,0,1,1
270280,"2015",2,0,5,7
270280,"2016",0,1,9,10
270280,"2017",1,0,8,9
270280,"2018",1,0,5,6
270280,"2019",4,0,6,10
270280,"2020",0,0,6,6
270280,"2021",2,0,8,10
270280,"2022",5,1,6,12
270280,"2023",0,0,1,1
270290,"2015",14,2,17,33
270290,"2016",5,1,24,30
270290,"2017",9,2,18,29
270290,"2018",16,1,26,43
270290,"2019",15,3,15,33
270290,"2020",7,4,14,25
270290,"2021",9,0,6,15
270290,"2022",8,3,8,19
270290,"2023",1,0,4,5
270300,"2015",2,0,13,15
270300,"2016",5,0,9,14
270300,"2017",2,3,12,17
270300,"2018",2,0,4,6
270300,"2019",0,2,4,6
270300,"2020",0,0,5,5
270300,"2021",4,1,6,11
270300,"2022",0,0,2,2
270300,"2023",4,1,0,5
270310,"2015",7,2,21,30
270310,"2016",7,2,6,15
270310,"2017",9,1,10,20
270310,"2018",12,1,11,24
270310,"2019",9,3,11,23
270310,"2020",3,1,3,7
270310,"2021",2,0,7,9
270310,"2022",10,4,5,19
270310,"2023",3,0,3,6
270320,"2015",8,2,22,32
270320,"2016",3,0,11,14
270320,"2017",5,1,13,19
270320,"2018",5,1,9,15
270320,"2019",5,1,9,15
270320,"2020",4,2,9,15
270320,"2021",4,0,6,10
270320,"2022",9,0,7,16
270320,"2023",3,0,5,8
270330,"2015",5,1,11,17
270330,"2016",3,0,8,11
270330,"2017",2,0,6,8
270330,"2018",0,2,1,3
270330,"2019",2,0,7,9
270330,"2020",1,1,5,7
270330,"2021",4,1,10,15
270330,"2022",2,2,9,13
270330,"2023",4,0,5,9
270340,"2015",0,0,2,2
270340,"2016",3,1,0,4
270340,"2017",1,0,0,1
270340,"2018",1,0,4,5
270340,"2019",0,0,7,7
270340,"2020",1,0,2,3
270340,"2021",2,0,2,4
270340,"2022",2,0,5,7
270350,"2015",0,0,4,4
270350,"2017",0,0,1,1
270350,"2018",0,0,5,5
270350,"2019",0,0,5,5
270350,"2021",0,0,1,1
270350,"2023",0,0,1,1
270360,"2015",2,0,5,7
270360,"2016",0,0,6,6
270360,"2017",1,1,4,6
270360,"2018",1,1,6,8
270360,"2019",2,1,7,10
270360,"2020",2,0,11,13
270360,"2021",1,0,2,3
270360,"2022",2,0,2,4
270370,"2015",1,0,4,5
270370,"2016",3,0,0,3
270370,"2017",3,0,4,7
270370,"2018",0,0,2,2
270370,"2019",2,0,2,4
270370,"2020",0,0,5,5
270370,"2021",0,0,3,3
270370,"2022",1,0,0,1
270370,"2023",3,0,0,3
270375,"2015",0,1,4,5
270375,"2016",0,0,1,1
270375,"2017",1,0,2,3
270375,"2019",1,0,3,4
270375,"2020",3,0,2,5
270375,"2021",1,0,3,4
270375,"2022",1,0,5,6
270375,"2023",0,0,1,1
270380,"2015",3,4,8,15
270380,"2016",5,1,12,18
270380,"2017",3,0,11,14
270380,"2018",1,0,6,7
270380,"2019",4,0,5,9
270380,"2020",3,1,4,8
270380,"2021",2,0,5,7
270380,"2022",3,1,4,8
270380,"2023",0,1,5,6
270390,"2015",0,0,1,1
270390,"2016",0,0,4,4
270390,"2017",2,0,3,5
270390,"2018",1,0,1,2
270390,"2019",1,0,4,5
270390,"2020",0,0,3,3
270390,"2021",1,0,2,3
270390,"2022",1,0,0,1
270400,"2015",3,2,14,19
270400,"2016",6,0,11,17
270400,"2017",8,0,9,17
270400,"2018",5,0,11,16
270400,"2019",3,2,20,25
270400,"2020",8,2,13,23
270400,"2021",5,1,9,15
270400,"2022",1,1,2,4
270400,"2023",2,0,0,2
270410,"2015",4,1,12,17
270410,"2016",7,2,14,23
270410,"2017",6,3,19,28
270410,"2018",5,2,7,14
270410,"2019",2,1,10,13
270410,"2020",2,1,9,12
270410,"2021",4,1,5,10
270410,"2022",3,0,5,8
270410,"2023",2,1,3,6
270420,"2015",9,2,11,22
270420,"2016",6,2,14,22
270420,"2017",9,2,11,22
270420,"2018",8,2,9,19
270420,"2019",9,5,10,24
270420,"2020",4,0,8,12
270420,"2021",7,3,5,15
270420,"2022",4,2,9,15
270420,"2023",4,0,4,8
270430,"2015",252,51,707,1010
270430,"2016",230,40,675,945
270430,"2017",254,52,740,1046
270430,"2018",266,66,579,911
270430,"2019",272,55,573,900
270430,"2020",222,59,508,789
270430,"2021",251,57,546,854
270430,"2022",204,50,507,761
270430,"2023",142,46,307,495
270440,"2015",4,0,11,15
270440,"2016",5,0,18,23
270440,"2017",3,1,12,16
270440,"2018",4,0,11,15
270440,"2019",0,2,8,10
270440,"2020",1,0,8,9
270440,"2021",5,1,7,13
270440,"2022",4,1,4,9
270440,"2023",2,0,1,3
270450,"2015",12,0,11,23
270450,"2016",7,0,22,29
270450,"2017",4,0,28,32
270450,"2018",12,1,23,36
270450,"2019",7,0,33,40
270450,"2020",6,0,19,25
270450,"2021",9,3,16,28
270450,"2022",8,2,10,20
270450,"2023",2,4,5,11
270460,"2015",2,1,8,11
270460,"2016",1,1,5,7
270460,"2017",2,1,2,5
270460,"2018",1,0,1,2
270460,"2019",4,0,5,9
270460,"2020",3,0,5,8
270460,"2021",6,0,5,11
270460,"2022",3,1,3,7
270460,"2023",1,0,6,7
270470,"2015",8,3,39,50
270470,"2016",8,2,42,52
270470,"2017",9,2,37,48
270470,"2018",19,3,40,62
270470,"2019",8,1,51,60
270470,"2020",12,5,26,43
270470,"2021",9,2,34,45
270470,"2022",6,3,24,33
270470,"2023",5,2,13,20
270480,"2015",1,1,2,4
270480,"2016",1,1,6,8
270480,"2017",2,0,7,9
270480,"2018",3,1,4,8
270480,"2019",11,1,8,20
270480,"2020",1,0,6,7
270480,"2021",1,1,5,7
270480,"2022",3,1,4,8
270480,"2023",2,0,1,3
270490,"2015",0,0,1,1
270490,"2016",0,0,1,1
270490,"2017",0,1,1,2
270490,"2019",4,0,0,4
270490,"2020",1,0,1,2
270490,"2021",1,0,0,1
270490,"2022",0,0,3,3
270490,"2023",1,0,1,2
270500,"2015",5,0,10,15
270500,"2016",4,1,6,11
270500,"2017",4,0,10,14
270500,"2018",4,0,6,10
270500,"2019",4,1,6,11
270500,"2020",7,0,5,12
270500,"2021",2,2,14,18
270500,"2022",3,2,6,11
270500,"2023",6,0,4,10
270510,"2015",10,1,17,28
270510,"2016",5,1,14,20
270510,"2017",2,0,22,24
270510,"2018",2,1,14,17
270510,"2019",8,2,22,32
270510,"2020",3,3,23,29
270510,"2021",3,0,11,14
270510,"2022",1,1,8,10
270510,"2023",1,0,4,5
270520,"2015",5,0,10,15
270520,"2016",3,0,15,18
270520,"2017",13,0,14,27
270520,"2018",4,0,19,23
270520,"2019",5,0,12,17
270520,"2020",3,1,7,11
270520,"2021",7,0,12,19
270520,"2022",0,0,3,3
270520,"2023",1,0,4,5
270530,"2015",1,2,2,5
270530,"2016",1,0,3,4
270530,"2017",2,1,2,5
270530,"2018",3,1,4,8
270530,"2019",1,0,3,4
270530,"2020",0,0,1,1
270530,"2021",1,0,2,3
270530,"2022",2,2,0,4
270540,"2015",2,1,2,5
270540,"2016",0,0,6,6
270540,"2017",1,1,2,4
270540,"2018",0,1,3,4
270540,"2019",0,0,2,2
270540,"2020",0,0,3,3
270540,"2021",2,1,6,9
270540,"2022",5,1,1,7
270540,"2023",1,0,1,2
270550,"2015",7,0,30,37
270550,"2016",10,4,9,23
270550,"2017",7,1,24,32
270550,"2018",5,1,5,11
270550,"2019",3,0,2,5
270550,"2020",1,0,10,11
270550,"2021",2,1,4,7
270550,"2022",4,0,4,8
270550,"2023",2,0,6,8
270560,"2015",2,0,8,10
270560,"2016",0,0,5,5
270560,"2017",1,1,3,5
270560,"2018",3,0,2,5
270560,"2019",1,0,6,7
270560,"2020",4,0,6,10
270560,"2021",1,0,4,5
270560,"2022",3,0,3,6
270560,"2023",1,1,0,2
270570,"2015",5,2,10,17
270570,"2016",4,2,11,17
270570,"2017",4,1,14,19
270570,"2018",3,1,6,10
270570,"2019",2,1,7,10
270570,"2020",7,0,10,17
270570,"2021",4,2,10,16
270570,"2022",8,3,14,25
270570,"2023",3,0,10,13
270580,"2015",0,0,3,3
270580,"2016",1,0,5,6
270580,"2017",2,1,2,5
270580,"2018",0,1,1,2
270580,"2019",0,1,3,4
270580,"2020",1,0,2,3
270580,"2021",2,0,3,5
270580,"2022",3,1,3,7
270580,"2023",3,1,3,7
270590,"2015",2,0,4,6
270590,"2016",2,0,1,3
270590,"2017",2,0,4,6
270590,"2018",1,0,1,2
270590,"2019",1,2,1,4
270590,"2020",1,1,0,2
270590,"2021",1,0,0,1
270590,"2022",2,1,0,3
270590,"2023",1,0,0,1
270600,"2015",3,1,4,8
270600,"2016",1,2,2,5
270600,"2017",1,0,7,8
270600,"2018",1,2,0,3
270600,"2019",0,2,0,2
270600,"2020",0,0,1,1
270600,"2021",1,0,6,7
270600,"2022",1,0,3,4
270600,"2023",2,0,6,8
270610,"2015",4,1,8,13
270610,"2016",3,0,8,11
270610,"2017",1,0,7,8
270610,"2018",1,0,12,13
270610,"2019",4,0,5,9
270610,"2020",5,0,3,8
270610,"2021",4,0,6,10
270610,"2022",1,2,3,6
270610,"2023",2,0,4,6
270620,"2015",4,0,3,7
270620,"2016",1,0,4,5
270620,"2017",2,0,2,4
270620,"2018",4,0,1,5
270620,"2019",1,0,0,1
270620,"2020",0,0,4,4
270620,"2021",2,0,4,6
270620,"2022",1,0,2,3
270620,"2023",0,0,3,3
270630,"2015",35,8,67,110
270630,"2016",35,4,54,93
270630,"2017",23,3,51,77
270630,"2018",20,9,47,76
270630,"2019",24,6,40,70
270630,"2020",19,1,26,46
270630,"2021",17,4,18,39
270630,"2022",19,4,26,49
270630,"2023",13,1,25,39
270640,"2015",4,1,13,18
270640,"2016",3,0,13,16
270640,"2017",5,0,8,13
270640,"2018",3,1,11,15
270640,"2019",5,0,3,8
270640,"2020",0,0,13,13
270640,"2021",2,1,13,16
270640,"2022",3,2,9,14
270640,"2023",3,1,13,17
270642,"2015",1,0,0,1
270642,"2016",2,0,2,4
270642,"2017",2,0,3,5
270642,"2018",0,2,5,7
270642,"2019",1,0,0,1
270642,"2020",0,1,0,1
270642,"2021",2,0,7,9
270642,"2022",2,0,3,5
270642,"2023",1,1,0,2
270644,"2015",1,1,12,14
270644,"2016",1,2,9,12
270644,"2017",4,0,16,20
270644,"2018",5,2,9,16
270644,"2019",4,1,15,20
270644,"2020",6,1,5,12
270644,"2021",2,1,10,13
270644,"2022",2,0,11,13
270644,"2023",0,1,3,4
270650,"2015",4,1,10,15
270650,"2016",3,0,13,16
270650,"2017",1,1,13,15
270650,"2018",7,1,12,20
270650,"2019",3,0,13,16
270650,"2020",1,0,15,16
270650,"2021",3,1,9,13
270650,"2022",4,0,5,9
270650,"2023",2,0,2,4
270660,"2015",1,0,6,7
270660,"2016",0,0,5,5
270660,"2017",1,0,3,4
270660,"2018",3,0,5,8
270660,"2019",2,2,2,6
270660,"2020",0,0,1,1
270660,"2021",0,0,3,3
270660,"2022",1,0,0,1
270660,"2023",1,0,0,1
270670,"2015",26,10,54,90
270670,"2016",36,4,49,89
270670,"2017",19,5,55,79
270670,"2018",25,3,58,86
270670,"2019",26,3,48,77
270670,"2020",17,1,25,43
270670,"2021",13,3,34,50
270670,"2022",21,5,21,47
270670,"2023",17,7,25,49
270680,"2015",6,1,12,19
270680,"2016",5,1,13,19
270680,"2017",3,0,17,20
270680,"2018",4,1,15,20
270680,"2019",4,0,12,16
270680,"2020",2,0,9,11
270680,"2021",2,1,7,10
270680,"2022",5,2,8,15
270680,"2023",4,1,5,10
270690,"2015",10,1,16,27
270690,"2016",5,2,20,27
270690,"2017",10,1,21,32
270690,"2018",12,4,37,53
270690,"2019",9,0,28,37
270690,"2020",5,0,29,34
270690,"2021",6,0,17,23
270690,"2022",8,1,16,25
270690,"2023",9,0,19,28
270700,"2015",0,0,1,1
270700,"2016",1,1,1,3
270700,"2017",1,0,1,2
270700,"2018",0,0,2,2
270700,"2019",0,0,2,2
270700,"2020",0,0,2,2
270700,"2023",0,0,1,1
270710,"2015",5,1,14,20
270710,"2016",6,0,13,19
270710,"2017",2,0,6,8
270710,"2018",3,2,10,15
270710,"2019",3,2,6,11
270710,"2020",1,1,12,14
270710,"2021",8,4,10,22
270710,"2022",6,1,14,21
270710,"2023",4,0,8,12
270720,"2015",2,1,4,7
270720,"2016",2,1,0,3
270720,"2017",0,1,4,5
270720,"2018",0,2,1,3
270720,"2019",3,2,4,9
270720,"2020",2,1,3,6
270720,"2021",2,1,6,9
270720,"2022",2,0,1,3
270720,"2023",2,0,3,5
270730,"2015",3,0,20,23
270730,"2016",7,2,29,38
270730,"2017",5,0,15,20
270730,"2018",6,0,21,27
270730,"2019",7,1,16,24
270730,"2020",5,3,16,24
270730,"2021",3,4,8,15
270730,"2022",3,0,7,10
270730,"2023",0,1,3,4
270740,"2015",1,0,9,10
270740,"2016",1,0,1,2
270740,"2017",3,0,4,7
270740,"2018",4,0,5,9
270740,"2019",4,0,0,4
270740,"2020",0,1,5,6
270740,"2021",1,0,1,2
270740,"2022",0,0,7,7
270740,"2023",0,0,1,1
270750,"2015",3,3,10,16
270750,"2016",2,1,17,20
270750,"2017",8,2,14,24
270750,"2018",6,1,10,17
270750,"2019",5,2,12,19
270750,"2020",5,1,5,11
270750,"2021",4,0,11,15
270750,"2022",2,1,7,10
270750,"2023",2,1,4,7
270760,"2015",2,1,9,12
270760,"2016",4,1,5,10
270760,"2017",6,1,11,18
270760,"2018",3,0,8,11
270760,"2019",1,1,6,8
270760,"2020",1,1,12,14
270760,"2021",2,0,4,6
270760,"2022",1,1,7,9
270760,"2023",2,1,2,5
270770,"2015",16,2,49,67
270770,"2016",13,6,56,75
270770,"2017",23,4,67,94
270770,"2018",20,6,42,68
270770,"2019",17,5,46,68
270770,"2020",21,6,50,77
270770,"2021",34,3,54,91
270770,"2022",20,4,41,65
270770,"2023",16,7,34,57
270780,"2015",0,0,7,7
270780,"2016",1,0,13,14
270780,"2017",0,0,3,3
270780,"2018",1,0,2,3
270780,"2019",1,1,3,5
270780,"2020",1,0,2,3
270780,"2021",1,1,4,6
270790,"2015",2,0,3,5
270790,"2016",1,0,7,8
270790,"2017",0,0,5,5
270790,"2018",0,0,8,8
270790,"2019",4,0,7,11
270790,"2020",1,1,8,10
270790,"2021",2,0,3,5
270790,"2022",0,0,2,2
270790,"2023",0,0,4,4
270800,"2015",13,4,24,41
270800,"2016",10,3,37,50
270800,"2017",7,2,23,32
270800,"2018",11,1,20,32
270800,"2019",13,4,12,29
270800,"2020",12,0,13,25
270800,"2021",6,7,19,32
270800,"2022",10,1,20,31
270800,"2023",8,5,17,30
270810,"2015",5,0,8,13
270810,"2016",2,0,3,5
270810,"2017",3,0,10,13
270810,"2018",1,0,7,8
270810,"2019",2,0,0,2
270810,"2020",0,0,2,2
270810,"2021",1,1,5,7
270810,"2022",2,0,1,3
270810,"2023",1,0,0,1
270820,"2015",1,0,3,4
270820,"2016",3,0,4,7
270820,"2017",3,2,6,11
270820,"2018",4,0,5,9
270820,"2019",0,1,4,5
270820,"2020",4,0,2,6
270820,"2021",2,1,2,5
270820,"2022",2,0,1,3
270820,"2023",0,0,3,3
270830,"2015",8,2,22,32
270830,"2016",5,3,20,28
270830,"2017",3,0,14,17
270830,"2018",4,0,6,10
270830,"2019",1,1,8,10
270830,"2020",3,1,11,15
270830,"2021",4,2,3,9
270830,"2022",2,1,2,5
270830,"2023",1,0,1,2
270840,"2015",5,1,17,23
270840,"2016",9,4,15,28
270840,"2017",4,2,12,18
270840,"2018",6,0,8,14
270840,"2019",6,2,9,17
270840,"2020",11,3,9,23
270840,"2021",6,1,16,23
270840,"2022",6,4,6,16
270840,"2023",4,2,13,19
270850,"2015",6,2,29,37
270850,"2016",4,1,25,30
270850,"2017",5,1,11,17
270850,"2018",6,2,19,27
270850,"2019",9,2,17,28
270850,"2020",9,0,22,31
270850,"2021",5,1,10,16
270850,"2022",5,2,13,20
270850,"2023",3,2,5,10
270860,"2015",9,2,15,26
270860,"2016",5,0,33,38
270860,"2017",14,1,38,53
270860,"2018",6,1,37,44
270860,"2019",10,2,25,37
270860,"2020",15,0,38,53
270860,"2021",14,1,20,35
270860,"2022",2,2,6,10
270860,"2023",0,0,4,4
270870,"2015",2,0,2,4
270870,"2016",1,0,1,2
270870,"2017",2,0,5,7
270870,"2018",2,2,3,7
270870,"2019",2,1,5,8
270870,"2020",1,0,7,8
270870,"2021",2,1,6,9
270870,"2022",1,0,1,2
270870,"2023",0,0,2,2
270880,"2015",5,1,29,35
270880,"2016",9,1,21,31
270880,"2017",15,2,17,34
270880,"2018",13,4,19,36
270880,"2019",5,1,17,23
270880,"2020",8,1,9,18
270880,"2021",6,0,10,16
270880,"2022",8,1,4,13
270880,"2023",4,0,3,7
270890,"2015",5,0,9,14
270890,"2016",7,2,8,17
270890,"2017",5,1,11,17
270890,"2018",7,4,11,22
270890,"2019",9,5,9,23
270890,"2020",10,1,8,19
270890,"2021",9,1,14,24
270890,"2022",6,3,2,11
270890,"2023",3,1,6,10
270895,"2015",5,0,7,12
270895,"2016",1,0,3,4
270895,"2017",3,1,3,7
270895,"2018",2,1,5,8
270895,"2019",3,0,4,7
270895,"2020",1,0,5,6
270895,"2021",4,1,5,10
270895,"2022",3,0,6,9
270895,"2023",1,0,7,8
270900,"2015",2,0,0,2
270900,"2016",1,0,5,6
270900,"2017",1,0,1,2
270900,"2018",2,1,5,8
270900,"2019",1,1,3,5
270900,"2020",0,0,5,5
270900,"2021",1,1,1,3
270900,"2022",3,0,5,8
270900,"2023",3,1,1,5
270910,"2015",5,2,8,15
270910,"2016",5,2,11,18
270910,"2017",7,1,8,16
270910,"2018",11,2,11,24
270910,"2019",9,0,6,15
270910,"2020",2,1,5,8
270910,"2021",8,2,7,17
270910,"2022",3,1,6,10
270910,"2023",5,0,0,5
270915,"2015",4,1,14,19
270915,"2016",8,0,24,32
270915,"2017",8,1,17,26
270915,"2018",4,2,21,27
270915,"2019",15,1,21,37
270915,"2020",2,1,18,21
270915,"2021",7,0,15,22
270915,"2022",1,0,2,3
270915,"2023",3,0,4,7
270920,"2015",8,3,11,22
270920,"2016",10,1,10,21
270920,"2017",4,2,12,18
270920,"2018",4,0,12,16
270920,"2019",7,1,7,15
270920,"2020",4,1,5,10
270920,"2021",4,1,7,12
270920,"2022",7,1,8,16
270920,"2023",1,0,1,2
270930,"2015",16,4,44,64
270930,"2016",14,0,59,73
270930,"2017",17,4,48,69
270930,"2018",14,0,22,36
270930,"2019",16,3,19,38
270930,"2020",9,5,15,29
270930,"2021",5,2,6,13
270930,"2022",2,0,11,13
270930,"2023",1,1,5,7
270940,"2015",4,0,7,11
270940,"2016",6,1,11,18
270940,"2017",6,2,14,22
270940,"2018",8,3,16,27
270940,"2019",5,0,13,18
270940,"2020",3,1,13,17
270940,"2021",7,3,7,17
270940,"2022",6,0,13,19
270940,"2023",5,2,6,13
280010,"2015",1,0,1,2
280010,"2016",0,3,4,7
280010,"2017",1,0,1,2
280010,"2018",2,0,5,7
280010,"2019",0,0,3,3
280010,"2020",1,0,2,3
280010,"2021",0,0,1,1
280010,"2022",0,0,1,1
280020,"2015",5,2,19,26
280020,"2016",6,1,13,20
280020,"2017",5,2,6,13
280020,"2018",8,2,5,15
280020,"2019",4,0,8,12
280020,"2020",5,0,7,12
280020,"2021",4,1,2,7
280020,"2022",3,0,5,8
280020,"2023",0,0,2,2
280030,"2015",229,40,410,679
280030,"2016",202,42,326,570
280030,"2017",193,47,336,576
280030,"2018",210,45,311,566
280030,"2019",203,43,337,583
280030,"2020",145,38,258,441
280030,"2021",146,52,223,421
280030,"2022",133,35,197,365
280030,"2023",87,26,181,294
280040,"2015",6,2,9,17
280040,"2016",1,1,6,8
280040,"2017",7,0,4,11
280040,"2018",3,0,7,10
280040,"2019",3,1,4,8
280040,"2020",1,0,8,9
280040,"2021",5,1,5,11
280040,"2022",2,2,4,8
280040,"2023",1,0,5,6
280050,"2015",9,2,11,22
280050,"2016",6,3,11,20
280050,"2017",11,1,7,19
280050,"2018",6,3,7,16
280050,"2019",7,2,14,23
280050,"2020",8,4,9,21
280050,"2021",4,1,9,14
280050,"2022",3,2,9,14
280050,"2023",0,2,2,4
280060,"2015",10,4,23,37
280060,"2016",8,0,23,31
280060,"2017",15,7,23,45
280060,"2018",7,1,23,31
280060,"2019",13,1,29,43
280060,"2020",9,1,14,24
280060,"2021",10,2,11,23
280060,"2022",9,5,15,29
280060,"2023",7,3,11,21
280067,"2015",5,1,14,20
280067,"2016",5,3,6,14
280067,"2017",7,7,15,29
280067,"2018",5,1,10,16
280067,"2019",4,3,19,26
280067,"2020",6,2,7,15
280067,"2021",8,1,6,15
280067,"2022",8,3,7,18
280067,"2023",8,1,7,16
280070,"2015",1,0,3,4
280070,"2016",2,2,5,9
280070,"2017",3,0,5,8
280070,"2018",1,1,5,7
280070,"2019",2,0,7,9
280070,"2020",2,0,6,8
280070,"2021",2,0,6,8
280070,"2022",1,0,3,4
280070,"2023",1,0,3,4
280100,"2015",8,0,13,21
280100,"2016",10,0,12,22
280100,"2017",9,2,16,27
280100,"2018",7,2,17,26
280100,"2019",11,2,14,27
280100,"2020",5,0,12,17
280100,"2021",4,5,11,20
280100,"2022",6,0,10,16
280100,"2023",5,2,7,14
280110,"2015",2,0,3,5
280110,"2016",1,0,1,2
280110,"2017",3,0,0,3
280110,"2018",0,0,2,2
280110,"2019",0,0,2,2
280110,"2020",0,1,2,3
280110,"2021",1,0,1,2
280110,"2022",0,0,3,3
280120,"2015",8,4,34,46
280120,"2016",13,0,19,32
280120,"2017",6,1,13,20
280120,"2018",2,1,10,13
280120,"2019",8,3,12,23
280120,"2020",10,3,9,22
280120,"2021",8,1,4,13
280120,"2022",3,1,17,21
280120,"2023",6,1,6,13
280130,"2015",10,2,24,36
280130,"2016",10,3,26,39
280130,"2017",10,1,29,40
280130,"2018",13,4,35,52
280130,"2019",12,4,26,42
280130,"2020",16,2,33,51
280130,"2021",19,4,19,42
280130,"2022",7,3,19,29
280130,"2023",4,1,15,20
280140,"2015",8,2,20,30
280140,"2016",5,1,19,25
280140,"2017",7,3,10,20
280140,"2018",6,2,8,16
280140,"2019",9,4,13,26
280140,"2020",13,1,15,29
280140,"2021",8,1,11,20
280140,"2022",2,3,8,13
280140,"2023",4,3,11,18
280150,"2015",5,1,14,20
280150,"2016",6,2,13,21
280150,"2017",3,0,12,15
280150,"2018",8,1,11,20
280150,"2019",6,0,13,19
280150,"2020",3,1,7,11
280150,"2021",3,1,7,11
280150,"2022",9,3,8,20
280150,"2023",2,1,3,6
280160,"2015",2,0,4,6
280160,"2016",2,0,2,4
280160,"2017",1,0,3,4
280160,"2018",3,0,4,7
280160,"2019",2,0,2,4
280160,"2020",1,0,0,1
280160,"2021",0,0,3,3
280160,"2022",3,0,0,3
280170,"2015",6,2,21,29
280170,"2016",7,2,17,26
280170,"2017",6,1,15,22
280170,"2018",8,1,10,19
280170,"2019",7,3,14,24
280170,"2020",5,1,11,17
280170,"2021",4,0,10,14
280170,"2022",4,0,8,12
280170,"2023",1,0,8,9
280190,"2015",1,0,3,4
280190,"2016",2,0,5,7
280190,"2017",0,0,2,2
280190,"2018",1,0,1,2
280190,"2019",1,0,3,4
280190,"2020",1,0,0,1
280190,"2021",2,2,0,4
280190,"2022",1,0,0,1
280200,"2015",1,0,4,5
280200,"2016",1,0,6,7
280200,"2017",0,1,5,6
280200,"2018",1,0,5,6
280200,"2019",2,1,2,5
280200,"2020",1,2,2,5
280200,"2022",0,0,1,1
280200,"2023",1,0,0,1
280210,"2015",48,7,80,135
280210,"2016",39,8,57,104
280210,"2017",29,7,59,95
280210,"2018",28,5,37,70
280210,"2019",32,11,44,87
280210,"2020",33,13,63,109
280210,"2021",21,11,58,90
280210,"2022",31,4,33,68
280210,"2023",19,7,21,47
280220,"2015",1,1,9,11
280220,"2016",2,1,6,9
280220,"2017",0,2,2,4
280220,"2018",1,0,3,4
280220,"2019",2,0,5,7
280220,"2020",0,1,2,3
280220,"2021",2,1,0,3
280220,"2022",3,0,3,6
280220,"2023",0,1,0,1
280230,"2015",7,0,18,25
280230,"2016",6,4,9,19
280230,"2017",7,0,13,20
280230,"2018",4,3,12,19
280230,"2019",5,1,16,22
280230,"2020",7,1,17,25
280230,"2021",4,1,11,16
280230,"2022",6,3,2,11
280230,"2023",5,2,5,12
280240,"2015",2,0,10,12
280240,"2016",0,1,3,4
280240,"2017",2,1,5,8
280240,"2018",0,1,6,7
280240,"2019",1,0,1,2
280240,"2020",2,0,0,2
280240,"2021",2,0,2,4
280240,"2022",1,0,2,3
280240,"2023",1,0,0,1
280250,"2017",1,0,2,3
280250,"2018",1,1,0,2
280250,"2019",3,0,0,3
280250,"2020",1,0,2,3
280250,"2021",0,0,2,2
280250,"2022",0,0,1,1
280250,"2023",1,0,1,2
280260,"2015",1,1,6,8
280260,"2016",1,0,4,5
280260,"2018",1,1,2,4
280260,"2019",2,0,2,4
280260,"2020",1,0,0,1
280260,"2021",0,0,3,3
280260,"2022",1,1,1,3
280270,"2015",1,1,2,4
280270,"2016",2,0,2,4
280270,"2017",3,0,8,11
280270,"2018",3,1,3,7
280270,"2019",4,0,6,10
280270,"2020",4,2,8,14
280270,"2021",2,3,7,12
280270,"2022",3,0,1,4
280270,"2023",3,0,3,6
280280,"2015",4,1,26,31
280280,"2016",1,0,10,11
280280,"2017",4,1,10,15
280280,"2018",2,0,7,9
280280,"2019",6,0,10,16
280280,"2020",7,0,8,15
280280,"2021",4,2,14,20
280280,"2022",4,1,7,12
280280,"2023",3,0,6,9
280290,"2015",47,11,94,152
280290,"2016",37,10,84,131
280290,"2017",58,16,84,158
280290,"2018",44,10,81,135
280290,"2019",28,9,74,111
280290,"2020",50,12,67,129
280290,"2021",33,10,60,103
280290,"2022",38,16,62,116
280290,"2023",27,4,50,81
280300,"2015",12,3,22,37
280300,"2016",12,6,20,38
280300,"2017",23,4,17,44
280300,"2018",13,2,19,34
280300,"2019",13,2,23,38
280300,"2020",15,3,28,46
280300,"2021",22,2,19,43
280300,"2022",9,1,18,28
280300,"2023",7,1,14,22
280310,"2015",1,0,2,3
280310,"2016",0,0,1,1
280310,"2019",0,0,4,4
280310,"2020",1,0,2,3
280310,"2021",0,0,1,1
280310,"2022",0,0,3,3
280310,"2023",0,0,1,1
280320,"2015",11,2,29,42
280320,"2016",12,3,22,37
280320,"2017",8,2,18,28
280320,"2018",12,0,16,28
280320,"2019",4,2,20,26
280320,"2020",10,3,20,33
280320,"2021",8,2,13,23
280320,"2022",4,1,16,21
280320,"2023",10,1,4,15
280330,"2015",2,1,14,17
280330,"2016",1,2,9,12
280330,"2017",2,2,10,14
280330,"2018",5,2,11,18
280330,"2019",9,0,9,18
280330,"2020",2,1,8,11
280330,"2021",4,0,7,11
280330,"2022",2,1,4,7
280330,"2023",0,0,4,4
280340,"2015",3,0,10,13
280340,"2016",3,0,12,15
280340,"2017",3,0,7,10
280340,"2018",5,1,7,13
280340,"2019",3,0,10,13
280340,"2020",3,1,5,9
280340,"2021",2,0,7,9
280340,"2022",5,1,7,13
280340,"2023",2,0,0,2
280350,"2015",42,15,92,149
280350,"2016",33,11,81,125
280350,"2017",52,12,76,140
280350,"2018",40,8,82,130
280350,"2019",48,17,65,130
280350,"2020",41,12,77,130
280350,"2021",39,13,72,124
280350,"2022",47,12,56,115
280350,"2023",38,5,40,83
280360,"2015",10,1,25,36
280360,"2016",7,2,22,31
280360,"2017",7,1,19,27
280360,"2018",17,0,21,38
280360,"2019",11,1,15,27
280360,"2020",8,0,12,20
280360,"2021",7,0,13,20
280360,"2022",5,1,8,14
280360,"2023",7,0,6,13
280370,"2015",4,0,5,9
280370,"2016",2,0,3,5
280370,"2017",6,1,5,12
280370,"2018",4,1,8,13
280370,"2019",3,0,5,8
280370,"2020",5,0,3,8
280370,"2021",1,1,3,5
280370,"2022",2,1,5,8
280370,"2023",0,1,3,4
280380,"2015",3,0,3,6
280380,"2016",1,0,2,3
280380,"2017",2,0,2,4
280380,"2018",2,0,2,4
280380,"2019",1,0,5,6
280380,"2020",0,0,5,5
280380,"2021",2,1,3,6
280380,"2022",0,0,1,1
280380,"2023",0,0,2,2
280390,"2015",2,1,24,27
280390,"2016",4,1,11,16
280390,"2017",10,2,9,21
280390,"2018",1,0,14,15
280390,"2019",4,4,8,16
280390,"2020",1,0,5,6
280390,"2021",3,0,6,9
280390,"2022",2,0,2,4
280390,"2023",1,1,4,6
280400,"2015",5,0,8,13
280400,"2016",5,3,17,25
280400,"2017",6,1,7,14
280400,"2018",5,1,13,19
280400,"2019",5,2,11,18
280400,"2020",3,1,10,14
280400,"2021",2,1,6,9
280400,"2022",6,0,9,15
280400,"2023",2,0,5,7
280410,"2015",4,4,3,11
280410,"2016",3,2,7,12
280410,"2017",3,1,6,10
280410,"2018",5,0,9,14
280410,"2019",4,2,4,10
280410,"2020",3,0,10,13
280410,"2021",5,0,11,16
280410,"2022",4,1,5,10
280410,"2023",1,2,3,6
280420,"2015",6,1,11,18
280420,"2016",5,0,5,10
280420,"2017",2,0,2,4
280420,"2018",6,2,7,15
280420,"2019",6,0,11,17
280420,"2020",2,0,5,7
280420,"2021",0,0,2,2
280420,"2022",5,2,4,11
280420,"2023",1,1,3,5
280430,"2015",2,0,5,7
280430,"2016",2,0,5,7
280430,"2017",3,1,3,7
280430,"2018",6,0,4,10
280430,"2019",1,1,3,5
280430,"2020",2,0,3,5
280430,"2021",2,2,3,7
280430,"2022",0,0,7,7
280430,"2023",0,0,3,3
280440,"2015",5,1,13,19
280440,"2016",1,2,14,17
280440,"2017",6,0,8,14
280440,"2018",5,1,15,21
280440,"2019",3,0,10,13
280440,"2020",5,0,10,15
280440,"2021",1,0,9,10
280440,"2022",3,0,6,9
280440,"2023",6,0,2,8
280445,"2015",2,2,7,11
280445,"2016",6,1,6,13
280445,"2017",3,0,6,9
280445,"2018",4,1,2,7
280445,"2019",2,2,5,9
280445,"2020",3,2,9,14
280445,"2021",3,3,3,9
280445,"2022",5,0,6,11
280445,"2023",2,2,3,7
280450,"2015",19,6,32,57
280450,"2016",10,3,30,43
280450,"2017",5,2,22,29
280450,"2018",14,3,29,46
280450,"2019",14,3,34,51
280450,"2020",9,1,16,26
280450,"2021",5,2,19,26
280450,"2022",9,0,15,24
280450,"2023",3,2,2,7
280460,"2015",7,1,13,21
280460,"2016",13,0,21,34
280460,"2017",4,1,22,27
280460,"2018",10,3,21,34
280460,"2019",3,0,10,13
280460,"2020",10,1,14,25
280460,"2021",9,0,9,18
280460,"2022",4,2,4,10
280460,"2023",8,0,4,12
280470,"2015",1,2,4,7
280470,"2016",0,1,4,5
280470,"2017",1,0,0,1
280470,"2018",2,1,1,4
280470,"2019",2,1,4,7
280470,"2020",1,2,2,5
280470,"2021",2,0,1,3
280470,"2022",4,0,2,6
280470,"2023",0,1,0,1
280480,"2015",106,12,210,328
280480,"2016",79,13,173,265
280480,"2017",75,19,178,272
280480,"2018",84,16,167,267
280480,"2019",85,17,139,241
280480,"2020",67,16,91,174
280480,"2021",54,15,100,169
280480,"2022",48,20,92,160
280480,"2023",42,12,47,101
280490,"2015",4,0,14,18
280490,"2016",4,0,4,8
280490,"2017",5,0,2,7
280490,"2018",3,0,6,9
280490,"2019",3,3,4,10
280490,"2020",7,1,5,13
280490,"2021",1,0,6,7
280490,"2022",0,2,8,10
280490,"2023",2,0,6,8
280500,"2015",1,0,6,7
280500,"2016",0,0,2,2
280500,"2018",0,1,4,5
280500,"2019",2,1,1,4
280500,"2020",2,0,2,4
280500,"2021",1,0,2,3
280500,"2022",2,0,3,5
280500,"2023",0,0,2,2
280510,"2015",5,1,6,12
280510,"2016",1,1,7,9
280510,"2017",1,0,5,6
280510,"2018",2,2,4,8
280510,"2019",1,1,1,3
280510,"2020",4,0,3,7
280510,"2021",2,2,3,7
280510,"2022",6,1,5,12
280510,"2023",2,0,3,5
280520,"2015",5,0,1,6
280520,"2016",2,1,4,7
280520,"2017",4,0,3,7
280520,"2018",4,0,2,6
280520,"2019",8,0,3,11
280520,"2020",2,0,5,7
280520,"2021",3,0,5,8
280520,"2022",1,3,5,9
280520,"2023",5,1,2,8
280530,"2015",3,1,8,12
280530,"2016",3,1,10,14
280530,"2017",5,3,6,14
280530,"2018",6,1,5,12
280530,"2019",2,0,3,5
280530,"2020",2,0,6,8
280530,"2021",1,1,3,5
280530,"2022",0,1,3,4
280530,"2023",1,1,1,3
280540,"2015",6,1,11,18
280540,"2016",10,1,14,25
280540,"2017",6,0,13,19
280540,"2018",11,4,12,27
280540,"2019",11,0,12,23
280540,"2020",1,1,5,7
280540,"2021",2,0,13,15
280540,"2022",5,1,7,13
280540,"2023",1,2,10,13
280550,"2015",7,1,12,20
280550,"2016",5,2,11,18
280550,"2017",8,2,18,28
280550,"2018",9,1,9,19
280550,"2019",7,2,9,18
280550,"2020",5,2,10,17
280550,"2021",6,1,10,17
280550,"2022",8,1,10,19
280550,"2023",1,0,4,5
280560,"2015",6,2,15,23
280560,"2016",5,1,7,13
280560,"2017",11,1,8,20
280560,"2018",2,1,16,19
280560,"2019",5,1,13,19
280560,"2020",6,0,8,14
280560,"2021",13,3,14,30
280560,"2022",7,4,6,17
280560,"2023",5,1,2,8
280570,"2015",14,2,28,44
280570,"2016",13,3,31,47
280570,"2017",8,0,18,26
280570,"2018",10,5,18,33
280570,"2019",11,1,21,33
280570,"2020",6,3,20,29
280570,"2021",13,1,17,31
280570,"2022",6,2,7,15
280570,"2023",8,1,5,14
280580,"2015",4,3,10,17
280580,"2016",10,3,11,24
280580,"2017",6,0,11,17
280580,"2018",5,3,5,13
280580,"2019",3,0,6,9
280580,"2020",5,4,12,21
280580,"2021",2,1,4,7
280580,"2022",6,4,5,15
280580,"2023",4,3,6,13
280590,"2015",1,2,5,8
280590,"2016",2,0,7,9
280590,"2017",5,0,6,11
280590,"2018",4,0,5,9
280590,"2019",3,0,4,7
280590,"2020",3,1,1,5
280590,"2021",4,1,5,10
280590,"2022",0,3,2,5
280590,"2023",0,0,1,1
280600,"2015",7,1,14,22
280600,"2016",8,5,13,26
280600,"2017",5,1,11,17
280600,"2018",13,6,8,27
280600,"2019",14,1,9,24
280600,"2020",5,1,2,8
280600,"2021",5,0,10,15
280600,"2022",3,2,5,10
280600,"2023",4,0,5,9
280610,"2015",9,0,10,19
280610,"2016",1,0,9,10
280610,"2017",2,0,5,7
280610,"2018",7,0,7,14
280610,"2019",0,0,8,8
280610,"2020",4,0,3,7
280610,"2021",5,0,3,8
280610,"2022",2,1,3,6
280610,"2023",2,1,4,7
280620,"2015",17,2,12,31
280620,"2016",8,0,11,19
280620,"2017",11,0,10,21
280620,"2018",8,2,9,19
280620,"2019",11,2,13,26
280620,"2020",11,4,15,30
280620,"2021",9,2,9,20
280620,"2022",7,2,9,18
280620,"2023",2,4,5,11
280630,"2015",7,2,12,21
280630,"2016",7,3,10,20
280630,"2017",4,2,10,16
280630,"2018",7,1,9,17
280630,"2019",4,0,16,20
280630,"2020",5,2,9,16
280630,"2021",6,0,6,12
280630,"2022",5,1,8,14
280630,"2023",4,1,6,11
280640,"2015",3,0,6,9
280640,"2016",0,0,6,6
280640,"2017",0,0,1,1
280640,"2018",0,0,6,6
280640,"2019",0,1,4,5
280640,"2020",1,0,2,3
280640,"2021",1,1,2,4
280640,"2022",3,0,5,8
280640,"2023",1,0,3,4
280650,"2015",4,0,3,7
280650,"2016",3,0,0,3
280650,"2017",3,0,1,4
280650,"2018",0,0,3,3
280650,"2020",2,0,4,6
280650,"2021",0,0,1,1
280650,"2022",1,1,1,3
280650,"2023",0,1,3,4
280660,"2015",2,0,6,8
280660,"2016",5,1,7,13
280660,"2017",3,1,6,10
280660,"2018",2,1,3,6
280660,"2019",2,1,6,9
280660,"2020",0,0,5,5
280660,"2021",1,0,2,3
280660,"2022",7,1,2,10
280660,"2023",4,1,2,7
280670,"2015",24,3,61,88
280670,"2016",26,8,54,88
280670,"2017",31,3,47,81
280670,"2018",34,8,51,93
280670,"2019",31,8,48,87
280670,"2020",28,6,36,70
280670,"2021",22,4,24,50
280670,"2022",25,2,34,61
280670,"2023",18,3,18,39
280680,"2015",2,1,7,10
280680,"2016",5,0,6,11
280680,"2017",3,1,7,11
280680,"2018",5,3,8,16
280680,"2019",2,0,8,10
280680,"2020",6,0,6,12
280680,"2021",3,1,6,10
280680,"2022",2,1,3,6
280680,"2023",1,1,3,5
280690,"2015",1,1,3,5
280690,"2016",0,0,2,2
280690,"2017",1,0,3,4
280690,"2018",0,0,2,2
280690,"2019",0,1,3,4
280690,"2020",2,0,3,5
280690,"2021",0,0,3,3
280700,"2015",1,0,2,3
280700,"2016",1,0,4,5
280700,"2017",2,0,1,3
280700,"2018",1,0,1,2
280700,"2019",2,0,2,4
280700,"2020",5,0,1,6
280700,"2021",2,0,2,4
280700,"2023",1,0,2,3
280710,"2015",9,2,36,47
280710,"2016",10,3,22,35
280710,"2017",13,2,25,40
280710,"2018",17,1,26,44
280710,"2019",13,5,23,41
280710,"2020",16,5,38,59
280710,"2021",17,8,29,54
280710,"2022",19,9,26,54
280710,"2023",14,2,9,25
280720,"2015",4,0,6,10
280720,"2016",2,0,4,6
280720,"2017",1,1,3,5
280720,"2018",3,0,6,9
280720,"2019",3,0,4,7
280720,"2020",3,0,4,7
280720,"2021",3,0,1,4
280720,"2022",0,3,2,5
280720,"2023",1,1,2,4
280730,"2015",1,0,2,3
280730,"2016",0,0,1,1
280730,"2017",1,0,0,1
280730,"2018",1,0,3,4
280730,"2019",1,0,0,1
280730,"2020",1,0,2,3
280730,"2021",2,0,1,3
280730,"2022",0,0,2,2
280730,"2023",0,0,1,1
280740,"2015",20,6,28,54
280740,"2016",14,1,22,37
280740,"2017",16,6,32,54
280740,"2018",23,7,28,58
280740,"2019",15,5,44,64
280740,"2020",17,6,20,43
280740,"2021",16,6,27,49
280740,"2022",13,3,26,42
280740,"2023",9,3,15,27
280750,"2015",7,0,12,19
280750,"2016",3,1,6,10
280750,"2017",4,2,5,11
280750,"2018",4,1,1,6
280750,"2019",5,0,6,11
280750,"2020",3,0,10,13
280750,"2021",5,1,2,8
280750,"2022",4,2,1,7
280750,"2023",1,2,4,7
280760,"2015",8,2,22,32
280760,"2016",10,0,21,31
280760,"2017",13,2,19,34
280760,"2018",9,0,19,28
280760,"2019",4,3,9,16
280760,"2020",17,3,16,36
280760,"2021",9,2,17,28
280760,"2022",6,3,7,16
280760,"2023",3,1,5,9
290010,"2016",1,1,0,2
290010,"2018",1,0,0,1
290010,"2019",1,0,1,2
290010,"2020",0,1,0,1
290010,"2021",1,0,1,2
290010,"2022",0,1,0,1
290010,"2023",0,0,1,1
290020,"2015",3,0,17,20
290020,"2016",2,2,10,14
290020,"2017",9,0,12,21
290020,"2018",6,1,6,13
290020,"2019",2,0,4,6
290020,"2020",6,1,5,12
290020,"2021",4,1,7,12
290020,"2022",3,0,8,11
290020,"2023",1,1,4,6
290030,"2015",2,0,8,10
290030,"2016",1,0,7,8
290030,"2017",2,1,4,7
290030,"2018",3,0,5,8
290030,"2019",3,0,1,4
290030,"2020",1,0,6,7
290030,"2021",1,0,1,2
290030,"2022",2,0,2,4
290030,"2023",1,1,1,3
290035,"2015",0,0,1,1
290035,"2016",2,1,0,3
290035,"2017",1,0,5,6
290035,"2018",3,0,7,10
290035,"2019",1,0,1,2
290035,"2020",1,1,2,4
290035,"2021",1,0,5,6
290035,"2022",2,0,4,6
290035,"2023",1,0,1,2
290040,"2015",1,1,4,6
290040,"2016",2,0,2,4
290040,"2017",0,0,2,2
290040,"2018",1,0,3,4
290040,"2019",2,1,1,4
290040,"2020",0,3,2,5
290040,"2021",3,0,1,4
290040,"2022",5,1,3,9
290040,"2023",1,0,2,3
290050,"2016",0,1,0,1
290050,"2017",0,0,1,1
290050,"2018",1,0,1,2
290050,"2019",2,0,1,3
290050,"2020",0,0,1,1
290060,"2015",1,0,0,1
290060,"2016",1,0,0,1
290060,"2018",1,0,0,1
290060,"2019",0,0,1,1
290060,"2020",0,0,1,1
290060,"2021",0,1,1,2
290060,"2022",1,0,0,1
290060,"2023",1,0,3,4
290070,"2015",86,8,147,241
290070,"2016",63,12,101,176
290070,"2017",74,16,136,226
290070,"2018",76,20,92,188
290070,"2019",50,14,90,154
290070,"2020",37,10,50,97
290070,"2021",21,9,23,53
290070,"2022",30,8,50,88
290070,"2023",21,11,38,70
290080,"2015",2,0,3,5
290080,"2016",1,0,1,2
290080,"2017",3,1,5,9
290080,"2018",0,0,1,1
290080,"2019",0,0,3,3
290080,"2020",1,1,0,2
290080,"2021",0,1,0,1
290080,"2022",0,1,3,4
290090,"2015",2,0,0,2
290090,"2016",1,0,3,4
290090,"2017",1,0,3,4
290090,"2018",1,0,2,3
290090,"2019",0,0,1,1
290090,"2020",0,0,1,1
290090,"2021",0,0,3,3
290090,"2022",0,0,3,3
290090,"2023",0,1,1,2
290100,"2015",5,2,12,19
290100,"2016",11,3,13,27
290100,"2017",8,2,18,28
290100,"2018",13,3,23,39
290100,"2019",16,4,13,33
290100,"2020",13,5,20,38
290100,"2021",19,1,15,35
290100,"2022",15,5,18,38
290100,"2023",11,2,11,24
290110,"2015",5,1,11,17
290110,"2016",3,1,4,8
290110,"2017",2,0,6,8
290110,"2018",4,0,5,9
290110,"2019",2,1,5,8
290110,"2020",1,1,5,7
290110,"2021",2,0,3,5
290110,"2022",4,3,2,9
290110,"2023",1,0,1,2
290115,"2015",3,1,10,14
290115,"2016",4,0,8,12
290115,"2017",4,0,11,15
290115,"2018",8,0,8,16
290115,"2019",2,4,5,11
290115,"2020",3,0,6,9
290115,"2021",0,1,9,10
290115,"2022",2,0,4,6
290115,"2023",3,2,3,8
290120,"2015",3,2,6,11
290120,"2016",2,2,5,9
290120,"2017",0,1,4,5
290120,"2018",1,1,4,6
290120,"2019",5,1,2,8
290120,"2020",4,0,3,7
290120,"2021",4,1,5,10
290120,"2022",1,3,3,7
290120,"2023",5,1,4,10
290130,"2016",1,0,0,1
290130,"2018",2,0,0,2
290130,"2019",1,0,1,2
290130,"2020",0,0,1,1
290130,"2023",0,1,1,2
290135,"2015",3,0,6,9
290135,"2016",8,2,11,21
290135,"2017",5,1,6,12
290135,"2018",3,0,5,8
290135,"2019",4,0,2,6
290135,"2020",0,0,2,2
290135,"2021",2,0,4,6
290135,"2022",2,4,7,13
290135,"2023",2,0,5,7
290140,"2015",1,1,6,8
290140,"2016",2,0,6,8
290140,"2017",3,1,2,6
290140,"2018",3,1,8,12
290140,"2019",6,0,6,12
290140,"2020",3,0,4,7
290140,"2021",3,3,10,16
290140,"2022",6,3,10,19
290140,"2023",4,2,4,10
290150,"2015",1,0,0,1
290150,"2016",2,0,2,4
290150,"2017",2,0,2,4
290150,"2018",1,1,1,3
290150,"2019",1,0,1,2
290150,"2020",3,0,1,4
290150,"2021",1,0,0,1
290150,"2022",2,2,0,4
290150,"2023",1,0,1,2
290160,"2015",0,1,6,7
290160,"2016",0,0,7,7
290160,"2017",1,0,1,2
290160,"2018",0,0,1,1
290160,"2019",0,0,1,1
290160,"2020",1,0,1,2
290160,"2021",1,0,2,3
290160,"2022",2,0,1,3
290170,"2015",0,0,2,2
290170,"2016",4,0,5,9
290170,"2017",0,0,3,3
290170,"2018",0,2,3,5
290170,"2019",0,0,4,4
290170,"2020",2,0,4,6
290170,"2021",1,0,2,3
290170,"2022",4,0,3,7
290170,"2023",0,1,1,2
290180,"2015",2,1,8,11
290180,"2016",3,1,10,14
290180,"2017",5,1,9,15
290180,"2018",3,0,6,9
290180,"2019",3,1,0,4
290180,"2020",2,1,4,7
290180,"2021",2,0,11,13
290180,"2022",2,2,9,13
290180,"2023",5,3,5,13
290190,"2015",3,1,5,9
290190,"2016",3,1,3,7
290190,"2017",4,3,5,12
290190,"2018",6,0,4,10
290190,"2019",2,0,4,6
290190,"2020",3,0,2,5
290190,"2021",2,0,0,2
290190,"2022",0,0,1,1
290190,"2023",2,0,0,2
290195,"2015",0,1,4,5
290195,"2016",0,1,0,1
290195,"2017",1,0,2,3
290195,"2018",2,1,2,5
290195,"2019",2,0,2,4
290195,"2020",0,0,4,4
290195,"2021",1,1,2,4
290195,"2022",2,0,5,7
290195,"2023",3,0,3,6
290200,"2015",3,2,7,12
290200,"2016",2,0,3,5
290200,"2017",4,0,3,7
290200,"2018",1,1,0,2
290200,"2019",3,2,6,11
290200,"2020",1,0,4,5
290200,"2021",3,1,2,6
290200,"2022",0,0,2,2
290200,"2023",1,0,1,2
290205,"2015",3,1,7,11
290205,"2016",2,0,11,13
290205,"2017",2,1,5,8
290205,"2018",5,0,7,12
290205,"2019",6,0,1,7
290205,"2020",2,1,1,4
290205,"2021",1,0,3,4
290205,"2022",1,0,2,3
290205,"2023",0,1,5,6
290210,"2015",4,1,11,16
290210,"2016",6,0,11,17
290210,"2017",5,1,13,19
290210,"2018",7,0,14,21
290210,"2019",7,3,9,19
290210,"2020",7,1,16,24
290210,"2021",6,0,11,17
290210,"2022",4,2,15,21
290210,"2023",5,1,4,10
290220,"2015",4,0,6,10
290220,"2016",9,1,3,13
290220,"2017",2,1,4,7
290220,"2018",2,1,6,9
290220,"2019",1,0,5,6
290220,"2020",1,0,0,1
290220,"2021",0,0,2,2
290220,"2022",0,1,2,3
290220,"2023",1,0,0,1
290225,"2015",1,0,1,2
290225,"2016",2,0,0,2
290225,"2017",2,0,1,3
290225,"2018",2,0,7,9
290225,"2019",1,0,3,4
290225,"2021",1,0,0,1
290225,"2022",2,1,1,4
290225,"2023",0,1,8,9
290230,"2015",1,0,4,5
290230,"2016",5,1,3,9
290230,"2017",1,0,3,4
290230,"2018",4,0,5,9
290230,"2019",4,0,4,8
290230,"2020",3,1,4,8
290230,"2021",2,1,2,5
290230,"2022",2,1,3,6
290230,"2023",4,2,5,11
290240,"2015",1,1,4,6
290240,"2016",3,1,4,8
290240,"2017",3,0,5,8
290240,"2018",3,0,1,4
290240,"2019",1,0,1,2
290240,"2020",2,0,1,3
290240,"2021",0,0,3,3
290240,"2022",0,0,1,1
290240,"2023",1,0,1,2
290250,"2015",3,0,8,11
290250,"2016",5,0,5,10
290250,"2017",2,0,8,10
290250,"2018",3,0,7,10
290250,"2019",3,1,6,10
290250,"2020",4,2,6,12
290250,"2021",3,2,7,12
290250,"2022",4,0,4,8
290250,"2023",5,2,4,11
290260,"2015",4,2,4,10
290260,"2016",2,1,5,8
290260,"2017",2,0,4,6
290260,"2018",2,0,5,7
290260,"2019",6,0,6,12
290260,"2020",4,1,4,9
290260,"2021",2,0,3,5
290260,"2022",1,0,7,8
290260,"2023",1,0,6,7
290265,"2015",0,1,8,9
290265,"2016",2,1,6,9
290265,"2017",3,0,5,8
290265,"2018",1,2,7,10
290265,"2019",3,1,5,9
290265,"2020",3,1,2,6
290265,"2021",0,0,1,1
290265,"2022",0,0,2,2
290265,"2023",3,0,1,4
290270,"2015",12,6,57,75
290270,"2016",24,4,66,94
290270,"2017",24,7,65,96
290270,"2018",25,5,54,84
290270,"2019",12,6,32,50
290270,"2020",18,5,42,65
290270,"2021",20,4,38,62
290270,"2022",6,2,17,25
290270,"2023",16,2,23,41
290280,"2015",12,2,29,43
290280,"2016",16,1,24,41
290280,"2017",27,5,22,54
290280,"2018",16,4,25,45
290280,"2019",11,2,23,36
290280,"2020",18,8,27,53
290280,"2021",8,4,16,28
290280,"2022",9,4,19,32
290280,"2023",8,5,25,38
290290,"2015",14,4,21,39
290290,"2016",5,2,10,17
290290,"2017",8,1,7,16
290290,"2018",6,1,8,15
290290,"2019",2,2,8,12
290290,"2020",6,0,4,10
290290,"2021",9,2,6,17
290290,"2022",7,1,4,12
290290,"2023",4,2,1,7
290300,"2015",3,1,5,9
290300,"2016",1,1,9,11
290300,"2017",2,1,7,10
290300,"2018",1,0,10,11
290300,"2019",7,0,9,16
290300,"2020",4,1,5,10
290300,"2021",3,0,0,3
290300,"2022",2,1,5,8
290300,"2023",1,0,0,1
290310,"2015",0,1,0,1
290310,"2016",0,0,1,1
290310,"2018",0,0,3,3
290310,"2019",1,0,1,2
290310,"2020",2,0,1,3
290310,"2021",0,0,4,4
290310,"2022",2,0,0,2
290310,"2023",2,0,1,3
290320,"2015",72,13,141,226
290320,"2016",93,21,164,278
290320,"2017",101,17,130,248
290320,"2018",84,16,106,206
290320,"2019",108,24,148,280
290320,"2020",95,22,141,258
290320,"2021",80,21,109,210
290320,"2022",99,28,116,243
290320,"2023",58,21,76,155
290323,"2015",6,0,4,10
290323,"2016",5,0,7,12
290323,"2017",4,1,8,13
290323,"2018",4,1,5,10
290323,"2019",4,2,7,13
290323,"2020",3,1,5,9
290323,"2021",2,0,1,3
290323,"2022",1,2,0,3
290323,"2023",3,0,1,4
290327,"2015",2,0,8,10
290327,"2016",0,0,4,4
290327,"2017",0,0,4,4
290327,"2018",1,0,9,10
290327,"2019",1,0,4,5
290327,"2020",0,2,1,3
290327,"2021",3,0,4,7
290327,"2022",4,0,0,4
290327,"2023",1,0,0,1
290330,"2015",1,0,1,2
290330,"2016",1,0,2,3
290330,"2017",0,0,1,1
290330,"2018",1,0,4,5
290330,"2019",1,0,2,3
290330,"2020",0,0,1,1
290330,"2021",0,0,1,1
290330,"2022",1,0,1,2
290330,"2023",0,0,2,2
290340,"2015",0,0,2,2
290340,"2016",1,0,3,4
290340,"2017",0,0,2,2
290340,"2018",3,1,3,7
290340,"2019",3,1,6,10
290340,"2020",3,1,1,5
290340,"2021",2,1,3,6
290340,"2022",1,1,5,7
290340,"2023",1,0,4,5
290350,"2015",5,1,7,13
290350,"2016",5,1,7,13
290350,"2017",2,0,5,7
290350,"2018",2,1,8,11
290350,"2019",4,2,5,11
290350,"2020",3,0,6,9
290350,"2021",3,1,4,8
290350,"2022",7,2,6,15
290350,"2023",0,0,1,1
290360,"2015",2,0,6,8
290360,"2016",1,1,3,5
290360,"2017",2,1,4,7
290360,"2018",3,1,7,11
290360,"2019",3,0,2,5
290360,"2020",1,0,0,1
290360,"2021",3,1,3,7
290360,"2022",1,0,2,3
290360,"2023",1,0,2,3
290370,"2015",5,1,3,9
290370,"2016",4,0,4,8
290370,"2017",5,0,3,8
290370,"2018",4,0,5,9
290370,"2019",5,1,3,9
290370,"2020",2,0,6,8
290370,"2021",1,1,2,4
290370,"2022",2,0,1,3
290370,"2023",5,2,2,9
290380,"2015",2,0,0,2
290380,"2020",1,0,1,2
290380,"2021",0,0,1,1
290390,"2015",27,7,58,92
290390,"2016",32,6,56,94
290390,"2017",39,7,76,122
290390,"2018",39,6,61,106
290390,"2019",38,12,71,121
290390,"2020",39,9,68,116
290390,"2021",46,8,64,118
290390,"2022",37,14,38,89
290390,"2023",23,6,25,54
290395,"2015",3,1,3,7
290395,"2016",1,0,4,5
290395,"2017",2,0,4,6
290395,"2018",1,0,0,1
290395,"2019",1,0,2,3
290395,"2020",2,0,2,4
290395,"2021",1,3,2,6
290395,"2022",3,0,2,5
290395,"2023",1,0,1,2
290400,"2015",1,0,0,1
290400,"2016",1,0,1,2
290400,"2018",1,0,4,5
290400,"2019",2,0,0,2
290400,"2020",1,0,0,1
290400,"2021",6,2,6,14
290400,"2022",3,1,5,9
290400,"2023",2,0,3,5
290405,"2015",0,0,6,6
290405,"2016",1,0,0,1
290405,"2017",1,2,1,4
290405,"2019",0,0,1,1
290405,"2020",0,1,3,4
290405,"2021",1,0,1,2
290405,"2022",0,1,0,1
290405,"2023",1,0,1,2
290410,"2015",2,0,2,4
290410,"2016",2,0,3,5
290410,"2017",4,0,7,11
290410,"2018",5,3,7,15
290410,"2019",7,2,4,13
290410,"2020",1,3,9,13
290410,"2021",3,0,5,8
290410,"2022",4,1,5,10
290410,"2023",3,1,4,8
290420,"2016",2,0,2,4
290420,"2017",1,0,2,3
290420,"2018",0,1,1,2
290420,"2019",1,1,2,4
290420,"2022",0,0,1,1
290420,"2023",0,0,2,2
290430,"2015",3,0,5,8
290430,"2016",1,1,2,4
290430,"2017",0,1,2,3
290430,"2018",2,0,4,6
290430,"2019",4,0,0,4
290430,"2020",2,0,5,7
290430,"2021",2,0,2,4
290430,"2022",2,0,3,5
290430,"2023",1,0,0,1
290440,"2015",0,0,1,1
290440,"2016",1,0,4,5
290440,"2017",1,0,3,4
290440,"2018",2,0,1,3
290440,"2019",0,0,1,1
290440,"2020",1,0,5,6
290440,"2021",1,0,2,3
290440,"2022",1,1,4,6
290440,"2023",3,1,4,8
290450,"2015",0,0,2,2
290450,"2016",1,0,1,2
290450,"2017",0,1,6,7
290450,"2018",1,0,3,4
290450,"2019",1,1,3,5
290450,"2020",1,0,1,2
290450,"2023",0,1,0,1
290460,"2015",21,7,24,52
290460,"2016",29,4,24,57
290460,"2017",25,8,22,55
290460,"2018",25,6,23,54
290460,"2019",30,7,42,79
290460,"2020",14,6,29,49
290460,"2021",13,6,28,47
290460,"2022",21,6,26,53
290460,"2023",13,7,21,41
290470,"2015",6,0,16,22
290470,"2016",3,0,10,13
290470,"2017",3,0,13,16
290470,"2018",6,0,8,14
290470,"2019",2,1,13,16
290470,"2020",1,2,5,8
290470,"2021",3,0,7,10
290470,"2022",4,0,5,9
290470,"2023",1,0,0,1
290475,"2015",9,0,16,25
290475,"2016",2,2,19,23
290475,"2017",8,0,13,21
290475,"2018",3,1,12,16
290475,"2019",8,0,3,11
290475,"2020",5,1,11,17
290475,"2021",9,3,13,25
290475,"2022",9,2,9,20
290475,"2023",7,0,8,15
290480,"2015",0,1,2,3
290480,"2017",3,0,3,6
290480,"2018",0,0,2,2
290480,"2019",0,0,6,6
290480,"2020",1,0,1,2
290480,"2021",1,0,0,1
290480,"2022",4,0,1,5
290485,"2016",2,0,1,3
290485,"2017",1,0,3,4
290485,"2018",1,0,2,3
290485,"2019",0,0,2,2
290485,"2020",0,0,1,1
290485,"2022",2,0,1,3
290485,"2023",3,1,1,5
290490,"2015",2,0,7,9
290490,"2016",2,0,4,6
290490,"2017",4,0,3,7
290490,"2018",0,1,3,4
290490,"2019",2,0,4,6
290490,"2020",3,0,2,5
290490,"2021",1,0,4,5
290490,"2022",3,0,7,10
290490,"2023",4,1,1,6
290500,"2015",4,3,6,13
290500,"2016",6,1,10,17
290500,"2017",10,1,11,22
290500,"2018",8,3,11,22
290500,"2019",12,1,10,23
290500,"2020",10,3,5,18
290500,"2021",5,1,6,12
290500,"2022",4,5,3,12
290500,"2023",2,4,2,8
290510,"2015",1,0,2,3
290510,"2016",4,0,3,7
290510,"2017",1,1,4,6
290510,"2018",2,0,3,5
290510,"2019",2,1,3,6
290510,"2020",1,2,2,5
290510,"2021",2,0,6,8
290510,"2022",1,0,2,3
290510,"2023",2,0,2,4
290515,"2015",3,1,7,11
290515,"2016",1,1,1,3
290515,"2017",1,1,1,3
290515,"2019",1,0,2,3
290515,"2020",3,1,2,6
290515,"2021",1,0,4,5
290515,"2022",1,0,2,3
290515,"2023",1,0,1,2
290520,"2015",16,5,35,56
290520,"2016",9,3,19,31
290520,"2017",10,2,13,25
290520,"2018",20,2,27,49
290520,"2019",16,3,14,33
290520,"2020",7,1,14,22
290520,"2021",14,1,16,31
290520,"2022",3,0,9,12
290520,"2023",5,1,8,14
290530,"2015",3,0,14,17
290530,"2016",3,0,8,11
290530,"2017",5,0,5,10
290530,"2018",1,0,2,3
290530,"2019",0,0,5,5
290530,"2020",3,1,8,12
290530,"2021",1,3,2,6
290530,"2022",2,0,4,6
290530,"2023",1,0,2,3
290540,"2015",9,1,16,26
290540,"2016",7,0,15,22
290540,"2017",9,0,25,34
290540,"2018",5,2,15,22
290540,"2019",9,0,18,27
290540,"2020",8,3,9,20
290540,"2021",12,2,19,33
290540,"2022",5,3,14,22
290540,"2023",5,3,4,12
290550,"2015",2,0,2,4
290550,"2016",0,1,5,6
290550,"2017",2,1,1,4
290550,"2018",1,1,2,4
290550,"2019",1,0,5,6
290550,"2020",0,0,4,4
290550,"2021",0,0,11,11
290550,"2022",3,1,4,8
290550,"2023",2,0,2,4
290560,"2015",2,0,6,8
290560,"2016",2,0,6,8
290560,"2017",1,0,13,14
290560,"2018",1,2,8,11
290560,"2019",4,3,9,16
290560,"2020",1,0,3,4
290560,"2021",2,1,4,7
290560,"2022",6,1,6,13
290560,"2023",3,2,4,9
290570,"2015",128,18,263,409
290570,"2016",136,22,205,363
290570,"2017",142,35,205,382
290570,"2018",140,32,207,379
290570,"2019",105,24,168,297
290570,"2020",94,24,150,268
290570,"2021",70,20,103,193
290570,"2022",77,17,92,186
290570,"2023",4,5,13,22
290580,"2015",7,1,8,16
290580,"2016",10,1,17,28
290580,"2017",2,3,11,16
290580,"2018",4,0,10,14
290580,"2019",11,0,11,22
290580,"2020",5,2,9,16
290580,"2021",5,2,8,15
290580,"2022",4,0,7,11
290580,"2023",4,2,8,14
290590,"2015",5,1,31,37
290590,"2016",13,4,20,37
290590,"2017",15,1,37,53
290590,"2018",16,1,16,33
290590,"2019",10,4,27,41
290590,"2020",9,3,28,40
290590,"2021",7,3,16,26
290590,"2022",18,1,21,40
290590,"2023",13,5,7,25
290600,"2015",15,3,45,63
290600,"2016",15,5,41,61
290600,"2017",32,3,50,85
290600,"2018",15,7,35,57
290600,"2019",18,6,38,62
290600,"2020",23,4,48,75
290600,"2021",25,5,50,80
290600,"2022",24,6,61,91
290600,"2023",20,8,38,66
290610,"2015",0,0,2,2
290610,"2016",0,0,1,1
290610,"2017",2,1,10,13
290610,"2018",2,0,2,4
290610,"2019",3,1,4,8
290610,"2020",1,0,0,1
290610,"2021",0,1,2,3
290610,"2022",1,0,3,4
290610,"2023",1,0,1,2
290620,"2015",3,2,15,20
290620,"2016",4,3,13,20
290620,"2017",6,0,13,19
290620,"2018",5,1,16,22
290620,"2019",6,1,16,23
290620,"2020",4,2,12,18
290620,"2021",4,0,10,14
290620,"2022",3,0,7,10
290620,"2023",1,3,3,7
290630,"2015",5,0,4,9
290630,"2016",1,0,5,6
290630,"2017",1,0,6,7
290630,"2018",7,1,15,23
290630,"2019",9,2,13,24
290630,"2020",1,1,7,9
290630,"2021",4,1,4,9
290630,"2022",8,0,6,14
290630,"2023",0,0,7,7
290640,"2015",1,0,4,5
290640,"2016",1,0,2,3
290640,"2017",1,0,3,4
290640,"2018",3,2,1,6
290640,"2019",1,0,0,1
290640,"2020",1,1,1,3
290640,"2021",2,0,3,5
290640,"2022",1,1,1,3
290640,"2023",0,0,1,1
290650,"2015",31,4,41,76
290650,"2016",19,3,25,47
290650,"2017",26,6,38,70
290650,"2018",35,7,63,105
290650,"2019",32,2,43,77
290650,"2020",32,12,52,96
290650,"2021",28,10,47,85
290650,"2022",16,7,34,57
290650,"2023",12,3,18,33
290660,"2015",1,0,0,1
290660,"2016",1,0,0,1
290660,"2017",0,0,2,2
290660,"2018",0,0,1,1
290660,"2020",0,0,1,1
290660,"2022",0,0,1,1
290670,"2015",7,0,4,11
290670,"2016",2,0,9,11
290670,"2017",2,1,9,12
290670,"2018",2,1,7,10
290670,"2019",2,0,2,4
290670,"2020",3,0,3,6
290670,"2021",3,0,9,12
290670,"2022",3,2,4,9
290670,"2023",2,2,5,9
290680,"2015",13,1,27,41
290680,"2016",8,6,35,49
290680,"2017",10,5,28,43
290680,"2018",6,0,9,15
290680,"2019",8,1,13,22
290680,"2020",3,1,10,14
290680,"2021",3,2,6,11
290680,"2022",3,0,12,15
290680,"2023",6,1,7,14
290682,"2015",5,0,12,17
290682,"2016",2,2,11,15
290682,"2017",2,1,12,15
290682,"2018",5,0,12,17
290682,"2019",7,2,4,13
290682,"2020",4,1,3,8
290682,"2021",0,3,2,5
290682,"2022",5,1,3,9
290682,"2023",0,0,4,4
290685,"2015",2,0,3,5
290685,"2016",0,0,1,1
290685,"2017",1,0,1,2
290685,"2018",1,0,2,3
290685,"2019",2,0,2,4
290685,"2020",3,0,3,6
290685,"2021",0,0,1,1
290685,"2022",4,1,0,5
290685,"2023",1,0,2,3
290687,"2015",8,3,31,42
290687,"2016",15,0,30,45
290687,"2017",16,4,27,47
290687,"2018",9,1,27,37
290687,"2019",12,1,22,35
290687,"2020",10,3,29,42
290687,"2021",15,3,16,34
290687,"2022",8,2,21,31
290687,"2023",10,1,13,24
290689,"2015",3,0,9,12
290689,"2016",3,1,4,8
290689,"2017",5,0,2,7
290689,"2018",1,1,0,2
290689,"2019",1,0,3,4
290689,"2020",1,1,1,3
290689,"2021",5,0,3,8
290689,"2022",3,0,0,3
290689,"2023",3,0,0,3
290690,"2015",6,0,7,13
290690,"2016",0,0,4,4
290690,"2017",1,0,2,3
290690,"2019",1,0,0,1
290690,"2020",0,0,1,1
290690,"2021",1,1,2,4
290690,"2022",0,1,3,4
290690,"2023",1,0,1,2
290700,"2015",1,1,3,5
290700,"2016",0,0,4,4
290700,"2017",0,0,2,2
290700,"2018",1,0,3,4
290700,"2019",0,0,2,2
290700,"2020",1,0,4,5
290700,"2022",0,0,4,4
290700,"2023",1,0,1,2
290710,"2015",1,0,0,1
290710,"2016",0,0,3,3
290710,"2017",4,0,5,9
290710,"2018",3,0,3,6
290710,"2019",1,1,0,2
290710,"2020",1,0,1,2
290710,"2021",1,0,2,3
290710,"2022",1,1,1,3
290710,"2023",3,0,2,5
290720,"2015",12,1,34,47
290720,"2016",13,6,38,57
290720,"2017",11,1,31,43
290720,"2018",15,4,32,51
290720,"2019",10,5,26,41
290720,"2020",11,2,19,32
290720,"2021",11,4,23,38
290720,"2022",17,2,24,43
290720,"2023",5,2,15,22
290730,"2015",8,3,12,23
290730,"2016",9,2,19,30
290730,"2017",6,0,12,18
290730,"2018",12,3,9,24
290730,"2019",10,1,11,22
290730,"2020",6,1,2,9
290730,"2021",9,3,5,17
290730,"2022",13,4,11,28
290730,"2023",1,1,3,5
290740,"2015",2,0,1,3
290740,"2016",0,0,1,1
290740,"2017",1,0,0,1
290740,"2018",0,0,3,3
290740,"2019",1,1,6,8
290740,"2020",1,0,0,1
290740,"2021",1,0,3,4
290740,"2022",1,0,2,3
290740,"2023",1,0,2,3
290750,"2015",22,2,27,51
290750,"2016",8,0,21,29
290750,"2017",9,5,15,29
290750,"2018",10,1,13,24
290750,"2019",7,1,8,16
290750,"2020",6,0,8,14
290750,"2021",3,3,10,16
290750,"2022",2,2,8,12
290750,"2023",6,0,4,10
290755,"2016",0,0,1,1
290755,"2018",1,0,3,4
290755,"2021",1,0,0,1
290760,"2015",2,1,8,11
290760,"2016",4,3,2,9
290760,"2017",3,0,9,12
290760,"2018",2,1,10,13
290760,"2019",5,3,10,18
290760,"2020",3,0,8,11
290760,"2021",7,0,5,12
290760,"2022",1,0,1,2
290760,"2023",0,1,1,2
290770,"2015",5,0,5,10
290770,"2016",4,0,6,10
290770,"2017",3,1,6,10
290770,"2018",3,0,5,8
290770,"2019",0,0,3,3
290770,"2020",2,0,6,8
290770,"2021",0,1,7,8
290770,"2022",2,2,7,11
290770,"2023",4,0,1,5
290780,"2015",11,0,8,19
290780,"2016",3,5,13,21
290780,"2017",9,1,13,23
290780,"2018",3,1,11,15
290780,"2019",4,1,4,9
290780,"2020",2,0,5,7
290780,"2021",5,1,9,15
290780,"2022",3,0,3,6
290780,"2023",1,1,2,4
290790,"2015",7,2,8,17
290790,"2016",4,0,14,18
290790,"2017",5,2,6,13
290790,"2018",4,1,6,11
290790,"2019",3,0,7,10
290790,"2020",3,0,5,8
290790,"2021",3,1,3,7
290790,"2022",3,0,3,6
290790,"2023",1,0,3,4
290800,"2015",3,1,8,12
290800,"2016",2,1,4,7
290800,"2017",4,2,5,11
290800,"2018",2,3,6,11
290800,"2019",2,0,2,4
290800,"2020",0,1,2,3
290800,"2021",2,0,0,2
290800,"2022",2,0,5,7
290800,"2023",1,1,3,5
290810,"2015",1,0,0,1
290810,"2016",8,0,15,23
290810,"2017",5,4,4,13
290810,"2018",1,0,3,4
290810,"2019",2,0,0,2
290810,"2020",2,0,3,5
290810,"2021",1,0,0,1
290810,"2022",0,1,1,2
290810,"2023",1,2,2,5
290820,"2015",2,0,2,4
290820,"2016",0,0,1,1
290820,"2017",2,0,0,2
290820,"2018",1,0,6,7
290820,"2019",3,1,5,9
290820,"2020",3,0,2,5
290820,"2021",1,1,0,2
290820,"2022",1,0,4,5
290820,"2023",3,1,4,8
290830,"2015",3,1,6,10
290830,"2016",3,1,8,12
290830,"2017",6,2,11,19
290830,"2018",6,1,5,12
290830,"2019",7,1,3,11
290830,"2020",2,2,7,11
290830,"2021",6,0,4,10
290830,"2022",1,1,6,8
290830,"2023",2,3,2,7
290840,"2015",19,7,43,69
290840,"2016",18,8,33,59
290840,"2017",21,9,53,83
290840,"2018",28,8,44,80
290840,"2019",20,3,48,71
290840,"2020",14,8,32,54
290840,"2021",19,3,15,37
290840,"2022",9,10,19,38
290840,"2023",12,7,21,40
290850,"2015",5,0,11,16
290850,"2016",7,1,11,19
290850,"2017",6,2,6,14
290850,"2018",5,0,15,20
290850,"2019",6,0,13,19
290850,"2020",6,1,2,9
290850,"2021",3,2,8,13
290850,"2022",8,4,10,22
290850,"2023",4,4,7,15
290860,"2015",6,4,4,14
290860,"2016",6,0,6,12
290860,"2017",7,1,9,17
290860,"2018",3,1,9,13
290860,"2019",5,0,8,13
290860,"2020",6,0,7,13
290860,"2021",4,0,10,14
290860,"2022",5,0,7,12
290860,"2023",3,1,1,5
290870,"2015",5,2,12,19
290870,"2016",4,1,4,9
290870,"2017",5,1,4,10
290870,"2018",2,1,1,4
290870,"2019",3,1,4,8
290870,"2020",0,2,2,4
290870,"2021",2,3,3,8
290870,"2022",1,1,2,4
290870,"2023",2,0,1,3
290880,"2015",3,0,0,3
290880,"2016",1,0,1,2
290880,"2017",1,0,1,2
290880,"2018",1,0,3,4
290880,"2019",0,1,0,1
290880,"2020",1,0,0,1
290880,"2021",0,1,2,3
290880,"2022",2,0,0,2
290890,"2015",3,0,5,8
290890,"2016",9,0,12,21
290890,"2017",4,0,15,19
290890,"2018",8,1,9,18
290890,"2019",6,2,13,21
290890,"2020",3,1,7,11
290890,"2021",3,1,6,10
290890,"2022",3,2,5,10
290890,"2023",7,2,9,18
290900,"2015",1,0,2,3
290900,"2016",3,0,1,4
290900,"2017",1,0,2,3
290900,"2018",0,0,1,1
290900,"2020",0,0,1,1
290900,"2021",1,0,2,3
290900,"2022",0,2,1,3
290900,"2023",0,0,3,3
290910,"2015",1,0,2,3
290910,"2016",4,0,3,7
290910,"2017",3,2,4,9
290910,"2018",0,0,4,4
290910,"2019",0,1,1,2
290910,"2020",2,0,1,3
290910,"2021",1,3,1,5
290910,"2022",6,4,5,15
290910,"2023",5,2,5,12
290920,"2015",3,1,5,9
290920,"2016",7,0,7,14
290920,"2017",4,1,9,14
290920,"2018",9,1,6,16
290920,"2019",8,1,10,19
290920,"2020",3,2,7,12
290920,"2021",4,1,4,9
290920,"2022",5,0,4,9
290920,"2023",4,1,4,9
290930,"2015",1,0,1,2
290930,"2016",1,0,2,3
290930,"2017",1,0,1,2
290930,"2018",0,0,3,3
290930,"2019",3,0,3,6
290930,"2020",2,1,3,6
290930,"2021",5,1,9,15
290930,"2022",3,1,4,8
290930,"2023",3,0,6,9
290940,"2015",4,0,2,6
290940,"2016",4,1,5,10
290940,"2017",0,0,4,4
290940,"2018",2,1,4,7
290940,"2019",6,0,2,8
290940,"2020",9,1,5,15
290940,"2021",2,1,2,5
290940,"2022",3,0,1,4
290940,"2023",2,1,3,6
290950,"2015",0,0,1,1
290950,"2016",0,2,0,2
290950,"2017",1,0,3,4
290950,"2018",0,0,1,1
290950,"2019",1,0,2,3
290950,"2021",2,0,1,3
290950,"2022",1,0,0,1
290950,"2023",1,0,0,1
290960,"2015",4,1,8,13
290960,"2016",5,4,11,20
290960,"2017",5,0,9,14
290960,"2018",4,1,2,7
290960,"2019",2,2,0,4
290960,"2020",4,1,3,8
290960,"2021",1,1,2,4
290960,"2022",4,0,7,11
290960,"2023",3,1,1,5
290970,"2015",2,1,8,11
290970,"2016",9,0,6,15
290970,"2017",1,1,3,5
290970,"2018",3,0,7,10
290970,"2019",3,0,7,10
290970,"2020",5,0,6,11
290970,"2021",9,2,4,15
290970,"2022",6,1,9,16
290970,"2023",4,2,5,11
290980,"2015",0,2,1,3
290980,"2016",2,0,4,6
290980,"2017",5,1,4,10
290980,"2018",3,0,4,7
290980,"2019",7,2,5,14
290980,"2020",1,0,1,2
290980,"2021",2,0,2,4
290980,"2022",2,2,3,7
290980,"2023",1,0,5,6
290990,"2015",8,4,19,31
290990,"2016",9,1,13,23
290990,"2017",11,2,18,31
290990,"2018",10,5,18,33
290990,"2019",9,1,10,20
290990,"2020",2,1,14,17
290990,"2021",6,0,9,15
290990,"2022",7,2,15,24
290990,"2023",1,2,9,12
291000,"2015",1,0,3,4
291000,"2016",0,0,6,6
291000,"2017",2,0,4,6
291000,"2018",2,1,1,4
291000,"2019",0,0,5,5
291000,"2020",1,0,3,4
291000,"2021",2,1,5,8
291000,"2022",3,0,5,8
291000,"2023",5,0,1,6
291005,"2015",15,1,31,47
291005,"2016",28,6,38,72
291005,"2017",25,2,38,65
291005,"2018",34,6,44,84
291005,"2019",17,4,25,46
291005,"2020",16,1,26,43
291005,"2021",18,1,23,42
291005,"2022",11,2,20,33
291005,"2023",16,4,18,38
291010,"2015",1,0,7,8
291010,"2016",0,0,3,3
291010,"2017",3,0,6,9
291010,"2018",1,1,1,3
291010,"2019",4,0,3,7
291010,"2020",1,0,0,1
291010,"2021",1,0,1,2
291010,"2022",1,1,2,4
291010,"2023",0,0,2,2
291020,"2015",1,0,1,2
291020,"2016",1,0,2,3
291020,"2017",3,1,0,4
291020,"2018",0,1,2,3
291020,"2019",4,0,4,8
291020,"2020",2,3,1,6
291020,"2021",1,0,5,6
291020,"2022",0,1,1,2
291020,"2023",0,2,2,4
291030,"2015",1,1,4,6
291030,"2016",0,0,4,4
291030,"2017",4,1,5,10
291030,"2018",0,1,2,3
291030,"2019",5,2,1,8
291030,"2020",2,1,1,4
291030,"2021",1,0,2,3
291030,"2022",4,1,3,8
291030,"2023",4,1,3,8
291040,"2015",4,3,9,16
291040,"2016",4,0,4,8
291040,"2017",0,2,3,5
291040,"2018",4,0,7,11
291040,"2019",4,1,4,9
291040,"2020",4,0,4,8
291040,"2021",2,1,4,7
291040,"2022",2,2,6,10
291040,"2023",0,0,3,3
291050,"2015",9,2,18,29
291050,"2016",5,0,15,20
291050,"2017",7,0,14,21
291050,"2018",5,0,14,19
291050,"2019",3,1,8,12
291050,"2020",2,0,9,11
291050,"2021",1,1,4,6
291050,"2022",4,2,7,13
291050,"2023",5,0,4,9
291060,"2015",8,2,13,23
291060,"2016",2,2,8,12
291060,"2017",6,0,17,23
291060,"2018",2,1,6,9
291060,"2019",7,2,10,19
291060,"2020",3,0,6,9
291060,"2021",6,2,10,18
291060,"2022",4,0,2,6
291060,"2023",0,1,2,3
291070,"2015",18,5,34,57
291070,"2016",29,4,55,88
291070,"2017",23,5,55,83
291070,"2018",31,7,51,89
291070,"2019",31,10,43,84
291070,"2020",29,7,39,75
291070,"2021",22,4,29,55
291070,"2022",16,5,22,43
291070,"2023",10,4,15,29
291072,"2015",20,5,61,86
291072,"2016",26,4,54,84
291072,"2017",17,3,50,70
291072,"2018",19,8,43,70
291072,"2019",14,3,37,54
291072,"2020",26,2,37,65
291072,"2021",13,6,27,46
291072,"2022",27,2,29,58
291072,"2023",12,5,27,44
291075,"2015",5,1,4,10
291075,"2016",0,0,6,6
291075,"2017",1,1,5,7
291075,"2018",4,0,2,6
291075,"2019",4,0,2,6
291075,"2020",3,0,3,6
291075,"2021",3,1,5,9
291075,"2022",4,0,3,7
291075,"2023",0,1,3,4
291077,"2016",0,0,1,1
291077,"2017",1,0,0,1
291077,"2019",0,1,2,3
291077,"2020",1,0,0,1
291077,"2023",1,0,0,1
291080,"2015",259,39,488,786
291080,"2016",331,76,561,968
291080,"2017",343,66,495,904
291080,"2018",326,74,466,866
291080,"2019",263,74,334,671
291080,"2020",204,64,285,553
291080,"2021",205,67,312,584
291080,"2022",201,72,304,577
291080,"2023",167,41,252,460
291085,"2015",2,0,7,9
291085,"2016",4,2,10,16
291085,"2017",7,2,7,16
291085,"2018",5,2,11,18
291085,"2019",5,1,12,18
291085,"2020",3,2,11,16
291085,"2021",11,0,8,19
291085,"2022",3,1,9,13
291085,"2023",2,3,6,11
291090,"2015",0,0,1,1
291090,"2016",0,0,2,2
291090,"2018",1,0,1,2
291090,"2019",0,0,1,1
291090,"2021",0,0,1,1
291090,"2022",1,0,0,1
291090,"2023",1,0,0,1
291100,"2015",1,0,2,3
291100,"2016",0,1,6,7
291100,"2017",1,0,3,4
291100,"2018",1,2,4,7
291100,"2019",1,0,2,3
291100,"2020",0,0,1,1
291100,"2021",3,0,1,4
291100,"2022",3,0,3,6
291100,"2023",1,1,1,3
291110,"2015",5,0,10,15
291110,"2016",1,0,10,11
291110,"2017",5,1,6,12
291110,"2018",1,1,7,9
291110,"2019",5,0,2,7
291110,"2020",9,0,6,15
291110,"2021",8,4,6,18
291110,"2022",1,1,10,12
291110,"2023",5,0,12,17
291120,"2015",13,4,25,42
291120,"2016",13,2,25,40
291120,"2017",19,1,31,51
291120,"2018",9,0,30,39
291120,"2019",5,0,20,25
291120,"2020",10,5,21,36
291120,"2021",9,1,23,33
291120,"2022",14,1,8,23
291120,"2023",8,0,6,14
291125,"2015",0,0,1,1
291125,"2016",0,0,1,1
291125,"2017",1,0,1,2
291125,"2018",0,0,1,1
291125,"2019",0,0,1,1
291125,"2021",1,0,1,2
291125,"2022",0,0,2,2
291125,"2023",0,0,2,2
291130,"2015",1,0,3,4
291130,"2016",1,0,6,7
291130,"2017",4,2,2,8
291130,"2018",2,1,6,9
291130,"2019",3,1,2,6
291130,"2020",3,1,9,13
291130,"2021",2,0,3,5
291130,"2022",0,3,2,5
291130,"2023",0,0,1,1
291140,"2015",3,1,11,15
291140,"2016",4,2,16,22
291140,"2017",6,2,9,17
291140,"2018",7,0,9,16
291140,"2020",2,2,3,7
291140,"2021",1,0,6,7
291140,"2022",7,0,3,10
291140,"2023",5,1,4,10
291150,"2015",0,0,1,1
291150,"2016",0,0,3,3
291150,"2017",0,1,2,3
291150,"2018",0,0,4,4
291150,"2019",0,1,1,2
291150,"2020",2,0,3,5
291150,"2021",1,0,1,2
291150,"2022",0,0,1,1
291160,"2015",1,0,1,2
291160,"2016",1,0,2,3
291160,"2018",0,0,3,3
291160,"2019",1,1,0,2
291160,"2020",0,0,1,1
291160,"2021",0,0,1,1
291160,"2022",1,0,0,1
291160,"2023",2,2,1,5
291165,"2015",0,0,1,1
291165,"2016",2,2,1,5
291165,"2017",2,0,1,3
291165,"2018",0,0,2,2
291165,"2019",2,1,0,3
291165,"2020",3,1,1,5
291165,"2021",1,0,2,3
291165,"2022",0,0,1,1
291165,"2023",2,0,0,2
291170,"2015",1,0,2,3
291170,"2016",0,1,2,3
291170,"2017",0,0,1,1
291170,"2018",1,1,1,3
291170,"2019",5,0,0,5
291170,"2020",3,0,6,9
291170,"2021",3,0,3,6
291170,"2022",3,2,1,6
291170,"2023",1,1,2,4
291180,"2015",3,0,4,7
291180,"2016",1,0,3,4
291180,"2017",1,0,3,4
291180,"2018",0,0,1,1
291180,"2019",2,1,2,5
291180,"2020",1,0,0,1
291180,"2021",1,0,1,2
291180,"2022",3,1,2,6
291180,"2023",1,0,2,3
291185,"2015",2,2,4,8
291185,"2016",4,2,3,9
291185,"2017",1,1,2,4
291185,"2018",5,0,4,9
291185,"2019",0,0,2,2
291185,"2020",0,1,4,5
291185,"2021",1,0,0,1
291185,"2022",4,0,3,7
291185,"2023",1,0,2,3
291190,"2016",0,1,1,2
291190,"2017",2,1,6,9
291190,"2018",1,0,2,3
291190,"2019",5,0,6,11
291190,"2020",3,0,2,5
291190,"2021",2,1,1,4
291190,"2022",0,1,1,2
291190,"2023",1,0,1,2
291200,"2015",3,0,2,5
291200,"2016",0,1,0,1
291200,"2017",0,3,3,6
291200,"2018",2,2,4,8
291200,"2019",1,1,4,6
291200,"2020",5,2,3,10
291200,"2021",7,2,3,12
291200,"2022",3,1,0,4
291200,"2023",1,0,0,1
291210,"2015",4,0,9,13
291210,"2016",1,0,7,8
291210,"2017",3,2,6,11
291210,"2018",6,1,12,19
291210,"2019",5,3,6,14
291210,"2020",2,0,1,3
291210,"2021",0,0,3,3
291210,"2022",2,1,1,4
291210,"2023",0,0,1,1
291220,"2015",5,2,27,34
291220,"2016",9,0,27,36
291220,"2017",12,2,20,34
291220,"2018",13,3,23,39
291220,"2019",18,1,15,34
291220,"2020",11,4,16,31
291220,"2021",8,1,19,28
291220,"2022",12,2,13,27
291220,"2023",9,1,13,23
291230,"2015",0,0,4,4
291230,"2016",0,0,1,1
291230,"2017",1,0,1,2
291230,"2018",1,0,3,4
291230,"2019",0,0,1,1
291230,"2020",1,0,2,3
291230,"2021",1,0,0,1
291230,"2023",0,0,1,1
291240,"2015",1,0,1,2
291240,"2016",0,0,2,2
291240,"2017",2,0,4,6
291240,"2018",4,0,4,8
291240,"2019",2,2,3,7
291240,"2020",1,0,3,4
291240,"2021",0,3,3,6
291240,"2022",1,0,3,4
291240,"2023",1,0,0,1
291250,"2016",1,0,0,1
291250,"2017",0,1,2,3
291250,"2018",3,1,3,7
291250,"2019",3,0,3,6
291250,"2020",0,0,1,1
291250,"2022",0,0,1,1
291250,"2023",0,0,3,3
291260,"2016",0,0,1,1
291260,"2018",0,0,1,1
291260,"2019",1,0,1,2
291270,"2015",7,0,12,19
291270,"2016",7,1,4,12
291270,"2017",4,1,6,11
291270,"2018",3,1,7,11
291270,"2019",2,0,4,6
291270,"2020",3,1,3,7
291270,"2021",2,0,3,5
291270,"2022",2,0,4,6
291270,"2023",1,0,3,4
291280,"2021",1,0,0,1
291280,"2022",1,0,1,2
291280,"2023",1,0,0,1
291290,"2015",2,1,5,8
291290,"2016",4,0,12,16
291290,"2017",5,1,10,16
291290,"2018",7,0,9,16
291290,"2019",3,0,13,16
291290,"2020",1,1,6,8
291290,"2021",3,2,4,9
291290,"2022",3,0,1,4
291290,"2023",3,3,5,11
291300,"2015",1,0,2,3
291300,"2016",2,0,1,3
291300,"2017",0,0,2,2
291300,"2019",0,1,0,1
291300,"2020",2,1,2,5
291300,"2021",1,1,3,5
291300,"2022",2,3,4,9
291300,"2023",1,0,3,4
291310,"2015",2,0,6,8
291310,"2016",2,0,3,5
291310,"2017",5,0,3,8
291310,"2018",1,0,7,8
291310,"2019",3,0,3,6
291310,"2020",2,1,3,6
291310,"2021",1,1,2,4
291310,"2022",4,2,1,7
291310,"2023",1,0,2,3
291320,"2015",20,1,52,73
291320,"2016",27,3,43,73
291320,"2017",15,0,26,41
291320,"2018",11,2,36,49
291320,"2019",21,4,36,61
291320,"2020",17,7,23,47
291320,"2021",26,11,40,77
291320,"2022",16,3,24,43
291320,"2023",15,2,23,40
291330,"2015",1,0,0,1
291330,"2017",0,0,3,3
291330,"2018",1,0,2,3
291330,"2019",0,0,2,2
291330,"2022",1,0,1,2
291340,"2015",0,0,3,3
291340,"2016",2,0,3,5
291340,"2017",1,0,0,1
291340,"2020",1,0,0,1
291340,"2021",0,1,2,3
291340,"2022",0,1,1,2
291340,"2023",0,1,1,2
291345,"2015",1,0,4,5
291345,"2016",5,1,6,12
291345,"2017",5,0,8,13
291345,"2018",1,0,6,7
291345,"2019",0,0,4,4
291345,"2020",3,3,4,10
291345,"2021",3,0,7,10
291345,"2022",0,0,2,2
291345,"2023",0,0,4,4
291350,"2015",1,1,1,3
291350,"2016",0,0,1,1
291350,"2017",2,0,0,2
291350,"2018",0,0,1,1
291350,"2019",0,0,1,1
291350,"2022",1,0,1,2
291350,"2023",1,0,0,1
291360,"2015",19,5,36,60
291360,"2016",19,3,26,48
291360,"2017",15,3,34,52
291360,"2018",23,3,63,89
291360,"2019",81,11,125,217
291360,"2020",54,9,94,157
291360,"2021",67,16,120,203
291360,"2022",43,9,89,141
291360,"2023",32,9,40,81
291370,"2015",7,3,20,30
291370,"2016",3,0,19,22
291370,"2017",11,1,19,31
291370,"2018",9,1,8,18
291370,"2019",11,6,7,24
291370,"2020",4,1,8,13
291370,"2021",2,1,5,8
291370,"2022",4,1,11,16
291370,"2023",5,2,2,9
291380,"2015",3,0,1,4
291380,"2016",1,0,4,5
291380,"2017",7,0,6,13
291380,"2018",2,1,0,3
291380,"2019",3,3,1,7
291380,"2020",0,1,2,3
291380,"2021",1,0,1,2
291380,"2022",1,0,4,5
291390,"2015",11,0,21,32
291390,"2016",12,0,16,28
291390,"2017",17,4,22,43
291390,"2018",20,6,23,49
291390,"2019",11,3,19,33
291390,"2020",13,4,16,33
291390,"2021",13,2,16,31
291390,"2022",12,4,22,38
291390,"2023",1,3,12,16
291400,"2015",16,3,39,58
291400,"2016",24,3,38,65
291400,"2017",6,0,9,15
291400,"2018",3,1,3,7
291400,"2019",1,0,2,3
291400,"2020",6,0,5,11
291400,"2021",14,8,14,36
291400,"2022",18,11,28,57
291400,"2023",22,13,16,51
291410,"2015",0,0,2,2
291410,"2016",1,0,0,1
291410,"2017",0,1,1,2
291410,"2018",0,0,2,2
291410,"2021",1,0,1,2
291410,"2022",1,0,1,2
291410,"2023",1,0,2,3
291420,"2015",0,0,4,4
291420,"2016",0,1,6,7
291420,"2017",2,1,6,9
291420,"2018",0,0,3,3
291420,"2019",1,0,1,2
291420,"2020",0,0,1,1
291420,"2021",1,1,2,4
291420,"2022",1,0,0,1
291420,"2023",1,0,2,3
291430,"2015",1,0,5,6
291430,"2016",4,0,2,6
291430,"2017",3,0,4,7
291430,"2018",5,0,5,10
291430,"2019",3,0,1,4
291430,"2020",0,0,3,3
291430,"2021",1,0,1,2
291430,"2022",1,0,6,7
291430,"2023",4,1,2,7
291440,"2015",0,0,1,1
291440,"2016",2,0,0,2
291440,"2017",0,0,1,1
291440,"2018",13,2,37,52
291440,"2019",13,2,25,40
291440,"2020",17,6,24,47
291440,"2021",10,2,20,32
291440,"2022",10,1,10,21
291440,"2023",7,1,17,25
291450,"2015",8,2,12,22
291450,"2016",6,3,6,15
291450,"2017",8,3,13,24
291450,"2018",1,1,8,10
291450,"2019",3,0,4,7
291450,"2020",2,3,5,10
291450,"2021",8,2,6,16
291450,"2022",5,1,6,12
291450,"2023",5,1,5,11
291460,"2015",45,9,61,115
291460,"2016",38,8,52,98
291460,"2017",54,5,81,140
291460,"2018",46,14,73,133
291460,"2019",41,15,48,104
291460,"2020",32,5,49,86
291460,"2021",33,8,40,81
291460,"2022",27,7,43,77
291460,"2023",20,2,32,54
291465,"2015",3,1,13,17
291465,"2016",2,0,7,9
291465,"2017",3,0,5,8
291465,"2018",3,3,10,16
291465,"2019",4,2,9,15
291465,"2020",3,0,5,8
291465,"2021",1,0,8,9
291465,"2022",3,1,9,13
291465,"2023",1,1,4,6
291470,"2015",0,0,1,1
291470,"2016",1,0,2,3
291470,"2017",2,0,2,4
291470,"2018",0,1,2,3
291470,"2019",0,0,1,1
291470,"2020",1,0,3,4
291470,"2021",1,0,2,3
291470,"2022",0,0,1,1
291470,"2023",0,1,0,1
291480,"2015",62,10,157,229
291480,"2016",54,16,161,231
291480,"2017",56,15,140,211
291480,"2018",87,15,148,250
291480,"2019",49,12,66,127
291480,"2020",21,5,34,60
291480,"2021",34,16,78,128
291480,"2022",31,12,46,89
291480,"2023",16,8,25,49
291490,"2015",0,0,2,2
291490,"2016",1,0,3,4
291490,"2017",2,0,1,3
291490,"2018",4,1,5,10
291490,"2019",9,2,10,21
291490,"2020",4,0,13,17
291490,"2021",5,1,11,17
291490,"2022",3,2,8,13
291490,"2023",3,0,5,8
291500,"2016",0,0,1,1
291500,"2020",0,0,1,1
291510,"2015",2,0,7,9
291510,"2016",0,0,6,6
291510,"2017",4,1,10,15
291510,"2018",1,1,6,8
291510,"2019",2,1,3,6
291510,"2020",4,0,5,9
291510,"2021",1,0,3,4
291510,"2022",1,0,6,7
291510,"2023",2,0,1,3
291520,"2015",4,0,8,12
291520,"2016",1,0,8,9
291520,"2017",2,0,9,11
291520,"2018",2,0,3,5
291520,"2019",3,0,5,8
291520,"2020",4,0,5,9
291520,"2021",5,3,5,13
291520,"2022",2,2,0,4
291520,"2023",1,0,2,3
291530,"2016",1,0,3,4
291530,"2017",0,1,1,2
291530,"2018",3,1,1,5
291530,"2019",1,0,0,1
291530,"2020",0,0,2,2
291530,"2021",1,0,0,1
291530,"2022",0,1,1,2
291535,"2015",1,0,5,6
291535,"2016",1,0,5,6
291535,"2017",2,0,12,14
291535,"2018",5,0,8,13
291535,"2019",6,0,5,11
291535,"2020",2,0,8,10
291535,"2021",0,0,4,4
291535,"2022",2,0,3,5
291535,"2023",0,0,5,5
291540,"2015",0,0,2,2
291540,"2016",0,1,2,3
291540,"2017",1,0,2,3
291540,"2018",2,0,4,6
291540,"2019",2,0,1,3
291540,"2020",0,0,1,1
291540,"2021",1,0,0,1
291540,"2022",0,0,1,1
291540,"2023",0,0,1,1
291550,"2015",2,1,9,12
291550,"2016",9,1,7,17
291550,"2017",3,1,10,14
291550,"2018",6,2,9,17
291550,"2019",6,1,4,11
291550,"2020",3,0,3,6
291550,"2021",1,0,7,8
291550,"2022",5,0,4,9
291550,"2023",1,0,1,2
291560,"2015",4,0,19,23
291560,"2016",10,0,18,28
291560,"2017",8,0,9,17
291560,"2018",7,1,17,25
291560,"2019",9,1,11,21
291560,"2020",6,1,8,15
291560,"2021",8,1,15,24
291560,"2022",5,1,13,19
291560,"2023",2,1,7,10
291570,"2015",1,0,4,5
291570,"2016",2,0,1,3
291570,"2017",2,0,5,7
291570,"2018",1,0,2,3
291570,"2019",2,0,3,5
291570,"2020",5,0,2,7
291570,"2021",4,0,5,9
291570,"2022",3,1,1,5
291570,"2023",2,0,0,2
291580,"2015",5,2,12,19
291580,"2016",2,2,11,15
291580,"2017",2,2,10,14
291580,"2018",2,0,5,7
291580,"2019",4,3,2,9
291580,"2020",3,3,3,9
291580,"2021",1,0,5,6
291580,"2022",0,0,1,1
291580,"2023",2,3,3,8
291590,"2015",1,0,0,1
291590,"2016",0,1,3,4
291590,"2017",0,0,2,2
291590,"2018",2,0,1,3
291590,"2019",1,0,1,2
291590,"2021",1,0,3,4
291600,"2015",4,2,7,13
291600,"2016",2,1,8,11
291600,"2017",4,0,4,8
291600,"2018",1,0,10,11
291600,"2019",1,0,5,6
291600,"2020",0,1,2,3
291600,"2021",0,1,1,2
291600,"2022",5,0,3,8
291600,"2023",0,0,3,3
291610,"2015",8,2,17,27
291610,"2016",8,1,20,29
291610,"2017",9,4,11,24
291610,"2018",10,4,16,30
291610,"2019",8,2,22,32
291610,"2020",12,3,10,25
291610,"2021",7,3,17,27
291610,"2022",11,1,17,29
291610,"2023",12,0,7,19
291620,"2015",1,0,4,5
291620,"2016",4,0,6,10
291620,"2018",1,0,5,6
291620,"2019",2,1,5,8
291620,"2020",0,1,1,2
291620,"2021",4,0,2,6
291620,"2022",1,3,1,5
291620,"2023",1,0,0,1
291630,"2015",1,1,1,3
291630,"2016",1,0,1,2
291630,"2017",1,0,0,1
291630,"2018",0,0,1,1
291630,"2020",1,0,2,3
291630,"2021",0,1,0,1
291630,"2022",0,1,3,4
291640,"2015",19,5,59,83
291640,"2016",15,4,50,69
291640,"2017",10,2,38,50
291640,"2018",16,2,26,44
291640,"2019",5,1,24,30
291640,"2020",11,1,21,33
291640,"2021",8,4,19,31
291640,"2022",13,3,26,42
291640,"2023",7,2,9,18
291650,"2015",2,2,12,16
291650,"2016",7,1,3,11
291650,"2017",3,3,3,9
291650,"2018",3,0,14,17
291650,"2019",6,0,7,13
291650,"2020",3,0,7,10
291650,"2021",5,1,4,10
291650,"2022",2,1,4,7
291650,"2023",2,0,1,3
291660,"2015",1,0,4,5
291660,"2016",0,1,0,1
291660,"2017",0,0,1,1
291660,"2018",0,0,5,5
291660,"2019",1,0,5,6
291660,"2020",0,0,1,1
291660,"2021",0,0,1,1
291660,"2022",0,0,1,1
291670,"2015",4,0,5,9
291670,"2016",2,0,6,8
291670,"2017",2,2,3,7
291670,"2018",7,1,4,12
291670,"2019",1,1,3,5
291670,"2020",1,2,6,9
291670,"2021",0,0,1,1
291670,"2022",1,0,2,3
291680,"2015",2,0,4,6
291680,"2016",4,1,6,11
291680,"2017",2,0,6,8
291680,"2018",2,1,3,6
291680,"2019",3,1,0,4
291680,"2020",0,0,2,2
291680,"2021",2,0,1,3
291680,"2022",1,0,5,6
291680,"2023",1,0,1,2
291685,"2015",1,0,8,9
291685,"2016",1,2,9,12
291685,"2017",3,0,3,6
291685,"2018",5,1,5,11
291685,"2019",3,4,5,12
291685,"2020",2,0,5,7
291685,"2021",6,1,6,13
291685,"2022",4,0,2,6
291685,"2023",2,1,5,8
291690,"2015",4,0,6,10
291690,"2016",5,2,3,10
291690,"2017",2,0,6,8
291690,"2018",5,3,2,10
291690,"2019",3,1,5,9
291690,"2020",1,0,4,5
291690,"2021",3,0,5,8
291690,"2022",2,1,0,3
291690,"2023",2,1,1,4
291700,"2015",3,2,4,9
291700,"2016",5,0,7,12
291700,"2017",5,0,15,20
291700,"2018",8,5,17,30
291700,"2019",7,2,14,23
291700,"2020",9,0,17,26
291700,"2021",6,2,13,21
291700,"2022",11,2,11,24
291700,"2023",6,5,13,24
291710,"2015",0,0,4,4
291710,"2016",2,0,7,9
291710,"2017",3,0,7,10
291710,"2018",2,0,4,6
291710,"2019",4,0,4,8
291710,"2020",1,0,6,7
291710,"2021",1,0,5,6
291710,"2022",5,0,9,14
291710,"2023",2,0,2,4
291720,"2015",9,4,12,25
291720,"2016",6,2,9,17
291720,"2017",8,1,3,12
291720,"2018",5,1,7,13
291720,"2019",0,1,8,9
291720,"2020",3,1,8,12
291720,"2021",3,1,10,14
291720,"2022",0,1,2,3
291720,"2023",2,0,1,3
291730,"2015",8,1,16,25
291730,"2016",7,0,24,31
291730,"2017",7,0,16,23
291730,"2018",8,1,21,30
291730,"2019",7,0,6,13
291730,"2020",3,1,5,9
291730,"2021",4,3,12,19
291730,"2022",4,1,3,8
291730,"2023",5,0,3,8
291733,"2016",1,0,0,1
291733,"2018",1,0,0,1
291733,"2023",0,1,0,1
291735,"2015",3,0,0,3
291735,"2017",3,0,1,4
291735,"2018",0,1,4,5
291735,"2019",1,0,1,2
291735,"2020",2,0,5,7
291735,"2021",2,0,1,3
291735,"2022",1,1,3,5
291735,"2023",0,0,1,1
291740,"2015",0,0,1,1
291740,"2017",0,0,1,1
291740,"2018",1,0,0,1
291740,"2020",1,0,0,1
291740,"2021",1,0,0,1
291740,"2022",1,0,0,1
291750,"2015",26,8,52,86
291750,"2016",30,7,44,81
291750,"2017",39,8,55,102
291750,"2018",38,4,74,116
291750,"2019",27,5,82,114
291750,"2020",36,10,83,129
291750,"2021",56,16,63,135
291750,"2022",37,15,64,116
291750,"2023",11,4,15,30
291760,"2015",9,2,21,32
291760,"2016",21,2,32,55
291760,"2017",37,1,43,81
291760,"2018",25,7,51,83
291760,"2019",17,4,29,50
291760,"2020",20,3,24,47
291760,"2021",19,6,26,51
291760,"2022",8,5,27,40
291760,"2023",12,8,13,33
291770,"2015",11,4,24,39
291770,"2016",10,1,15,26
291770,"2017",4,1,13,18
291770,"2018",10,0,12,22
291770,"2019",7,2,9,18
291770,"2020",4,3,11,18
291770,"2021",5,3,16,24
291770,"2022",3,2,15,20
291770,"2023",5,1,5,11
291780,"2015",1,0,6,7
291780,"2016",6,2,11,19
291780,"2017",6,3,4,13
291780,"2018",5,2,4,11
291780,"2019",3,4,5,12
291780,"2020",4,1,9,14
291780,"2021",5,2,9,16
291780,"2022",8,1,4,13
291780,"2023",4,1,4,9
291790,"2015",3,0,5,8
291790,"2016",5,0,3,8
291790,"2017",2,1,2,5
291790,"2018",3,1,8,12
291790,"2019",7,0,6,13
291790,"2020",2,1,5,8
291790,"2021",2,1,4,7
291790,"2022",0,1,4,5
291790,"2023",3,0,4,7
291800,"2015",52,4,105,161
291800,"2016",49,5,76,130
291800,"2017",71,13,118,202
291800,"2018",72,21,99,192
291800,"2019",48,12,86,146
291800,"2020",49,10,63,122
291800,"2021",40,7,54,101
291800,"2022",46,17,69,132
291800,"2023",30,11,43,84
291810,"2015",6,3,17,26
291810,"2016",3,0,11,14
291810,"2017",7,1,10,18
291810,"2018",6,1,19,26
291810,"2019",1,0,2,3
291810,"2020",6,1,8,15
291810,"2021",9,1,8,18
291810,"2022",5,1,8,14
291810,"2023",6,1,4,11
291820,"2015",2,0,6,8
291820,"2016",3,0,7,10
291820,"2017",1,1,9,11
291820,"2018",1,0,5,6
291820,"2019",5,1,5,11
291820,"2020",4,0,7,11
291820,"2021",1,1,7,9
291820,"2022",4,0,5,9
291820,"2023",1,0,2,3
291830,"2015",2,1,2,5
291830,"2016",0,0,3,3
291830,"2017",4,1,7,12
291830,"2018",3,0,4,7
291830,"2019",4,0,3,7
291830,"2020",5,0,7,12
291830,"2021",1,0,3,4
291830,"2022",3,3,6,12
291830,"2023",2,0,4,6
291835,"2015",6,1,9,16
291835,"2016",3,0,15,18
291835,"2017",5,3,16,24
291835,"2018",7,2,15,24
291835,"2019",7,1,10,18
291835,"2020",4,1,8,13
291835,"2021",4,1,4,9
291835,"2022",5,1,4,10
291835,"2023",0,1,2,3
291840,"2015",100,20,237,357
291840,"2016",98,29,283,410
291840,"2017",107,21,227,355
291840,"2018",113,12,228,353
291840,"2019",113,27,252,392
291840,"2020",90,20,186,296
291840,"2021",77,21,163,261
291840,"2022",71,16,141,228
291840,"2023",30,9,72,111
291845,"2015",2,1,4,7
291845,"2016",1,1,1,3
291845,"2018",0,0,1,1
291845,"2019",0,0,1,1
291845,"2020",0,0,1,1
291845,"2021",1,0,0,1
291845,"2022",1,1,0,2
291845,"2023",1,0,1,2
291850,"2015",3,1,9,13
291850,"2016",5,1,5,11
291850,"2017",4,3,8,15
291850,"2018",3,3,8,14
291850,"2019",2,1,5,8
291850,"2020",4,1,3,8
291850,"2021",1,0,3,4
291850,"2022",3,0,4,7
291850,"2023",1,0,1,2
291855,"2015",0,0,1,1
291855,"2016",4,0,2,6
291855,"2017",0,0,3,3
291855,"2018",0,0,3,3
291855,"2019",0,0,3,3
291855,"2020",0,0,2,2
291855,"2022",0,0,1,1
291860,"2016",2,1,1,4
291860,"2017",1,0,1,2
291860,"2019",1,0,0,1
291860,"2020",0,0,2,2
291860,"2021",1,0,0,1
291860,"2022",1,0,1,2
291860,"2023",0,1,2,3
291870,"2015",0,0,2,2
291870,"2016",2,0,2,4
291870,"2017",0,0,1,1
291870,"2018",1,0,1,2
291870,"2019",2,2,3,7
291870,"2020",1,0,2,3
291870,"2021",2,0,0,2
291870,"2022",0,1,1,2
291870,"2023",1,0,1,2
291875,"2015",0,0,2,2
291875,"2016",4,0,3,7
291875,"2017",1,1,3,5
291875,"2018",2,0,2,4
291875,"2019",2,0,0,2
291875,"2020",3,0,4,7
291875,"2021",5,1,1,7
291875,"2022",2,1,7,10
291875,"2023",0,1,2,3
291880,"2015",5,2,16,23
291880,"2016",9,1,21,31
291880,"2017",8,1,16,25
291880,"2018",8,1,12,21
291880,"2019",12,1,11,24
291880,"2020",12,1,10,23
291880,"2021",11,3,14,28
291880,"2022",10,0,13,23
291880,"2023",6,4,12,22
291890,"2020",1,0,0,1
291890,"2023",0,0,1,1
291900,"2017",1,0,0,1
291900,"2018",1,0,1,2
291900,"2020",0,0,1,1
291900,"2022",0,0,1,1
291905,"2016",1,0,0,1
291905,"2017",1,0,3,4
291905,"2018",3,1,2,6
291905,"2019",1,0,1,2
291905,"2020",0,1,2,3
291905,"2021",0,0,1,1
291905,"2022",1,0,1,2
291905,"2023",0,0,2,2
291910,"2015",0,0,3,3
291910,"2016",0,0,1,1
291910,"2017",0,0,1,1
291910,"2018",0,1,3,4
291910,"2019",1,1,1,3
291910,"2020",0,3,2,5
291910,"2023",0,0,1,1
291915,"2015",11,2,17,30
291915,"2016",4,0,21,25
291915,"2017",5,3,15,23
291915,"2018",5,4,15,24
291915,"2019",8,2,13,23
291915,"2020",9,4,14,27
291915,"2021",13,0,9,22
291915,"2022",8,2,8,18
291915,"2023",2,2,7,11
291920,"2015",96,10,173,279
291920,"2016",100,22,159,281
291920,"2017",100,24,128,252
291920,"2018",103,16,131,250
291920,"2019",101,15,165,281
291920,"2020",76,20,122,218
291920,"2021",71,18,109,198
291920,"2022",49,10,70,129
291920,"2023",49,12,78,139
291930,"2015",3,1,0,4
291930,"2016",3,0,6,9
291930,"2018",0,0,1,1
291930,"2019",1,0,3,4
291930,"2020",1,0,4,5
291930,"2021",1,1,1,3
291930,"2022",0,0,4,4
291930,"2023",1,0,1,2
291940,"2015",1,0,1,2
291940,"2016",4,0,3,7
291940,"2017",0,0,4,4
291940,"2018",0,0,1,1
291940,"2019",1,2,1,4
291940,"2020",0,1,1,2
291940,"2021",3,0,2,5
291940,"2023",1,0,1,2
291950,"2015",17,3,46,66
291950,"2016",17,3,24,44
291950,"2017",19,5,26,50
291950,"2018",20,3,27,50
291950,"2019",16,3,17,36
291950,"2020",18,4,26,48
291950,"2021",21,3,29,53
291950,"2022",20,8,23,51
291950,"2023",16,6,19,41
291955,"2015",25,4,65,94
291955,"2016",26,11,56,93
291955,"2017",22,4,30,56
291955,"2018",7,1,12,20
291955,"2019",12,3,15,30
291955,"2020",7,3,10,20
291955,"2021",14,2,23,39
291955,"2022",69,15,87,171
291955,"2023",45,5,43,93
291960,"2016",0,0,1,1
291960,"2017",0,1,0,1
291960,"2018",1,0,1,2
291960,"2019",1,0,1,2
291960,"2020",0,0,1,1
291960,"2022",0,0,1,1
291970,"2015",1,3,9,13
291970,"2016",3,1,9,13
291970,"2017",1,0,5,6
291970,"2018",1,0,4,5
291970,"2019",2,0,2,4
291970,"2020",4,0,5,9
291970,"2021",3,1,5,9
291970,"2022",0,1,3,4
291980,"2015",14,2,19,35
291980,"2016",8,2,24,34
291980,"2017",12,1,25,38
291980,"2018",10,3,16,29
291980,"2019",14,3,17,34
291980,"2020",11,3,12,26
291980,"2021",11,1,6,18
291980,"2022",10,1,10,21
291980,"2023",8,2,9,19
291990,"2015",1,0,2,3
291990,"2016",0,0,1,1
291990,"2017",2,0,4,6
291990,"2018",3,0,1,4
291990,"2019",0,1,0,1
291990,"2020",1,0,2,3
291990,"2021",0,1,2,3
291990,"2022",1,0,0,1
291990,"2023",1,1,3,5
291992,"2015",14,1,25,40
291992,"2016",11,2,20,33
291992,"2017",7,0,6,13
291992,"2018",2,0,4,6
291992,"2019",1,0,2,3
291992,"2020",3,0,2,5
291992,"2021",0,0,2,2
291992,"2022",0,0,1,1
291992,"2023",0,1,3,4
291995,"2015",1,0,3,4
291995,"2016",0,0,1,1
291995,"2017",2,0,1,3
291995,"2018",1,1,0,2
291995,"2019",2,0,0,2
291995,"2020",0,0,1,1
291995,"2021",1,0,3,4
291995,"2022",2,2,0,4
291995,"2023",1,0,1,2
292000,"2015",1,0,4,5
292000,"2016",1,0,2,3
292000,"2017",2,1,1,4
292000,"2018",0,0,3,3
292000,"2019",0,0,1,1
292000,"2020",1,0,2,3
292000,"2021",1,0,1,2
292000,"2022",1,0,3,4
292000,"2023",0,0,1,1
292010,"2015",6,2,11,19
292010,"2016",3,2,3,8
292010,"2017",2,5,4,11
292010,"2018",8,1,8,17
292010,"2019",3,1,5,9
292010,"2020",2,3,7,12
292010,"2021",3,0,8,11
292010,"2022",3,0,1,4
292010,"2023",0,0,5,5
292020,"2017",0,0,2,2
292020,"2019",1,0,1,2
292020,"2020",1,0,2,3
292020,"2022",2,0,1,3
292020,"2023",0,0,2,2
292030,"2015",1,0,2,3
292030,"2016",0,1,2,3
292030,"2017",0,0,4,4
292030,"2018",1,0,1,2
292030,"2019",2,1,1,4
292030,"2020",0,1,0,1
292030,"2021",1,0,1,2
292030,"2022",3,0,2,5
292030,"2023",1,0,1,2
292040,"2015",2,3,4,9
292040,"2016",3,0,5,8
292040,"2017",4,0,5,9
292040,"2018",4,0,7,11
292040,"2019",1,0,6,7
292040,"2020",3,1,5,9
292040,"2021",2,1,4,7
292040,"2022",2,3,6,11
292040,"2023",1,0,1,2
292045,"2015",5,0,3,8
292045,"2016",0,0,2,2
292045,"2017",2,1,6,9
292045,"2018",3,0,5,8
292045,"2019",1,0,1,2
292045,"2020",2,0,1,3
292045,"2021",2,1,2,5
292045,"2022",3,1,3,7
292045,"2023",1,0,2,3
292050,"2015",2,0,12,14
292050,"2016",7,1,17,25
292050,"2017",5,2,14,21
292050,"2018",5,0,9,14
292050,"2019",5,2,6,13
292050,"2020",4,2,7,13
292050,"2021",6,0,5,11
292050,"2022",1,0,2,3
292050,"2023",5,4,4,13
292060,"2015",6,0,1,7
292060,"2016",4,0,2,6
292060,"2017",4,0,1,5
292060,"2018",3,1,1,5
292060,"2019",2,1,3,6
292060,"2020",5,1,3,9
292060,"2021",2,0,2,4
292060,"2022",2,0,2,4
292060,"2023",1,0,3,4
292070,"2015",0,0,3,3
292070,"2016",1,0,3,4
292070,"2017",4,0,5,9
292070,"2018",1,0,3,4
292070,"2019",2,2,5,9
292070,"2020",1,1,8,10
292070,"2021",3,0,2,5
292070,"2022",1,1,8,10
292070,"2023",2,1,4,7
292080,"2016",0,0,1,1
292080,"2018",1,0,0,1
292080,"2019",0,0,1,1
292090,"2015",0,0,2,2
292090,"2016",3,0,4,7
292090,"2017",3,0,3,6
292090,"2018",2,0,3,5
292090,"2019",1,0,4,5
292090,"2021",3,2,3,8
292090,"2022",0,0,2,2
292100,"2015",13,2,47,62
292100,"2016",10,2,20,32
292100,"2017",22,1,37,60
292100,"2018",24,6,46,76
292100,"2019",26,6,29,61
292100,"2020",23,3,33,59
292100,"2021",14,5,19,38
292100,"2022",6,2,21,29
292100,"2023",7,0,14,21
292105,"2021",1,0,0,1
292105,"2023",0,0,1,1
292110,"2016",0,1,0,1
292110,"2022",0,1,2,3
292110,"2023",0,0,3,3
292120,"2015",0,0,7,7
292120,"2016",3,1,2,6
292120,"2017",4,1,7,12
292120,"2018",0,0,3,3
292120,"2019",1,0,8,9
292120,"2020",4,0,5,9
292120,"2021",5,2,8,15
292120,"2022",8,2,4,14
292120,"2023",3,0,3,6
292130,"2015",2,1,1,4
292130,"2016",2,0,4,6
292130,"2017",1,0,4,5
292130,"2018",2,2,2,6
292130,"2019",4,0,5,9
292130,"2020",2,1,7,10
292130,"2021",4,0,6,10
292130,"2022",6,0,2,8
292130,"2023",1,0,2,3
292140,"2015",1,1,7,9
292140,"2016",1,1,8,10
292140,"2017",6,1,14,21
292140,"2018",3,0,4,7
292140,"2019",1,2,5,8
292140,"2020",7,1,8,16
292140,"2021",6,2,5,13
292140,"2022",4,0,6,10
292140,"2023",0,1,1,2
292145,"2015",1,0,2,3
292145,"2016",3,0,1,4
292145,"2017",0,2,0,2
292145,"2018",2,0,3,5
292145,"2019",1,0,1,2
292145,"2020",1,0,0,1
292145,"2021",0,2,1,3
292145,"2022",0,0,3,3
292150,"2015",1,0,4,5
292150,"2016",1,0,9,10
292150,"2017",1,1,1,3
292150,"2018",1,0,0,1
292150,"2019",1,0,1,2
292150,"2020",2,1,2,5
292150,"2022",1,0,4,5
292150,"2023",2,0,0,2
292160,"2015",1,0,4,5
292160,"2016",1,0,1,2
292160,"2017",2,0,4,6
292160,"2018",3,0,5,8
292160,"2019",1,1,6,8
292160,"2020",3,0,1,4
292160,"2021",4,1,2,7
292160,"2022",3,1,1,5
292160,"2023",5,3,3,11
292170,"2015",4,0,4,8
292170,"2016",4,0,7,11
292170,"2017",4,0,9,13
292170,"2018",5,0,11,16
292170,"2019",0,0,3,3
292170,"2020",0,0,5,5
292170,"2021",1,2,11,14
292170,"2022",2,0,5,7
292170,"2023",0,0,3,3
292180,"2015",4,0,2,6
292180,"2016",0,0,2,2
292180,"2017",1,1,2,4
292180,"2018",0,1,2,3
292180,"2019",4,1,4,9
292180,"2020",2,0,4,6
292180,"2021",1,0,0,1
292180,"2022",2,1,0,3
292190,"2016",0,0,1,1
292190,"2018",1,0,1,2
292190,"2019",3,0,8,11
292190,"2020",0,0,4,4
292190,"2021",2,1,0,3
292190,"2022",6,1,4,11
292190,"2023",2,1,4,7
292200,"2015",1,1,6,8
292200,"2016",4,0,15,19
292200,"2017",6,2,18,26
292200,"2018",10,1,29,40
292200,"2019",6,1,18,25
292200,"2020",3,1,6,10
292200,"2021",10,3,25,38
292200,"2022",5,4,14,23
292200,"2023",3,1,15,19
292205,"2015",4,0,4,8
292205,"2016",4,0,9,13
292205,"2017",3,0,18,21
292205,"2018",6,3,10,19
292205,"2019",2,0,9,11
292205,"2020",1,0,8,9
292205,"2021",3,1,6,10
292205,"2022",4,2,3,9
292205,"2023",4,0,1,5
292210,"2015",5,1,5,11
292210,"2016",3,0,3,6
292210,"2017",0,0,2,2
292210,"2018",2,0,3,5
292210,"2019",1,2,4,7
292210,"2020",1,0,5,6
292210,"2021",3,0,5,8
292210,"2022",2,1,0,3
292210,"2023",1,0,2,3
292220,"2015",0,0,4,4
292220,"2016",6,0,4,10
292220,"2017",3,0,5,8
292220,"2018",3,0,8,11
292220,"2019",1,1,4,6
292220,"2020",2,1,2,5
292220,"2021",1,0,2,3
292220,"2022",2,0,0,2
292220,"2023",4,1,1,6
292225,"2015",4,0,10,14
292225,"2016",2,1,15,18
292225,"2017",3,0,8,11
292225,"2018",2,2,4,8
292225,"2019",1,1,8,10
292225,"2020",4,1,7,12
292225,"2021",6,1,5,12
292225,"2022",2,1,10,13
292225,"2023",3,0,12,15
292230,"2015",3,0,1,4
292230,"2016",1,0,3,4
292230,"2017",0,1,3,4
292230,"2018",3,0,5,8
292230,"2019",1,0,2,3
292230,"2020",1,1,4,6
292230,"2021",3,0,0,3
292230,"2022",1,0,1,2
292230,"2023",1,0,2,3
292240,"2015",9,2,13,24
292240,"2016",8,0,9,17
292240,"2017",1,1,12,14
292240,"2018",6,2,11,19
292240,"2019",8,3,7,18
292240,"2020",3,4,12,19
292240,"2021",4,3,12,19
292240,"2022",7,3,8,18
292240,"2023",3,1,8,12
292250,"2015",7,1,7,15
292250,"2016",7,1,14,22
292250,"2017",12,0,8,20
292250,"2018",9,3,13,25
292250,"2019",9,1,11,21
292250,"2020",11,1,6,18
292250,"2021",7,5,8,20
292250,"2022",7,2,8,17
292250,"2023",3,3,10,16
292260,"2015",5,0,2,7
292260,"2016",1,1,3,5
292260,"2017",4,0,15,19
292260,"2018",5,0,6,11
292260,"2019",1,0,4,5
292260,"2020",5,1,12,18
292260,"2021",4,0,5,9
292260,"2022",3,0,2,5
292260,"2023",2,3,0,5
292265,"2016",1,1,3,5
292265,"2017",2,0,1,3
292265,"2018",0,1,5,6
292265,"2019",1,0,5,6
292265,"2020",4,0,3,7
292265,"2021",0,3,5,8
292265,"2022",0,0,5,5
292265,"2023",0,1,3,4
292270,"2015",5,2,4,11
292270,"2016",2,0,2,4
292270,"2017",0,1,1,2
292270,"2018",3,0,2,5
292270,"2019",1,0,0,1
292270,"2020",0,0,3,3
292270,"2021",1,2,0,3
292270,"2022",1,0,1,2
292270,"2023",1,0,1,2
292273,"2016",0,0,2,2
292273,"2017",0,0,1,1
292273,"2018",3,1,2,6
292273,"2019",0,0,2,2
292273,"2021",0,2,2,4
292273,"2022",0,0,1,1
292273,"2023",2,0,1,3
292275,"2015",2,1,4,7
292275,"2016",1,1,2,4
292275,"2017",2,1,3,6
292275,"2018",1,0,2,3
292275,"2019",1,0,1,2
292275,"2020",2,0,0,2
292275,"2021",1,0,1,2
292275,"2022",1,0,1,2
292275,"2023",0,0,1,1
292280,"2015",0,0,1,1
292280,"2016",1,0,6,7
292280,"2017",3,1,8,12
292280,"2018",2,0,6,8
292280,"2019",1,1,3,5
292280,"2020",1,0,3,4
292280,"2021",3,0,2,5
292280,"2022",1,0,3,4
292280,"2023",2,0,2,4
292290,"2015",4,0,12,16
292290,"2016",4,1,14,19
292290,"2017",8,1,10,19
292290,"2018",13,0,9,22
292290,"2019",3,2,16,21
292290,"2020",5,2,6,13
292290,"2021",3,2,9,14
292290,"2022",2,1,2,5
292290,"2023",2,1,2,5
292300,"2015",2,1,4,7
292300,"2016",2,0,3,5
292300,"2017",1,0,3,4
292300,"2018",1,0,2,3
292300,"2019",0,0,1,1
292300,"2020",2,0,0,2
292300,"2021",2,0,6,8
292300,"2022",3,1,10,14
292300,"2023",3,0,3,6
292303,"2015",0,0,3,3
292303,"2017",2,0,3,5
292303,"2018",2,0,1,3
292303,"2020",1,1,5,7
292303,"2021",2,1,3,6
292303,"2022",3,0,3,6
292303,"2023",4,1,2,7
292305,"2015",2,0,1,3
292305,"2016",0,0,2,2
292305,"2017",1,0,1,2
292305,"2020",1,0,0,1
292305,"2021",1,0,0,1
292305,"2022",0,0,2,2
292310,"2015",3,0,10,13
292310,"2016",3,3,10,16
292310,"2017",4,0,6,10
292310,"2018",6,0,11,17
292310,"2019",2,0,9,11
292310,"2020",4,1,6,11
292310,"2021",4,0,3,7
292310,"2022",3,1,5,9
292310,"2023",3,0,5,8
292320,"2015",9,1,9,19
292320,"2016",7,3,12,22
292320,"2017",6,1,6,13
292320,"2018",3,1,8,12
292320,"2019",5,3,11,19
292320,"2020",8,3,8,19
292320,"2021",6,1,6,13
292320,"2022",7,3,8,18
292320,"2023",10,3,5,18
292330,"2015",1,1,9,11
292330,"2016",0,0,4,4
292330,"2017",1,0,2,3
292330,"2018",1,0,3,4
292330,"2019",2,1,3,6
292330,"2020",0,0,2,2
292330,"2021",1,0,0,1
292335,"2015",2,1,11,14
292335,"2016",1,0,8,9
292335,"2017",8,1,11,20
292335,"2018",1,0,12,13
292335,"2019",4,0,10,14
292335,"2020",1,2,14,17
292335,"2021",4,2,17,23
292335,"2022",3,1,10,14
292335,"2023",2,2,2,6
292340,"2015",1,0,2,3
292340,"2020",2,0,0,2
292340,"2021",1,0,0,1
292340,"2023",0,1,1,2
292350,"2015",0,0,1,1
292350,"2018",4,2,7,13
292350,"2019",4,0,8,12
292350,"2020",2,1,11,14
292350,"2021",5,1,4,10
292350,"2022",0,3,1,4
292350,"2023",3,0,4,7
292360,"2017",1,0,3,4
292360,"2018",1,1,9,11
292360,"2019",7,1,5,13
292360,"2020",1,0,2,3
292360,"2022",4,0,1,5
292360,"2023",1,0,2,3
292370,"2015",13,0,15,28
292370,"2016",10,2,18,30
292370,"2017",7,3,16,26
292370,"2018",11,4,26,41
292370,"2019",5,1,14,20
292370,"2020",2,0,3,5
292370,"2021",6,1,13,20
292370,"2022",11,1,10,22
292370,"2023",10,5,12,27
292380,"2015",3,0,6,9
292380,"2016",0,1,6,7
292380,"2017",4,2,6,12
292380,"2018",1,1,6,8
292380,"2019",4,1,6,11
292380,"2020",5,0,6,11
292380,"2021",1,1,5,7
292380,"2022",3,2,14,19
292380,"2023",5,1,4,10
292390,"2015",1,0,5,6
292390,"2016",3,0,4,7
292390,"2017",2,0,6,8
292390,"2018",1,0,7,8
292390,"2019",2,1,6,9
292390,"2020",1,1,3,5
292390,"2021",3,2,0,5
292390,"2022",1,2,2,5
292390,"2023",1,0,2,3
292400,"2015",53,12,87,152
292400,"2016",54,9,80,143
292400,"2017",38,12,75,125
292400,"2018",57,13,93,163
292400,"2019",1,0,2,3
292400,"2020",41,6,41,88
292400,"2021",43,13,66,122
292400,"2022",38,9,74,121
292400,"2023",37,12,44,93
292405,"2015",2,1,3,6
292405,"2016",1,1,2,4
292405,"2017",2,1,2,5
292405,"2018",0,0,1,1
292405,"2019",1,0,2,3
292405,"2020",0,0,1,1
292405,"2021",1,0,2,3
292405,"2022",4,0,2,6
292405,"2023",3,0,3,6
292410,"2015",3,0,2,5
292410,"2016",0,1,3,4
292410,"2017",2,2,1,5
292410,"2018",2,0,0,2
292410,"2020",2,0,0,2
292410,"2021",1,1,0,2
292410,"2022",2,0,1,3
292410,"2023",1,0,2,3
292420,"2015",5,0,11,16
292420,"2016",5,3,4,12
292420,"2017",5,2,10,17
292420,"2018",8,3,4,15
292420,"2019",3,0,6,9
292420,"2020",4,0,7,11
292420,"2021",8,1,6,15
292420,"2022",7,0,2,9
292420,"2023",6,2,7,15
292430,"2015",7,1,3,11
292430,"2016",2,0,2,4
292430,"2017",0,1,0,1
292430,"2018",1,0,4,5
292430,"2019",1,0,3,4
292430,"2020",3,0,6,9
292430,"2021",1,0,4,5
292430,"2022",2,0,4,6
292430,"2023",6,0,1,7
292440,"2015",4,2,16,22
292440,"2016",6,0,12,18
292440,"2017",2,0,4,6
292440,"2018",0,0,1,1
292440,"2019",1,0,1,2
292440,"2020",0,1,5,6
292440,"2021",2,0,0,2
292440,"2022",0,0,3,3
292440,"2023",2,0,2,4
292450,"2015",1,0,4,5
292450,"2016",2,0,9,11
292450,"2017",2,0,1,3
292450,"2019",0,0,1,1
292450,"2020",2,0,0,2
292450,"2022",0,0,1,1
292460,"2015",1,0,12,13
292460,"2016",4,1,16,21
292460,"2017",9,2,19,30
292460,"2018",7,2,5,14
292460,"2019",2,1,9,12
292460,"2020",5,2,10,17
292460,"2021",4,2,4,10
292460,"2022",2,2,5,9
292460,"2023",4,2,2,8
292465,"2015",2,1,2,5
292465,"2016",1,0,1,2
292465,"2017",0,2,3,5
292465,"2018",2,0,2,4
292465,"2019",1,1,0,2
292465,"2020",0,0,2,2
292465,"2021",0,0,1,1
292465,"2022",1,0,2,3
292465,"2023",2,0,1,3
292467,"2015",3,0,1,4
292467,"2016",2,1,5,8
292467,"2017",1,2,5,8
292467,"2018",3,0,4,7
292467,"2019",2,0,2,4
292467,"2020",1,0,4,5
292467,"2021",1,0,5,6
292467,"2022",1,0,1,2
292467,"2023",3,0,1,4
292470,"2015",3,1,7,11
292470,"2016",5,0,1,6
292470,"2017",3,0,3,6
292470,"2018",1,0,3,4
292470,"2019",3,0,1,4
292470,"2020",0,0,3,3
292470,"2021",1,1,3,5
292470,"2022",3,1,1,5
292470,"2023",0,0,3,3
292480,"2015",1,1,4,6
292480,"2016",1,1,7,9
292480,"2017",4,0,7,11
292480,"2018",2,0,3,5
292480,"2019",0,0,5,5
292480,"2020",2,1,9,12
292480,"2021",10,3,6,19
292480,"2022",7,4,10,21
292480,"2023",1,1,4,6
292490,"2015",0,0,3,3
292490,"2016",1,0,6,7
292490,"2017",3,0,0,3
292490,"2018",2,2,0,4
292490,"2019",1,1,0,2
292490,"2020",1,2,0,3
292490,"2021",1,0,1,2
292490,"2022",0,0,4,4
292490,"2023",1,0,1,2
292500,"2015",6,0,16,22
292500,"2016",5,0,9,14
292500,"2017",3,3,8,14
292500,"2018",4,0,6,10
292500,"2019",7,1,6,14
292500,"2020",1,1,2,4
292500,"2021",1,1,7,9
292500,"2022",4,1,3,8
292500,"2023",2,0,2,4
292510,"2015",14,3,42,59
292510,"2016",8,5,24,37
292510,"2017",9,2,17,28
292510,"2018",8,0,11,19
292510,"2019",5,1,15,21
292510,"2020",4,2,7,13
292510,"2021",5,1,6,12
292510,"2022",4,1,10,15
292510,"2023",4,1,7,12
292520,"2015",16,2,33,51
292520,"2016",7,0,17,24
292520,"2017",14,1,14,29
292520,"2018",3,1,9,13
292520,"2019",7,0,13,20
292520,"2020",9,1,13,23
292520,"2021",12,0,22,34
292520,"2022",17,6,16,39
292520,"2023",3,3,6,12
292525,"2015",3,1,7,11
292525,"2016",7,1,18,26
292525,"2017",5,0,21,26
292525,"2018",6,2,11,19
292525,"2019",7,1,8,16
292525,"2020",4,0,5,9
292525,"2021",4,1,4,9
292525,"2022",4,0,5,9
292525,"2023",5,1,7,13
292530,"2015",7,0,5,12
292530,"2016",6,0,20,26
292530,"2017",41,8,63,112
292530,"2018",89,15,145,249
292530,"2019",65,11,132,208
292530,"2020",75,14,100,189
292530,"2021",57,8,120,185
292530,"2022",76,20,123,219
292530,"2023",66,14,84,164
292540,"2015",1,0,1,2
292540,"2016",1,1,2,4
292540,"2017",1,0,3,4
292540,"2019",0,0,2,2
292540,"2020",1,0,1,2
292540,"2021",0,0,1,1
292540,"2022",0,0,2,2
292540,"2023",1,0,0,1
292550,"2015",0,0,3,3
292550,"2016",2,0,5,7
292550,"2017",0,1,1,2
292550,"2018",2,1,4,7
292550,"2019",2,2,5,9
292550,"2020",5,3,8,16
292550,"2021",2,1,1,4
292550,"2022",6,0,2,8
292550,"2023",2,1,2,5
292560,"2015",2,1,9,12
292560,"2016",2,0,7,9
292560,"2017",3,0,9,12
292560,"2018",6,0,6,12
292560,"2019",4,2,9,15
292560,"2020",3,0,4,7
292560,"2021",2,1,3,6
292560,"2023",0,1,1,2
292570,"2015",3,2,6,11
292570,"2016",2,0,2,4
292570,"2017",3,0,2,5
292570,"2018",1,0,2,3
292570,"2019",2,0,1,3
292570,"2020",1,0,0,1
292570,"2021",0,0,2,2
292570,"2022",2,0,3,5
292570,"2023",3,0,0,3
292575,"2015",4,0,15,19
292575,"2016",8,0,11,19
292575,"2017",11,0,11,22
292575,"2018",7,3,10,20
292575,"2019",2,1,10,13
292575,"2020",6,0,6,12
292575,"2021",5,0,10,15
292575,"2022",3,1,8,12
292575,"2023",7,5,20,32
292580,"2015",1,0,0,1
292580,"2016",2,0,1,3
292580,"2017",5,0,2,7
292580,"2018",4,0,5,9
292580,"2019",2,0,4,6
292580,"2020",4,0,7,11
292580,"2021",0,1,1,2
292580,"2022",6,1,7,14
292580,"2023",3,0,4,7
292590,"2015",0,3,1,4
292590,"2016",2,0,8,10
292590,"2017",6,0,17,23
292590,"2018",5,4,12,21
292590,"2019",8,5,6,19
292590,"2020",3,1,7,11
292590,"2021",5,1,8,14
292590,"2022",1,0,6,7
292590,"2023",3,2,5,10
292593,"2015",0,0,2,2
292593,"2016",0,1,5,6
292593,"2017",2,0,3,5
292593,"2018",1,0,2,3
292593,"2019",3,0,3,6
292593,"2020",2,1,12,15
292593,"2021",1,1,3,5
292593,"2022",5,0,5,10
292595,"2015",4,0,9,13
292595,"2016",7,1,6,14
292595,"2017",4,0,10,14
292595,"2018",1,1,7,9
292595,"2019",4,3,8,15
292595,"2020",1,0,8,9
292595,"2021",1,2,7,10
292595,"2022",1,2,4,7
292595,"2023",1,1,1,3
292600,"2015",10,3,35,48
292600,"2016",9,1,22,32
292600,"2017",9,1,42,52
292600,"2018",7,1,25,33
292600,"2019",21,2,25,48
292600,"2020",8,4,22,34
292600,"2021",6,1,21,28
292600,"2022",7,1,9,17
292600,"2023",2,1,3,6
292610,"2015",1,0,5,6
292610,"2016",1,1,2,4
292610,"2017",11,0,7,18
292610,"2018",3,0,9,12
292610,"2019",2,1,3,6
292610,"2020",5,0,4,9
292610,"2021",1,2,5,8
292610,"2022",1,0,2,3
292610,"2023",2,0,0,2
292620,"2015",11,0,14,25
292620,"2016",5,1,13,19
292620,"2017",5,1,5,11
292620,"2018",2,0,4,6
292620,"2019",4,0,12,16
292620,"2020",3,1,16,20
292620,"2021",4,0,14,18
292620,"2022",5,1,9,15
292620,"2023",4,1,7,12
292630,"2015",6,2,5,13
292630,"2016",5,0,3,8
292630,"2017",9,0,9,18
292630,"2018",6,2,16,24
292630,"2019",5,2,4,11
292630,"2020",4,2,11,17
292630,"2021",9,2,6,17
292630,"2022",6,1,11,18
292630,"2023",6,3,6,15
292640,"2015",8,1,8,17
292640,"2016",2,0,4,6
292640,"2017",3,0,2,5
292640,"2018",4,1,3,8
292640,"2019",5,1,5,11
292640,"2020",5,1,12,18
292640,"2021",1,1,4,6
292640,"2022",1,0,4,5
292640,"2023",0,1,1,2
292650,"2015",5,1,6,12
292650,"2016",4,0,6,10
292650,"2017",2,1,4,7
292650,"2018",5,3,5,13
292650,"2019",0,1,0,1
292650,"2020",1,0,4,5
292650,"2021",4,0,4,8
292650,"2022",2,0,2,4
292650,"2023",1,0,0,1
292660,"2015",26,6,36,68
292660,"2016",21,6,34,61
292660,"2017",14,1,36,51
292660,"2018",20,4,33,57
292660,"2019",15,5,28,48
292660,"2020",18,4,27,49
292660,"2021",15,2,18,35
292660,"2022",13,2,17,32
292660,"2023",9,4,15,28
292665,"2015",1,0,2,3
292665,"2016",0,1,3,4
292665,"2017",1,0,1,2
292665,"2018",1,0,2,3
292665,"2019",2,0,1,3
292665,"2020",1,1,1,3
292665,"2021",6,0,2,8
292665,"2022",0,1,2,3
292665,"2023",0,0,1,1
292670,"2015",0,0,3,3
292670,"2017",2,0,0,2
292670,"2019",3,2,4,9
292670,"2020",2,0,1,3
292670,"2021",0,0,2,2
292670,"2023",1,0,0,1
292680,"2015",3,1,2,6
292680,"2016",2,0,2,4
292680,"2017",2,1,2,5
292680,"2018",0,0,2,2
292680,"2019",2,0,3,5
292680,"2020",2,0,2,4
292680,"2021",1,0,4,5
292680,"2022",1,1,1,3
292680,"2023",2,0,2,4
292690,"2017",1,0,0,1
292690,"2018",0,0,2,2
292690,"2019",1,2,1,4
292690,"2021",0,0,1,1
292700,"2015",10,3,15,28
292700,"2016",5,1,23,29
292700,"2017",10,1,16,27
292700,"2018",6,0,17,23
292700,"2019",9,2,11,22
292700,"2020",10,2,17,29
292700,"2021",13,5,15,33
292700,"2022",6,6,14,26
292700,"2023",1,1,4,6
292710,"2015",5,2,6,13
292710,"2016",8,2,5,15
292710,"2017",2,1,6,9
292710,"2018",3,1,4,8
292710,"2020",3,1,6,10
292710,"2021",2,0,7,9
292710,"2022",4,0,3,7
292710,"2023",0,0,2,2
292720,"2015",6,0,17,23
292720,"2016",4,0,13,17
292720,"2017",2,2,12,16
292720,"2018",9,3,22,34
292720,"2019",4,1,8,13
292720,"2020",3,0,13,16
292720,"2021",3,2,7,12
292720,"2022",1,0,3,4
292720,"2023",6,1,17,24
292730,"2015",2,0,5,7
292730,"2016",3,0,5,8
292730,"2017",5,0,4,9
292730,"2018",3,2,12,17
292730,"2019",8,2,8,18
292730,"2020",3,2,2,7
292730,"2021",7,2,4,13
292730,"2022",7,2,5,14
292730,"2023",2,0,9,11
292740,"2015",1181,213,1795,3189
292740,"2016",1168,193,1669,3030
292740,"2017",1080,193,1577,2850
292740,"2018",975,202,1321,2498
292740,"2019",960,216,1341,2517
292740,"2020",791,219,1133,2143
292740,"2021",712,186,970,1868
292740,"2022",647,208,948,1803
292740,"2023",542,162,779,1483
292750,"2015",4,1,4,9
292750,"2016",5,2,2,9
292750,"2017",4,1,4,9
292750,"2018",7,1,4,12
292750,"2019",1,0,6,7
292750,"2020",4,1,2,7
292750,"2021",4,1,2,7
292750,"2022",2,2,6,10
292750,"2023",1,1,4,6
292760,"2015",3,5,7,15
292760,"2016",2,1,9,12
292760,"2017",6,1,8,15
292760,"2018",4,1,8,13
292760,"2020",4,1,4,9
292760,"2021",8,2,8,18
292760,"2022",6,0,8,14
292760,"2023",4,0,4,8
292770,"2015",0,0,3,3
292770,"2016",0,1,0,1
292770,"2017",3,2,3,8
292770,"2018",7,4,15,26
292770,"2019",7,2,15,24
292770,"2020",8,3,10,21
292770,"2021",9,3,8,20
292770,"2022",16,4,17,37
292770,"2023",3,1,9,13
292780,"2015",2,1,2,5
292780,"2016",1,0,2,3
292780,"2017",0,2,3,5
292780,"2018",3,0,1,4
292780,"2019",0,1,2,3
292780,"2020",2,0,1,3
292780,"2021",0,0,1,1
292780,"2022",1,0,0,1
292780,"2023",0,0,1,1
292790,"2015",0,1,3,4
292790,"2016",2,0,3,5
292790,"2017",1,0,5,6
292790,"2018",1,0,2,3
292790,"2019",0,0,2,2
292790,"2020",1,0,3,4
292790,"2021",0,0,2,2
292790,"2022",2,0,4,6
292790,"2023",1,0,1,2
292800,"2015",8,3,24,35
292800,"2016",14,2,18,34
292800,"2017",11,0,18,29
292800,"2018",12,1,12,25
292800,"2019",5,1,14,20
292800,"2020",3,2,5,10
292800,"2021",3,3,11,17
292800,"2022",6,1,12,19
292800,"2023",3,2,11,16
292805,"2016",1,0,1,2
292805,"2017",1,0,2,3
292805,"2018",1,0,5,6
292805,"2019",2,0,4,6
292805,"2021",0,1,0,1
292805,"2022",0,0,1,1
292805,"2023",0,0,2,2
292810,"2015",5,3,12,20
292810,"2016",10,2,14,26
292810,"2017",19,1,20,40
292810,"2018",11,3,28,42
292810,"2019",24,3,34,61
292810,"2020",10,4,25,39
292810,"2021",18,5,18,41
292810,"2022",14,4,24,42
292810,"2023",8,5,18,31
292820,"2015",3,0,3,6
292820,"2016",1,1,3,5
292820,"2017",8,1,6,15
292820,"2018",7,5,14,26
292820,"2019",5,2,9,16
292820,"2020",4,0,6,10
292820,"2021",7,2,10,19
292820,"2022",7,0,6,13
292820,"2023",4,0,8,12
292830,"2015",1,0,2,3
292830,"2016",2,1,1,4
292830,"2017",2,0,3,5
292830,"2019",1,1,3,5
292830,"2020",1,0,0,1
292830,"2022",1,0,0,1
292830,"2023",0,1,0,1
292840,"2015",9,1,6,16
292840,"2016",8,3,6,17
292840,"2017",7,3,11,21
292840,"2018",11,2,14,27
292840,"2019",7,1,15,23
292840,"2020",7,5,10,22
292840,"2021",9,3,6,18
292840,"2022",6,1,13,20
292840,"2023",9,4,9,22
292850,"2015",5,0,4,9
292850,"2016",3,0,3,6
292850,"2017",0,0,4,4
292850,"2018",1,0,3,4
292850,"2019",3,0,6,9
292850,"2020",5,1,6,12
292850,"2021",5,0,5,10
292850,"2022",2,0,2,4
292850,"2023",0,1,3,4
292860,"2015",2,0,11,13
292860,"2016",4,1,9,14
292860,"2017",1,0,4,5
292860,"2018",10,2,14,26
292860,"2019",11,2,13,26
292860,"2020",4,1,5,10
292860,"2021",9,4,8,21
292860,"2022",4,3,7,14
292860,"2023",4,0,2,6
292870,"2015",52,10,113,175
292870,"2016",60,10,107,177
292870,"2017",70,19,106,195
292870,"2018",60,17,111,188
292870,"2019",74,21,94,189
292870,"2020",47,15,68,130
292870,"2021",62,13,71,146
292870,"2022",59,19,63,141
292870,"2023",59,13,59,131
292880,"2015",12,1,30,43
292880,"2016",16,4,18,38
292880,"2017",14,5,27,46
292880,"2018",19,4,21,44
292880,"2019",9,4,13,26
292880,"2020",9,1,18,28
292880,"2021",11,8,10,29
292880,"2022",6,2,14,22
292880,"2023",14,0,12,26
292890,"2015",10,0,19,29
292890,"2016",6,1,19,26
292890,"2017",3,0,4,7
292890,"2018",1,1,5,7
292890,"2019",7,2,13,22
292890,"2020",9,0,20,29
292890,"2021",3,0,5,8
292890,"2022",1,1,5,7
292890,"2023",1,0,0,1
292895,"2015",1,0,6,7
292895,"2016",2,0,3,5
292895,"2017",3,1,2,6
292895,"2018",1,0,2,3
292895,"2019",0,0,1,1
292895,"2020",1,0,3,4
292895,"2021",1,0,2,3
292895,"2022",2,0,2,4
292895,"2023",2,0,0,2
292900,"2015",0,0,1,1
292900,"2017",1,0,0,1
292900,"2019",1,0,0,1
292905,"2015",2,3,10,15
292905,"2016",2,1,9,12
292905,"2017",5,0,4,9
292905,"2018",4,1,6,11
292905,"2019",1,1,1,3
292905,"2020",2,2,3,7
292905,"2021",2,0,4,6
292905,"2022",3,0,3,6
292905,"2023",3,1,2,6
292910,"2015",5,1,10,16
292910,"2016",4,0,3,7
292910,"2017",2,2,10,14
292910,"2018",5,1,3,9
292910,"2019",4,1,6,11
292910,"2020",2,2,6,10
292910,"2021",3,2,6,11
292910,"2022",3,0,5,8
292910,"2023",4,1,5,10
292920,"2015",2,0,1,3
292920,"2016",2,0,1,3
292920,"2017",1,1,2,4
292920,"2018",7,0,11,18
292920,"2019",13,7,22,42
292920,"2020",16,3,22,41
292920,"2021",9,9,19,37
292920,"2022",7,4,16,27
292920,"2023",1,0,3,4
292925,"2015",4,1,10,15
292925,"2016",0,1,13,14
292925,"2017",3,3,14,20
292925,"2018",6,0,10,16
292925,"2019",8,2,10,20
292925,"2020",6,1,9,16
292925,"2021",4,2,7,13
292925,"2022",4,1,7,12
292925,"2023",1,1,2,4
292930,"2015",7,3,11,21
292930,"2016",8,1,8,17
292930,"2017",7,4,10,21
292930,"2018",5,0,11,16
292930,"2019",7,3,7,17
292930,"2020",4,2,5,11
292930,"2021",5,3,7,15
292930,"2022",10,2,3,15
292930,"2023",6,6,2,14
292935,"2015",1,0,3,4
292935,"2016",1,0,3,4
292935,"2017",0,0,2,2
292935,"2018",2,0,2,4
292935,"2019",1,0,4,5
292935,"2020",1,0,3,4
292935,"2021",2,0,2,4
292935,"2022",2,0,1,3
292935,"2023",0,0,2,2
292937,"2015",4,1,7,12
292937,"2016",5,0,5,10
292937,"2017",3,0,5,8
292937,"2018",3,1,0,4
292937,"2019",0,0,5,5
292937,"2020",5,0,5,10
292937,"2021",2,2,4,8
292937,"2022",2,1,3,6
292937,"2023",0,1,1,2
292940,"2015",1,0,2,3
292940,"2016",4,1,4,9
292940,"2017",3,0,8,11
292940,"2018",0,2,2,4
292940,"2019",3,0,2,5
292940,"2020",4,0,3,7
292940,"2021",1,1,6,8
292940,"2022",1,1,3,5
292940,"2023",2,0,0,2
292950,"2015",12,2,21,35
292950,"2016",8,2,14,24
292950,"2017",18,4,12,34
292950,"2018",9,2,10,21
292950,"2019",9,2,9,20
292950,"2020",6,1,12,19
292950,"2021",3,1,2,6
292950,"2022",7,2,6,15
292950,"2023",2,1,8,11
292960,"2015",2,3,10,15
292960,"2016",2,0,7,9
292960,"2017",4,2,4,10
292960,"2018",2,1,5,8
292960,"2019",3,1,0,4
292960,"2020",1,0,2,3
292960,"2022",3,0,1,4
292960,"2023",5,0,2,7
292970,"2015",4,1,4,9
292970,"2016",1,1,3,5
292970,"2017",1,1,8,10
292970,"2018",3,0,7,10
292970,"2019",3,0,2,5
292970,"2021",4,3,6,13
292970,"2022",1,1,4,6
292970,"2023",1,0,3,4
292975,"2015",0,0,1,1
292975,"2016",1,0,1,2
292975,"2017",2,0,1,3
292975,"2018",0,0,1,1
292975,"2019",2,1,4,7
292975,"2020",1,1,1,3
292975,"2021",2,0,2,4
292975,"2022",2,0,2,4
292975,"2023",0,1,2,3
292980,"2015",2,2,4,8
292980,"2016",1,0,5,6
292980,"2017",1,0,3,4
292980,"2018",1,0,3,4
292980,"2019",2,0,2,4
292980,"2020",2,0,4,6
292980,"2021",4,1,5,10
292980,"2022",4,0,6,10
292980,"2023",1,1,1,3
292990,"2015",15,5,30,50
292990,"2016",19,10,25,54
292990,"2017",1,0,0,1
292990,"2018",15,3,27,45
292990,"2019",16,6,24,46
292990,"2020",2,0,23,25
292990,"2021",10,1,15,26
292990,"2022",16,4,28,48
292990,"2023",16,2,20,38
293000,"2017",0,0,1,1
293000,"2019",0,0,1,1
293010,"2015",28,3,72,103
293010,"2016",24,3,48,75
293010,"2017",26,11,55,92
293010,"2018",32,5,55,92
293010,"2019",24,3,42,69
293010,"2020",28,2,40,70
293010,"2021",24,6,44,74
293010,"2022",38,11,54,103
293010,"2023",28,10,42,80
293015,"2015",9,1,27,37
293015,"2016",5,0,12,17
293015,"2017",7,1,19,27
293015,"2018",11,4,24,39
293015,"2019",8,3,25,36
293015,"2020",12,2,17,31
293015,"2021",12,2,18,32
293015,"2022",3,1,19,23
293015,"2023",12,3,9,24
293020,"2015",2,3,22,27
293020,"2016",11,1,11,23
293020,"2017",5,1,12,18
293020,"2018",5,4,15,24
293020,"2019",4,1,12,17
293020,"2020",6,3,22,31
293020,"2021",3,1,11,15
293020,"2022",4,2,22,28
293020,"2023",4,1,3,8
293030,"2015",1,0,6,7
293030,"2016",2,1,7,10
293030,"2017",2,1,6,9
293030,"2018",6,0,4,10
293030,"2019",0,1,5,6
293030,"2020",5,0,5,10
293030,"2021",7,4,5,16
293030,"2022",2,1,4,7
293030,"2023",3,0,3,6
293040,"2015",1,0,2,3
293040,"2016",0,2,0,2
293040,"2017",0,2,2,4
293040,"2018",1,0,0,1
293040,"2019",0,0,1,1
293040,"2020",1,1,1,3
293040,"2021",3,0,2,5
293040,"2022",3,1,3,7
293040,"2023",1,0,0,1
293050,"2015",12,2,27,41
293050,"2016",7,2,15,24
293050,"2017",9,2,21,32
293050,"2018",19,5,33,57
293050,"2019",24,2,32,58
293050,"2020",16,7,27,50
293050,"2021",17,3,36,56
293050,"2022",8,4,20,32
293050,"2023",9,0,12,21
293060,"2015",5,0,1,6
293060,"2016",2,0,8,10
293060,"2017",3,3,2,8
293060,"2018",3,2,4,9
293060,"2019",0,2,4,6
293060,"2020",2,0,1,3
293060,"2021",4,1,10,15
293060,"2022",5,2,4,11
293060,"2023",1,0,1,2
293070,"2015",59,7,108,174
293070,"2016",61,14,98,173
293070,"2017",56,11,78,145
293070,"2018",37,8,71,116
293070,"2019",60,13,86,159
293070,"2020",31,8,76,115
293070,"2021",37,11,67,115
293070,"2022",37,6,62,105
293070,"2023",24,7,30,61
293075,"2015",6,0,14,20
293075,"2016",1,0,8,9
293075,"2017",6,0,8,14
293075,"2018",3,0,5,8
293075,"2019",5,2,4,11
293075,"2020",3,3,8,14
293075,"2021",7,3,10,20
293075,"2022",1,1,9,11
293075,"2023",3,0,4,7
293076,"2015",0,0,1,1
293076,"2016",1,0,0,1
293076,"2017",0,0,2,2
293076,"2018",1,1,4,6
293076,"2019",0,0,1,1
293076,"2020",2,0,0,2
293076,"2021",4,0,0,4
293076,"2022",0,1,3,4
293076,"2023",1,0,1,2
293077,"2015",9,2,15,26
293077,"2016",11,1,14,26
293077,"2017",7,0,19,26
293077,"2018",7,1,12,20
293077,"2019",6,3,20,29
293077,"2020",5,2,14,21
293077,"2021",7,1,14,22
293077,"2022",2,2,7,11
293077,"2023",0,0,4,4
293080,"2015",3,2,6,11
293080,"2016",3,1,11,15
293080,"2017",1,0,9,10
293080,"2018",9,1,10,20
293080,"2019",3,1,6,10
293080,"2020",7,1,8,16
293080,"2021",6,0,11,17
293080,"2022",1,0,2,3
293080,"2023",3,1,5,9
293090,"2015",0,1,0,1
293090,"2016",2,0,2,4
293090,"2017",0,0,2,2
293090,"2018",0,0,3,3
293090,"2019",1,0,2,3
293090,"2020",2,0,2,4
293090,"2021",2,2,1,5
293090,"2022",4,1,3,8
293090,"2023",4,1,1,6
293100,"2015",6,4,13,23
293100,"2016",6,0,8,14
293100,"2017",4,2,7,13
293100,"2018",9,0,5,14
293100,"2019",3,0,2,5
293100,"2020",0,1,3,4
293100,"2021",3,1,5,9
293100,"2022",1,1,5,7
293100,"2023",3,1,1,5
293105,"2015",1,0,0,1
293105,"2016",1,0,0,1
293105,"2017",0,0,1,1
293105,"2018",0,0,1,1
293105,"2019",0,0,1,1
293105,"2020",1,0,1,2
293105,"2021",2,0,0,2
293105,"2022",1,1,0,2
293105,"2023",0,0,1,1
293110,"2015",2,0,1,3
293110,"2016",2,0,0,2
293110,"2017",3,1,4,8
293110,"2018",1,1,1,3
293110,"2019",4,0,0,4
293110,"2020",3,1,0,4
293110,"2021",1,0,1,2
293110,"2022",0,0,1,1
293120,"2015",1,2,4,7
293120,"2016",3,1,12,16
293120,"2017",1,4,5,10
293120,"2018",2,1,7,10
293120,"2019",3,1,5,9
293120,"2020",4,1,8,13
293120,"2021",4,2,7,13
293120,"2022",3,3,9,15
293120,"2023",1,1,4,6
293130,"2015",0,2,4,6
293130,"2016",1,0,5,6
293130,"2017",3,0,6,9
293130,"2018",5,0,8,13
293130,"2019",0,0,4,4
293130,"2020",1,1,6,8
293130,"2021",1,0,4,5
293130,"2022",6,1,6,13
293130,"2023",0,0,4,4
293135,"2015",1,0,1,2
293135,"2016",1,0,3,4
293135,"2017",1,0,1,2
293135,"2018",1,0,1,2
293135,"2019",2,0,1,3
293135,"2020",0,0,2,2
293135,"2021",8,1,8,17
293135,"2022",15,1,18,34
293135,"2023",3,3,14,20
293140,"2016",1,0,4,5
293140,"2017",0,0,1,1
293140,"2018",3,2,1,6
293140,"2019",0,0,2,2
293140,"2020",1,0,0,1
293140,"2021",1,0,1,2
293140,"2022",0,0,1,1
293140,"2023",1,0,0,1
293150,"2015",2,3,8,13
293150,"2016",4,1,14,19
293150,"2017",5,2,9,16
293150,"2018",4,0,5,9
293150,"2019",4,1,2,7
293150,"2020",1,0,1,2
293150,"2021",3,1,2,6
293150,"2022",4,0,3,7
293150,"2023",2,0,7,9
293160,"2015",1,0,9,10
293160,"2016",1,1,4,6
293160,"2017",2,0,8,10
293160,"2018",0,0,3,3
293160,"2019",4,1,3,8
293160,"2020",3,0,7,10
293160,"2021",2,0,5,7
293160,"2022",1,0,2,3
293160,"2023",1,0,1,2
293170,"2015",3,0,3,6
293170,"2016",5,1,4,10
293170,"2017",3,0,2,5
293170,"2018",3,0,3,6
293170,"2019",2,0,5,7
293170,"2020",1,0,3,4
293170,"2021",1,0,2,3
293170,"2022",1,0,2,3
293170,"2023",1,0,2,3
293180,"2015",9,2,1,12
293180,"2016",2,1,7,10
293180,"2017",3,1,1,5
293180,"2018",2,0,2,4
293180,"2019",2,0,4,6
293180,"2020",0,0,4,4
293180,"2021",3,1,3,7
293180,"2022",1,1,4,6
293180,"2023",2,0,2,4
293190,"2015",16,5,29,50
293190,"2016",13,3,16,32
293190,"2017",6,4,15,25
293190,"2018",12,2,10,24
293190,"2019",9,3,13,25
293190,"2020",5,3,12,20
293190,"2021",6,1,11,18
293190,"2022",10,2,12,24
293190,"2023",4,1,15,20
293200,"2015",4,1,10,15
293200,"2016",7,1,7,15
293200,"2017",2,0,6,8
293200,"2018",2,1,8,11
293200,"2019",8,1,20,29
293200,"2020",4,2,9,15
293200,"2021",4,3,6,13
293200,"2022",3,2,4,9
293200,"2023",4,1,1,6
293210,"2015",8,1,15,24
293210,"2016",5,0,8,13
293210,"2017",4,0,7,11
293210,"2018",2,1,7,10
293210,"2019",5,1,6,12
293210,"2020",7,1,12,20
293210,"2021",4,3,7,14
293210,"2022",3,4,4,11
293210,"2023",8,1,8,17
293220,"2015",5,2,2,9
293220,"2016",0,0,5,5
293220,"2017",4,0,9,13
293220,"2018",5,1,9,15
293220,"2019",5,0,3,8
293220,"2020",0,1,2,3
293220,"2021",5,0,2,7
293220,"2022",1,0,5,6
293220,"2023",1,0,4,5
293230,"2015",1,1,6,8
293230,"2016",1,3,3,7
293230,"2017",0,3,5,8
293230,"2018",3,0,7,10
293230,"2019",3,2,5,10
293230,"2020",2,0,2,4
293230,"2021",3,1,6,10
293230,"2022",1,1,6,8
293230,"2023",1,1,3,5
293240,"2015",2,0,8,10
293240,"2016",3,0,8,11
293240,"2017",3,1,6,10
293240,"2018",5,2,5,12
293240,"2019",3,1,6,10
293240,"2020",5,0,7,12
293240,"2021",3,0,1,4
293240,"2022",3,2,5,10
293240,"2023",3,0,0,3
293245,"2015",4,0,5,9
293245,"2016",1,0,3,4
293245,"2017",0,1,10,11
293245,"2018",4,1,10,15
293245,"2019",3,0,5,8
293245,"2020",5,0,3,8
293245,"2021",7,1,6,14
293245,"2022",5,1,9,15
293245,"2023",0,0,3,3
293250,"2015",0,0,1,1
293250,"2016",2,0,1,3
293250,"2017",2,0,4,6
293250,"2018",3,1,5,9
293250,"2019",3,1,7,11
293250,"2020",2,1,11,14
293250,"2021",1,1,3,5
293250,"2022",3,1,8,12
293250,"2023",1,1,5,7
293260,"2015",2,0,4,6
293260,"2016",1,0,5,6
293260,"2020",2,0,0,2
293260,"2021",0,0,3,3
293260,"2022",2,1,0,3
293260,"2023",1,0,1,2
293270,"2015",3,0,3,6
293270,"2016",2,0,1,3
293270,"2017",0,2,2,4
293270,"2018",1,0,5,6
293270,"2019",2,1,8,11
293270,"2020",2,1,3,6
293270,"2021",4,0,5,9
293270,"2022",4,1,6,11
293270,"2023",2,0,3,5
293280,"2015",1,0,2,3
293280,"2016",1,0,2,3
293280,"2017",1,0,3,4
293280,"2018",0,0,2,2
293280,"2019",3,0,6,9
293280,"2020",0,1,2,3
293280,"2021",0,0,1,1
293280,"2022",1,0,1,2
293280,"2023",0,0,1,1
293290,"2015",49,5,93,147
293290,"2016",45,9,88,142
293290,"2017",49,10,88,147
293290,"2018",49,13,84,146
293290,"2019",45,6,69,120
293290,"2020",53,10,95,158
293290,"2021",49,12,71,132
293290,"2022",35,2,59,96
293290,"2023",23,3,45,71
293300,"2015",5,0,9,14
293300,"2016",3,0,8,11
293300,"2017",6,1,11,18
293300,"2018",5,2,7,14
293300,"2019",5,2,2,9
293300,"2020",4,1,9,14
293300,"2021",4,1,7,12
293300,"2022",2,1,6,9
293300,"2023",5,0,6,11
293305,"2015",3,0,9,12
293305,"2016",2,0,6,8
293305,"2017",4,0,5,9
293305,"2018",4,0,7,11
293305,"2019",7,1,3,11
293305,"2020",5,2,6,13
293305,"2021",3,1,4,8
293305,"2022",5,2,4,11
293305,"2023",2,1,2,5
293310,"2015",1,0,3,4
293310,"2016",1,0,2,3
293310,"2017",0,1,3,4
293310,"2018",1,3,2,6
293310,"2019",1,0,2,3
293310,"2020",1,1,6,8
293310,"2021",2,0,2,4
293310,"2022",2,2,2,6
293310,"2023",1,0,2,3
293315,"2015",1,1,8,10
293315,"2016",6,1,7,14
293315,"2017",5,1,7,13
293315,"2018",6,0,3,9
293315,"2019",2,0,3,5
293315,"2020",4,0,2,6
293315,"2021",3,0,9,12
293315,"2022",4,0,4,8
293315,"2023",1,1,2,4
293317,"2015",5,1,9,15
293317,"2016",3,2,4,9
293317,"2017",1,0,7,8
293317,"2018",4,0,4,8
293317,"2019",7,1,8,16
293317,"2020",3,0,11,14
293317,"2021",5,1,10,16
293317,"2022",8,3,5,16
293317,"2023",3,1,0,4
293320,"2015",14,3,27,44
293320,"2016",15,3,31,49
293320,"2017",18,6,20,44
293320,"2018",13,6,36,55
293320,"2019",13,8,24,45
293320,"2020",11,4,14,29
293320,"2021",23,6,20,49
293320,"2022",21,3,20,44
293320,"2023",27,6,18,51
293325,"2016",1,0,0,1
293325,"2019",0,0,1,1
293325,"2023",0,0,2,2
293330,"2015",182,32,316,530
293330,"2016",177,43,319,539
293330,"2017",161,35,268,464
293330,"2018",142,38,208,388
293330,"2019",101,27,171,299
293330,"2020",82,42,121,245
293330,"2021",72,29,121,222
293330,"2022",89,32,94,215
293330,"2023",32,16,73,121
293340,"2017",2,0,0,2
293340,"2018",1,1,3,5
293340,"2019",2,1,5,8
293340,"2020",2,1,3,6
293340,"2021",1,0,3,4
293340,"2022",4,0,1,5
293340,"2023",1,0,0,1
293345,"2015",1,0,3,4
293345,"2016",7,2,3,12
293345,"2017",3,0,5,8
293345,"2018",2,0,0,2
293345,"2019",2,1,9,12
293345,"2020",3,0,6,9
293345,"2021",4,1,3,8
293345,"2022",1,2,4,7
293345,"2023",1,1,3,5
293350,"2015",8,1,11,20
293350,"2016",8,0,15,23
293350,"2017",0,2,10,12
293350,"2018",3,0,8,11
293350,"2019",3,1,7,11
293350,"2020",3,0,16,19
293350,"2021",7,1,4,12
293350,"2022",4,0,9,13
293350,"2023",1,0,2,3
293360,"2015",8,4,31,43
293360,"2016",14,2,43,59
293360,"2017",27,3,36,66
293360,"2018",20,3,46,69
293360,"2019",15,1,21,37
293360,"2020",6,1,16,23
293360,"2021",5,1,5,11
293360,"2022",4,0,5,9
293360,"2023",1,0,5,6
310010,"2018",1,0,0,1
310010,"2019",1,0,2,3
310010,"2020",0,1,0,1
310010,"2021",1,0,0,1
310020,"2015",3,1,8,12
310020,"2016",6,0,8,14
310020,"2017",4,1,7,12
310020,"2018",5,1,7,13
310020,"2019",1,0,2,3
310020,"2020",2,1,1,4
310020,"2021",2,1,4,7
310020,"2022",6,1,5,12
310020,"2023",4,1,5,10
310030,"2015",2,0,10,12
310030,"2016",4,1,4,9
310030,"2017",0,1,6,7
310030,"2018",2,1,11,14
310030,"2019",0,1,5,6
310030,"2020",5,2,4,11
310030,"2021",8,1,5,14
310030,"2022",5,0,8,13
310030,"2023",3,0,2,5
310040,"2015",0,1,0,1
310040,"2018",1,0,0,1
310040,"2019",0,0,1,1
310040,"2020",1,1,1,3
310040,"2021",1,0,3,4
310040,"2022",1,0,0,1
310040,"2023",1,0,0,1
310050,"2015",2,0,3,5
310050,"2016",1,0,2,3
310050,"2017",0,2,2,4
310050,"2018",1,0,3,4
310050,"2019",1,0,1,2
310050,"2020",0,2,1,3
310050,"2021",1,1,0,2
310050,"2022",1,0,1,2
310050,"2023",0,0,1,1
310060,"2015",1,0,5,6
310060,"2016",5,2,11,18
310060,"2017",5,2,5,12
310060,"2018",5,0,7,12
310060,"2019",3,1,2,6
310060,"2020",0,1,4,5
310060,"2021",1,0,3,4
310060,"2022",3,2,5,10
310060,"2023",2,0,4,6
310070,"2017",0,0,1,1
310070,"2018",0,0,2,2
310070,"2019",0,0,1,1
310070,"2022",0,0,1,1
310080,"2015",0,0,1,1
310080,"2016",1,1,1,3
310080,"2017",2,0,2,4
310080,"2018",1,0,1,2
310080,"2019",2,0,4,6
310080,"2020",0,0,1,1
310080,"2021",0,0,1,1
310080,"2022",0,1,2,3
310080,"2023",0,0,2,2
310090,"2015",1,0,5,6
310090,"2016",3,0,0,3
310090,"2017",3,0,1,4
310090,"2018",2,2,2,6
310090,"2019",2,0,5,7
310090,"2020",2,1,1,4
310090,"2021",4,0,7,11
310090,"2022",3,0,11,14
310090,"2023",0,3,4,7
310100,"2015",2,1,5,8
310100,"2016",2,1,6,9
310100,"2017",4,0,9,13
310100,"2018",1,0,4,5
310100,"2019",5,1,7,13
310100,"2020",3,4,2,9
310100,"2021",2,0,4,6
310100,"2022",0,0,6,6
310100,"2023",1,1,4,6
310110,"2015",4,3,15,22
310110,"2016",12,1,6,19
310110,"2017",9,1,9,19
310110,"2018",6,2,6,14
310110,"2019",5,2,5,12
310110,"2020",7,0,8,15
310110,"2021",7,3,6,16
310110,"2022",7,2,9,18
310110,"2023",7,2,3,12
310120,"2015",2,0,2,4
310120,"2018",0,0,1,1
310120,"2019",0,0,1,1
310120,"2020",0,1,0,1
310120,"2021",1,1,2,4
310120,"2022",0,2,1,3
310120,"2023",1,0,1,2
310130,"2015",1,0,0,1
310130,"2020",0,0,1,1
310130,"2022",1,0,0,1
310140,"2015",0,0,3,3
310140,"2016",0,0,2,2
310140,"2020",0,1,3,4
310140,"2022",0,0,1,1
310140,"2023",1,0,0,1
310150,"2015",6,2,19,27
310150,"2016",7,2,18,27
310150,"2017",4,3,20,27
310150,"2018",11,8,20,39
310150,"2019",10,4,19,33
310150,"2020",10,5,13,28
310150,"2021",11,4,22,37
310150,"2022",9,2,16,27
310150,"2023",11,3,13,27
310160,"2015",23,3,39,65
310160,"2016",26,5,48,79
310160,"2017",15,6,30,51
310160,"2018",21,8,40,69
310160,"2019",22,6,30,58
310160,"2020",23,3,18,44
310160,"2021",15,3,22,40
310160,"2022",18,6,21,45
310160,"2023",15,5,10,30
310163,"2015",4,0,2,6
310163,"2016",3,0,6,9
310163,"2017",1,0,5,6
310163,"2018",2,0,2,4
310163,"2019",4,0,3,7
310163,"2020",1,0,3,4
310163,"2021",2,0,0,2
310163,"2022",0,0,1,1
310163,"2023",1,1,0,2
310170,"2015",19,5,29,53
310170,"2016",22,6,32,60
310170,"2017",21,2,31,54
310170,"2018",18,3,33,54
310170,"2019",18,1,32,51
310170,"2020",27,9,32,68
310170,"2021",11,4,27,42
310170,"2022",25,5,42,72
310170,"2023",22,4,17,43
310180,"2015",0,0,1,1
310180,"2016",4,1,2,7
310180,"2017",2,0,2,4
310180,"2018",1,0,5,6
310180,"2019",1,0,3,4
310180,"2020",0,0,3,3
310180,"2021",0,0,1,1
310180,"2022",2,0,3,5
310180,"2023",0,0,1,1
310190,"2015",4,1,12,17
310190,"2016",2,2,8,12
310190,"2017",3,2,3,8
310190,"2018",2,0,0,2
310190,"2019",2,0,5,7
310190,"2020",3,0,5,8
310190,"2021",5,1,9,15
310190,"2022",0,1,6,7
310190,"2023",5,0,4,9
310200,"2015",3,0,3,6
310200,"2016",3,0,5,8
310200,"2017",0,0,4,4
310200,"2018",2,0,4,6
310200,"2019",4,0,2,6
310200,"2020",5,0,3,8
310200,"2021",5,0,4,9
310200,"2022",3,1,7,11
310200,"2023",1,0,5,6
310205,"2015",1,0,2,3
310205,"2016",1,0,2,3
310205,"2017",1,0,2,3
310205,"2018",0,0,1,1
310205,"2019",1,0,4,5
310205,"2020",0,0,1,1
310205,"2021",1,0,1,2
310205,"2023",1,0,1,2
310210,"2015",3,3,1,7
310210,"2016",2,2,5,9
310210,"2017",5,0,5,10
310210,"2018",2,0,4,6
310210,"2019",4,0,2,6
310210,"2020",1,0,1,2
310210,"2021",0,1,0,1
310210,"2022",1,0,1,2
310220,"2015",0,0,1,1
310220,"2016",1,0,1,2
310220,"2017",0,0,1,1
310220,"2018",1,1,1,3
310220,"2019",2,0,0,2
310220,"2022",1,1,1,3
310220,"2023",0,0,1,1
310230,"2015",2,0,4,6
310230,"2016",2,0,2,4
310230,"2017",1,0,3,4
310230,"2018",3,0,3,6
310230,"2019",1,0,0,1
310230,"2020",2,0,3,5
310230,"2021",1,2,5,8
310230,"2022",2,0,0,2
310230,"2023",1,1,2,4
310240,"2015",0,0,4,4
310240,"2016",0,0,4,4
310240,"2017",0,0,6,6
310240,"2018",2,1,4,7
310240,"2019",2,0,3,5
310240,"2020",3,0,4,7
310240,"2021",1,1,0,2
310240,"2022",2,0,0,2
310250,"2016",0,0,1,1
310250,"2018",0,0,1,1
310250,"2020",0,0,2,2
310250,"2021",0,0,2,2
310250,"2022",1,0,0,1
310260,"2015",9,0,28,37
310260,"2016",9,1,14,24
310260,"2017",8,0,15,23
310260,"2018",6,3,10,19
310260,"2019",7,1,13,21
310260,"2020",1,1,10,12
310260,"2021",6,5,15,26
310260,"2022",12,0,7,19
310260,"2023",6,1,2,9
310270,"2015",2,1,2,5
310270,"2016",5,0,6,11
310270,"2017",2,1,1,4
310270,"2018",0,1,4,5
310270,"2019",1,0,1,2
310270,"2020",0,0,2,2
310270,"2021",2,0,2,4
310270,"2022",1,0,1,2
310270,"2023",1,0,2,3
310280,"2015",5,2,5,12
310280,"2016",2,0,8,10
310280,"2017",2,0,2,4
310280,"2018",2,0,0,2
310280,"2019",1,0,5,6
310280,"2020",4,0,0,4
310280,"2021",0,0,2,2
310280,"2022",2,2,2,6
310280,"2023",3,0,0,3
310285,"2015",4,0,3,7
310285,"2016",1,0,2,3
310285,"2018",0,0,3,3
310285,"2019",1,0,3,4
310285,"2020",1,0,2,3
310285,"2021",4,2,2,8
310285,"2022",1,0,2,3
310290,"2015",4,0,7,11
310290,"2016",3,0,5,8
310290,"2017",1,0,4,5
310290,"2018",2,0,5,7
310290,"2019",4,2,6,12
310290,"2020",2,0,3,5
310290,"2021",0,0,2,2
310290,"2022",2,0,1,3
310290,"2023",1,1,1,3
310300,"2015",4,1,3,8
310300,"2016",0,0,8,8
310300,"2017",3,0,3,6
310300,"2018",1,0,5,6
310300,"2019",1,1,2,4
310300,"2020",2,0,0,2
310300,"2021",0,0,3,3
310300,"2023",1,0,0,1
310310,"2019",1,0,0,1
310320,"2015",1,0,1,2
310320,"2016",0,0,1,1
310320,"2017",0,0,2,2
310320,"2020",1,0,1,2
310330,"2016",0,0,2,2
310330,"2017",2,0,0,2
310330,"2018",0,0,1,1
310330,"2019",0,0,1,1
310330,"2021",0,1,0,1
310330,"2022",0,0,2,2
310330,"2023",2,0,0,2
310340,"2015",1,0,0,1
310340,"2016",1,0,0,1
310340,"2017",0,0,1,1
310340,"2019",0,1,0,1
310340,"2020",0,0,1,1
310340,"2021",0,0,1,1
310340,"2022",1,2,5,8
310340,"2023",3,1,1,5
310350,"2015",8,3,19,30
310350,"2016",8,1,32,41
310350,"2017",5,0,28,33
310350,"2018",6,4,21,31
310350,"2019",13,2,11,26
310350,"2020",12,1,16,29
310350,"2021",12,2,15,29
310350,"2022",5,1,14,20
310350,"2023",6,1,7,14
310360,"2015",1,0,0,1
310360,"2017",0,2,1,3
310360,"2020",1,0,0,1
310370,"2015",0,0,1,1
310370,"2016",2,1,2,5
310370,"2017",3,2,1,6
310370,"2018",0,0,2,2
310370,"2019",0,0,3,3
310370,"2020",0,0,1,1
310370,"2021",2,1,2,5
310370,"2022",2,1,1,4
310370,"2023",2,0,2,4
310375,"2015",2,0,4,6
310375,"2016",2,0,9,11
310375,"2017",0,0,7,7
310375,"2018",2,0,2,4
310375,"2019",2,0,3,5
310375,"2020",2,0,0,2
310375,"2021",1,0,4,5
310375,"2022",1,0,1,2
310375,"2023",0,0,2,2
310380,"2015",1,0,0,1
310380,"2016",3,1,1,5
310380,"2017",0,0,1,1
310380,"2018",1,0,0,1
310380,"2019",0,0,2,2
310390,"2015",4,0,2,6
310390,"2016",1,0,2,3
310390,"2017",3,1,6,10
310390,"2018",1,1,2,4
310390,"2019",2,0,2,4
310390,"2020",3,2,2,7
310390,"2021",1,1,2,4
310390,"2022",0,0,1,1
310390,"2023",0,0,2,2
310400,"2015",12,1,41,54
310400,"2016",16,2,37,55
310400,"2017",20,2,40,62
310400,"2018",17,2,25,44
310400,"2019",15,5,20,40
310400,"2020",13,1,17,31
310400,"2021",5,0,13,18
310400,"2022",10,3,14,27
310400,"2023",4,1,9,14
310410,"2015",1,0,0,1
310410,"2016",1,0,3,4
310410,"2020",0,0,2,2
310410,"2022",2,0,2,4
310420,"2015",8,1,18,27
310420,"2016",6,1,9,16
310420,"2017",15,4,11,30
310420,"2018",10,2,9,21
310420,"2019",11,4,11,26
310420,"2020",6,2,12,20
310420,"2021",7,6,8,21
310420,"2022",4,1,11,16
310420,"2023",3,0,8,11
310430,"2015",2,0,6,8
310430,"2016",5,0,5,10
310430,"2017",4,1,6,11
310430,"2018",0,0,6,6
310430,"2019",4,0,5,9
310430,"2020",1,0,2,3
310430,"2021",1,0,0,1
310430,"2022",6,0,4,10
310430,"2023",5,2,2,9
310440,"2015",1,0,1,2
310440,"2016",2,0,1,3
310440,"2017",0,0,3,3
310440,"2018",0,0,1,1
310440,"2019",2,0,3,5
310440,"2020",2,1,1,4
310440,"2021",3,0,0,3
310440,"2022",2,1,2,5
310440,"2023",2,0,3,5
310445,"2015",2,0,1,3
310445,"2016",0,1,2,3
310445,"2017",1,0,0,1
310445,"2018",3,0,3,6
310445,"2019",0,0,3,3
310445,"2020",2,0,1,3
310445,"2021",2,1,2,5
310445,"2022",0,0,2,2
310445,"2023",1,0,0,1
310450,"2015",5,0,7,12
310450,"2016",4,0,10,14
310450,"2017",4,0,10,14
310450,"2018",3,1,5,9
310450,"2019",3,0,4,7
310450,"2020",3,2,4,9
310450,"2021",4,0,2,6
310450,"2022",4,1,4,9
310450,"2023",1,2,1,4
310460,"2015",5,0,6,11
310460,"2016",0,0,6,6
310460,"2017",1,0,5,6
310460,"2018",4,0,0,4
310460,"2020",1,0,2,3
310460,"2021",2,1,5,8
310460,"2022",2,1,0,3
310460,"2023",3,0,2,5
310470,"2015",3,0,3,6
310470,"2016",2,0,3,5
310470,"2017",1,1,4,6
310470,"2018",1,0,3,4
310470,"2019",1,0,7,8
310470,"2020",1,0,2,3
310470,"2021",1,1,3,5
310470,"2022",1,0,1,2
310470,"2023",0,0,3,3
310480,"2015",2,0,3,5
310480,"2016",1,0,4,5
310480,"2017",2,0,0,2
310480,"2018",0,0,2,2
310480,"2019",0,0,1,1
310480,"2020",0,0,5,5
310480,"2021",4,0,1,5
310480,"2022",1,0,2,3
310480,"2023",0,0,1,1
310490,"2015",4,0,2,6
310490,"2016",6,2,4,12
310490,"2017",2,1,4,7
310490,"2018",2,1,3,6
310490,"2019",4,0,3,7
310490,"2020",2,0,0,2
310490,"2021",3,2,2,7
310490,"2022",6,2,3,11
310490,"2023",8,1,6,15
310500,"2015",2,0,4,6
310500,"2016",1,0,3,4
310500,"2017",2,0,2,4
310500,"2018",1,0,2,3
310500,"2019",1,1,4,6
310500,"2020",1,0,3,4
310500,"2021",0,1,0,1
310500,"2022",0,2,3,5
310500,"2023",0,1,1,2
310510,"2015",2,0,2,4
310510,"2016",1,0,4,5
310510,"2017",4,1,1,6
310510,"2018",3,2,4,9
310510,"2019",1,0,0,1
310510,"2020",3,1,10,14
310510,"2021",5,0,8,13
310510,"2022",2,2,7,11
310510,"2023",3,0,3,6
310520,"2015",0,0,3,3
310520,"2017",1,0,2,3
310520,"2018",0,1,1,2
310520,"2019",1,2,2,5
310520,"2020",2,1,0,3
310520,"2021",1,0,4,5
310520,"2022",1,0,2,3
310520,"2023",1,0,4,5
310530,"2015",3,0,0,3
310530,"2016",1,0,0,1
310530,"2017",0,1,1,2
310530,"2018",1,0,0,1
310530,"2020",1,0,1,2
310530,"2021",1,0,2,3
310530,"2022",0,0,2,2
310530,"2023",0,1,1,2
310540,"2015",10,1,8,19
310540,"2016",13,4,22,39
310540,"2017",8,5,12,25
310540,"2018",4,2,15,21
310540,"2019",24,3,18,45
310540,"2020",9,2,13,24
310540,"2021",5,5,11,21
310540,"2022",7,3,12,22
310540,"2023",11,2,7,20
310550,"2020",0,0,1,1
310550,"2021",0,0,1,1
310550,"2022",0,0,1,1
310550,"2023",0,0,1,1
310560,"2015",40,15,69,124
310560,"2016",40,7,62,109
310560,"2017",39,13,61,113
310560,"2018",34,12,40,86
310560,"2019",29,8,51,88
310560,"2020",34,10,26,70
310560,"2021",18,8,30,56
310560,"2022",15,5,18,38
310560,"2023",10,0,6,16
310570,"2019",0,0,1,1
310570,"2020",0,1,2,3
310570,"2021",1,1,3,5
310570,"2022",0,0,3,3
310570,"2023",0,0,1,1
310590,"2015",4,2,4,10
310590,"2016",3,0,5,8
310590,"2017",4,0,8,12
310590,"2018",8,0,6,14
310590,"2019",9,2,5,16
310590,"2020",5,0,6,11
310590,"2021",8,2,8,18
310590,"2022",3,1,10,14
310590,"2023",3,0,6,9
310600,"2015",7,1,4,12
310600,"2016",6,0,4,10
310600,"2017",0,0,7,7
310600,"2018",0,3,1,4
310600,"2019",3,1,3,7
310600,"2020",0,0,5,5
310600,"2021",3,3,0,6
310600,"2022",4,0,1,5
310600,"2023",1,1,4,6
310610,"2015",2,0,0,2
310610,"2017",1,0,1,2
310610,"2020",1,1,1,3
310610,"2022",1,0,0,1
310610,"2023",0,0,2,2
310620,"2015",544,121,935,1600
310620,"2016",544,137,849,1530
310620,"2017",548,148,866,1562
310620,"2018",463,129,802,1394
310620,"2019",443,126,663,1232
310620,"2020",311,122,523,956
310620,"2021",317,105,485,907
310620,"2022",313,102,470,885
310620,"2023",191,73,309,573
310630,"2015",11,3,9,23
310630,"2016",7,2,6,15
310630,"2017",3,1,7,11
310630,"2018",7,1,2,10
310630,"2019",4,1,5,10
310630,"2020",4,2,2,8
310630,"2021",4,0,5,9
310630,"2022",3,1,2,6
310630,"2023",3,2,4,9
310640,"2015",0,1,3,4
310640,"2016",7,0,1,8
310640,"2017",1,0,6,7
310640,"2018",1,0,3,4
310640,"2019",1,0,4,5
310640,"2020",3,0,2,5
310640,"2021",3,1,5,9
310640,"2022",2,0,4,6
310640,"2023",3,0,1,4
310650,"2015",0,0,3,3
310650,"2016",1,0,0,1
310650,"2018",0,1,0,1
310650,"2019",1,0,1,2
310650,"2022",1,0,0,1
310650,"2023",0,0,1,1
310660,"2015",0,0,1,1
310660,"2016",1,0,1,2
310660,"2018",1,0,0,1
310660,"2020",0,0,4,4
310660,"2021",0,0,2,2
310660,"2022",0,0,1,1
310665,"2015",3,0,0,3
310665,"2016",2,0,0,2
310665,"2017",0,0,1,1
310665,"2018",2,0,1,3
310665,"2019",1,0,2,3
310665,"2020",1,0,1,2
310665,"2021",1,0,0,1
310665,"2022",3,0,2,5
310665,"2023",0,0,2,2
310670,"2015",128,29,207,364
310670,"2016",97,30,179,306
310670,"2017",95,30,153,278
310670,"2018",94,27,191,312
310670,"2019",122,33,146,301
310670,"2020",76,31,133,240
310670,"2021",82,28,105,215
310670,"2022",103,29,125,257
310670,"2023",78,23,103,204
310680,"2015",0,0,2,2
310680,"2016",1,1,0,2
310680,"2017",0,0,3,3
310680,"2018",2,0,0,2
310680,"2019",2,0,0,2
310680,"2020",0,0,1,1
310680,"2021",0,0,3,3
310690,"2015",2,0,5,7
310690,"2016",3,0,5,8
310690,"2017",3,0,4,7
310690,"2018",3,1,1,5
310690,"2019",3,0,4,7
310690,"2020",6,1,0,7
310690,"2021",5,0,2,7
310690,"2022",2,1,2,5
310690,"2023",5,1,2,8
310700,"2015",0,0,2,2
310700,"2016",0,0,2,2
310700,"2017",1,0,0,1
310700,"2018",2,0,1,3
310700,"2019",0,0,3,3
310700,"2020",1,0,1,2
310700,"2022",0,0,1,1
310710,"2015",3,0,15,18
310710,"2016",6,0,12,18
310710,"2017",9,3,11,23
310710,"2018",3,0,5,8
310710,"2019",3,1,5,9
310710,"2020",6,1,10,17
310710,"2021",8,4,13,25
310710,"2022",12,5,8,25
310710,"2023",13,2,13,28
310720,"2015",0,0,1,1
310720,"2017",2,0,1,3
310720,"2019",0,0,1,1
310720,"2021",2,0,0,2
310720,"2023",1,0,1,2
310730,"2015",30,1,24,55
310730,"2016",27,6,34,67
310730,"2017",29,10,35,74
310730,"2018",32,9,48,89
310730,"2019",27,6,35,68
310730,"2020",20,6,31,57
310730,"2021",25,7,23,55
310730,"2022",23,9,21,53
310730,"2023",20,3,27,50
310740,"2015",2,2,8,12
310740,"2016",4,0,11,15
310740,"2017",6,2,17,25
310740,"2018",12,4,10,26
310740,"2019",3,1,7,11
310740,"2020",5,0,5,10
310740,"2021",8,3,6,17
310740,"2022",5,2,16,23
310740,"2023",8,0,4,12
310750,"2015",2,0,1,3
310750,"2016",3,0,3,6
310750,"2017",1,0,3,4
310750,"2018",1,0,2,3
310750,"2020",1,0,1,2
310750,"2021",0,0,2,2
310750,"2022",0,1,2,3
310750,"2023",0,0,1,1
310760,"2016",0,0,1,1
310760,"2017",0,0,2,2
310760,"2018",0,0,1,1
310760,"2019",0,0,1,1
310760,"2020",0,0,1,1
310760,"2021",0,0,1,1
310760,"2022",1,0,2,3
310770,"2015",2,1,3,6
310770,"2016",1,0,5,6
310770,"2017",4,2,1,7
310770,"2018",1,0,2,3
310770,"2019",1,1,0,2
310770,"2020",1,2,4,7
310770,"2021",2,3,3,8
310770,"2022",2,1,0,3
310770,"2023",5,0,3,8
310780,"2015",2,1,2,5
310780,"2016",1,1,2,4
310780,"2017",6,0,5,11
310780,"2018",4,0,5,9
310780,"2019",5,1,3,9
310780,"2020",4,0,3,7
310780,"2021",1,2,4,7
310780,"2022",3,2,5,10
310780,"2023",1,0,2,3
310790,"2015",1,1,4,6
310790,"2016",6,1,1,8
310790,"2017",6,0,5,11
310790,"2018",3,1,4,8
310790,"2019",3,1,2,6
310790,"2020",3,2,4,9
310790,"2021",2,0,6,8
310790,"2022",0,0,10,10
310790,"2023",1,2,2,5
310800,"2015",2,0,2,4
310800,"2016",5,0,9,14
310800,"2017",8,1,5,14
310800,"2018",4,1,4,9
310800,"2019",4,0,3,7
310800,"2020",2,1,3,6
310800,"2021",0,0,4,4
310800,"2022",3,0,3,6
310800,"2023",2,2,0,4
310810,"2015",2,1,0,3
310810,"2016",1,1,1,3
310810,"2017",1,0,0,1
310810,"2018",0,1,2,3
310810,"2019",0,2,2,4
310810,"2020",0,1,1,2
310810,"2021",0,1,0,1
310810,"2022",1,1,3,5
310810,"2023",0,0,1,1
310820,"2015",0,1,0,1
310820,"2016",2,0,1,3
310820,"2017",2,0,1,3
310820,"2018",2,0,4,6
310820,"2019",0,0,2,2
310820,"2023",0,0,1,1
310825,"2015",1,0,2,3
310825,"2017",0,0,2,2
310825,"2018",2,0,1,3
310825,"2019",0,1,1,2
310825,"2020",0,0,1,1
310825,"2021",2,0,2,4
310825,"2022",2,0,3,5
310825,"2023",0,0,1,1
310830,"2015",3,1,7,11
310830,"2016",5,0,3,8
310830,"2017",5,1,5,11
310830,"2018",4,2,2,8
310830,"2019",2,1,3,6
310830,"2020",5,1,2,8
310830,"2021",4,2,9,15
310830,"2022",5,0,4,9
310830,"2023",2,0,0,2
310840,"2015",0,0,2,2
310840,"2016",2,1,1,4
310840,"2017",1,0,3,4
310840,"2018",1,1,4,6
310840,"2019",1,1,2,4
310840,"2020",2,0,3,5
310840,"2021",3,0,0,3
310840,"2022",3,1,3,7
310840,"2023",1,0,1,2
310850,"2015",1,0,1,2
310850,"2016",2,0,4,6
310850,"2017",0,1,1,2
310850,"2018",0,0,2,2
310850,"2019",1,0,1,2
310850,"2020",1,0,4,5
310850,"2021",0,0,2,2
310850,"2022",2,0,1,3
310850,"2023",1,1,0,2
310855,"2015",3,0,5,8
310855,"2016",3,0,8,11
310855,"2017",4,0,6,10
310855,"2018",3,0,7,10
310855,"2019",1,0,1,2
310855,"2020",0,0,1,1
310855,"2021",3,0,2,5
310855,"2022",2,0,1,3
310855,"2023",4,0,1,5
310860,"2015",18,2,19,39
310860,"2016",20,4,15,39
310860,"2017",32,5,23,60
310860,"2018",13,3,19,35
310860,"2019",14,6,18,38
310860,"2020",11,3,10,24
310860,"2021",12,2,10,24
310860,"2022",5,1,7,13
310860,"2023",3,1,1,5
310870,"2015",0,0,2,2
310870,"2017",2,0,0,2
310870,"2018",1,0,1,2
310870,"2019",1,0,0,1
310870,"2020",1,0,1,2
310870,"2021",0,1,0,1
310870,"2022",0,0,1,1
310870,"2023",0,0,2,2
310880,"2015",1,1,0,2
310880,"2016",0,0,1,1
310880,"2017",1,0,0,1
310880,"2018",1,0,0,1
310880,"2019",0,0,1,1
310880,"2020",0,0,2,2
310880,"2022",1,0,0,1
310880,"2023",0,0,1,1
310890,"2015",0,0,2,2
310890,"2016",2,0,6,8
310890,"2017",2,0,3,5
310890,"2018",2,1,3,6
310890,"2019",2,0,0,2
310890,"2020",0,1,2,3
310890,"2021",1,0,3,4
310890,"2022",2,0,3,5
310890,"2023",1,0,3,4
310900,"2015",13,4,17,34
310900,"2016",11,2,13,26
310900,"2017",7,6,21,34
310900,"2018",13,7,20,40
310900,"2019",14,3,18,35
310900,"2020",13,4,24,41
310900,"2021",16,4,21,41
310900,"2022",11,3,17,31
310900,"2023",5,1,13,19
310910,"2015",3,0,1,4
310910,"2016",3,1,0,4
310910,"2017",5,0,1,6
310910,"2018",4,1,4,9
310910,"2019",0,0,2,2
310910,"2020",2,1,1,4
310910,"2021",4,0,3,7
310910,"2022",2,1,2,5
310920,"2015",4,0,4,8
310920,"2016",2,2,8,12
310920,"2017",1,0,10,11
310920,"2018",4,1,4,9
310920,"2019",0,1,6,7
310920,"2020",3,0,4,7
310920,"2021",0,0,4,4
310920,"2022",2,2,8,12
310920,"2023",4,0,7,11
310925,"2015",1,0,2,3
310925,"2016",1,0,1,2
310925,"2017",1,0,1,2
310925,"2018",0,0,2,2
310925,"2019",1,0,1,2
310925,"2021",0,1,0,1
310925,"2022",1,0,0,1
310930,"2015",7,1,13,21
310930,"2016",5,0,12,17
310930,"2017",5,4,17,26
310930,"2018",12,1,23,36
310930,"2019",12,5,19,36
310930,"2020",8,4,21,33
310930,"2021",12,3,18,33
310930,"2022",8,4,16,28
310930,"2023",6,4,14,24
310940,"2015",10,1,10,21
310940,"2016",4,0,4,8
310940,"2017",3,0,9,12
310940,"2018",4,0,12,16
310940,"2019",5,0,6,11
310940,"2020",3,0,10,13
310940,"2021",5,0,5,10
310940,"2022",3,0,11,14
310940,"2023",5,1,5,11
310945,"2015",0,0,2,2
310945,"2016",0,0,2,2
310945,"2017",2,0,3,5
310945,"2018",0,0,1,1
310945,"2019",0,0,1,1
310945,"2020",0,1,4,5
310945,"2021",1,0,1,2
310945,"2023",3,0,1,4
310950,"2015",2,0,6,8
310950,"2016",3,0,4,7
310950,"2017",4,0,5,9
310950,"2018",3,0,0,3
310950,"2019",1,0,1,2
310950,"2020",1,0,0,1
310950,"2021",1,0,2,3
310950,"2022",0,0,1,1
310950,"2023",0,0,1,1
310960,"2015",1,0,1,2
310960,"2016",1,0,2,3
310960,"2017",1,0,0,1
310960,"2018",1,2,0,3
310960,"2020",0,0,1,1
310960,"2021",2,0,0,2
310960,"2022",2,0,1,3
310960,"2023",0,1,0,1
310970,"2015",1,0,5,6
310970,"2016",1,0,6,7
310970,"2017",2,0,4,6
310970,"2018",2,0,4,6
310970,"2019",1,0,6,7
310970,"2020",0,1,5,6
310970,"2021",2,1,4,7
310970,"2022",1,0,1,2
310970,"2023",0,1,2,3
310980,"2015",0,0,1,1
310990,"2015",2,1,0,3
310990,"2016",3,0,4,7
310990,"2017",6,0,5,11
310990,"2018",4,0,2,6
310990,"2019",1,1,3,5
310990,"2020",3,0,3,6
310990,"2021",0,2,1,3
310990,"2022",3,0,2,5
310990,"2023",0,0,2,2
311000,"2015",9,5,20,34
311000,"2016",7,7,12,26
311000,"2017",9,3,18,30
311000,"2018",13,2,16,31
311000,"2019",9,3,18,30
311000,"2020",7,2,17,26
311000,"2021",10,4,16,30
311000,"2022",8,5,12,25
311000,"2023",6,3,8,17
311010,"2015",0,1,2,3
311010,"2016",2,0,0,2
311010,"2017",1,0,1,2
311010,"2018",1,0,1,2
311010,"2019",1,0,1,2
311010,"2020",0,1,0,1
311010,"2021",1,1,1,3
311010,"2023",1,0,1,2
311020,"2015",1,0,0,1
311020,"2018",0,0,1,1
311020,"2020",4,0,0,4
311020,"2021",0,1,1,2
311020,"2022",1,0,2,3
311020,"2023",0,0,2,2
311030,"2015",1,0,3,4
311030,"2016",1,0,5,6
311030,"2017",1,0,1,2
311030,"2018",1,0,1,2
311030,"2019",1,0,0,1
311030,"2020",1,2,1,4
311030,"2021",2,0,0,2
311030,"2023",1,0,1,2
311040,"2015",0,0,1,1
311040,"2016",3,1,3,7
311040,"2017",1,0,1,2
311040,"2020",0,0,2,2
311040,"2021",2,0,1,3
311050,"2015",0,0,1,1
311050,"2016",1,1,2,4
311050,"2017",2,0,4,6
311050,"2018",3,2,7,12
311050,"2019",1,0,6,7
311050,"2020",3,1,4,8
311050,"2021",1,0,3,4
311050,"2022",4,0,2,6
311050,"2023",1,0,6,7
311060,"2015",4,5,7,16
311060,"2016",3,3,7,13
311060,"2017",7,2,9,18
311060,"2018",8,5,10,23
311060,"2019",6,0,8,14
311060,"2020",5,0,10,15
311060,"2021",6,3,12,21
311060,"2022",6,0,11,17
311060,"2023",4,2,4,10
311070,"2015",3,0,3,6
311070,"2016",1,1,1,3
311070,"2017",0,0,3,3
311070,"2018",3,2,5,10
311070,"2019",5,0,1,6
311070,"2020",0,0,3,3
311070,"2021",4,2,5,11
311070,"2022",1,0,1,2
311070,"2023",1,0,2,3
311080,"2015",1,0,0,1
311080,"2016",0,1,2,3
311080,"2017",1,0,0,1
311080,"2018",0,0,1,1
311080,"2019",0,1,1,2
311080,"2020",0,0,1,1
311080,"2022",0,0,2,2
311090,"2015",2,2,8,12
311090,"2016",3,0,1,4
311090,"2017",0,0,2,2
311090,"2018",2,1,6,9
311090,"2019",0,1,2,3
311090,"2020",4,1,3,8
311090,"2021",3,1,4,8
311090,"2022",3,1,5,9
311090,"2023",2,0,3,5
311100,"2015",1,0,1,2
311100,"2016",1,0,3,4
311100,"2017",2,0,6,8
311100,"2018",1,0,6,7
311100,"2019",3,0,4,7
311100,"2020",1,1,0,2
311100,"2021",0,4,1,5
311100,"2022",2,0,2,4
311100,"2023",0,1,0,1
311110,"2015",4,0,8,12
311110,"2016",2,0,8,10
311110,"2017",4,1,1,6
311110,"2018",1,0,2,3
311110,"2019",2,0,1,3
311110,"2020",2,1,6,9
311110,"2021",1,0,3,4
311110,"2022",1,0,2,3
311110,"2023",1,0,2,3
311115,"2015",2,0,0,2
311115,"2016",1,0,0,1
311115,"2017",0,0,5,5
311115,"2018",2,0,0,2
311115,"2019",2,2,3,7
311115,"2020",2,0,1,3
311115,"2021",0,1,2,3
311115,"2022",2,0,0,2
311115,"2023",0,1,0,1
311120,"2015",10,0,35,45
311120,"2016",16,6,19,41
311120,"2017",8,2,28,38
311120,"2018",11,9,20,40
311120,"2019",15,4,9,28
311120,"2020",20,1,30,51
311120,"2021",21,2,22,45
311120,"2022",6,5,18,29
311120,"2023",5,1,12,18
311130,"2015",2,3,5,10
311130,"2016",1,1,7,9
311130,"2017",2,0,3,5
311130,"2018",1,1,2,4
311130,"2019",4,1,6,11
311130,"2020",3,0,5,8
311130,"2021",2,3,6,11
311130,"2022",3,0,10,13
311130,"2023",2,2,2,6
311140,"2015",1,1,1,3
311140,"2016",1,1,2,4
311140,"2017",1,0,0,1
311140,"2018",0,0,1,1
311140,"2019",0,0,2,2
311140,"2020",2,0,5,7
311140,"2021",0,0,5,5
311140,"2022",1,0,1,2
311140,"2023",0,0,2,2
311150,"2015",0,0,7,7
311150,"2016",1,0,4,5
311150,"2017",0,0,4,4
311150,"2018",0,0,5,5
311150,"2019",0,0,5,5
311150,"2020",1,0,9,10
311150,"2021",1,3,4,8
311150,"2022",1,1,1,3
311150,"2023",0,1,2,3
311160,"2015",5,5,8,18
311160,"2016",6,2,11,19
311160,"2017",5,1,12,18
311160,"2018",4,1,12,17
311160,"2019",6,0,9,15
311160,"2020",4,1,15,20
311160,"2021",8,4,11,23
311160,"2022",6,2,5,13
311160,"2023",9,0,7,16
311170,"2015",0,0,2,2
311170,"2016",0,0,2,2
311170,"2017",1,0,1,2
311170,"2018",1,1,0,2
311170,"2020",1,0,0,1
311170,"2021",0,0,2,2
311170,"2022",1,0,2,3
311170,"2023",0,0,1,1
311180,"2015",1,0,5,6
311180,"2016",3,0,2,5
311180,"2017",2,0,5,7
311180,"2018",2,0,4,6
311180,"2019",4,0,5,9
311180,"2020",2,1,7,10
311180,"2021",3,1,3,7
311180,"2022",0,0,3,3
311180,"2023",0,0,1,1
311190,"2015",1,0,1,2
311190,"2016",2,0,1,3
311190,"2017",1,2,2,5
311190,"2018",3,0,1,4
311190,"2019",1,1,0,2
311190,"2020",3,0,2,5
311190,"2021",1,0,1,2
311190,"2022",1,0,3,4
311190,"2023",0,0,1,1
311200,"2015",3,1,4,8
311200,"2016",2,0,3,5
311200,"2017",1,0,6,7
311200,"2018",2,0,8,10
311200,"2019",1,1,2,4
311200,"2020",5,2,4,11
311200,"2021",5,1,6,12
311200,"2022",3,0,2,5
311200,"2023",3,1,2,6
311205,"2015",1,0,1,2
311205,"2016",1,0,2,3
311205,"2017",2,0,1,3
311205,"2018",1,0,2,3
311205,"2019",1,0,0,1
311205,"2020",0,2,2,4
311205,"2021",5,0,1,6
311205,"2022",2,0,2,4
311205,"2023",0,0,3,3
311210,"2015",1,0,2,3
311210,"2016",1,0,1,2
311210,"2017",1,0,0,1
311210,"2018",0,0,5,5
311210,"2019",0,1,2,3
311210,"2020",3,0,0,3
311210,"2021",0,0,1,1
311210,"2022",1,0,0,1
311210,"2023",1,0,2,3
311220,"2015",0,0,1,1
311220,"2016",3,0,1,4
311220,"2017",2,0,0,2
311220,"2018",1,0,3,4
311220,"2019",6,0,4,10
311220,"2020",1,0,0,1
311220,"2021",0,0,1,1
311220,"2022",1,1,0,2
311220,"2023",1,0,0,1
311230,"2015",18,1,24,43
311230,"2016",16,1,33,50
311230,"2017",14,4,20,38
311230,"2018",20,7,18,45
311230,"2019",16,3,20,39
311230,"2020",18,9,23,50
311230,"2021",12,5,18,35
311230,"2022",16,4,18,38
311230,"2023",10,5,17,32
311240,"2015",2,0,1,3
311240,"2016",2,0,0,2
311240,"2017",1,0,2,3
311240,"2018",4,0,0,4
311240,"2019",2,0,2,4
311240,"2020",2,1,1,4
311240,"2021",2,1,6,9
311240,"2022",0,1,5,6
311240,"2023",0,0,1,1
311250,"2015",5,2,5,12
311250,"2016",0,1,0,1
311250,"2017",2,1,3,6
311250,"2018",4,2,5,11
311250,"2019",4,1,0,5
311250,"2020",5,0,2,7
311250,"2021",2,2,0,4
311250,"2022",3,1,2,6
311250,"2023",1,0,6,7
311260,"2015",0,2,2,4
311260,"2016",0,1,3,4
311260,"2017",1,1,2,4
311260,"2019",1,0,1,2
311260,"2020",1,2,2,5
311260,"2021",4,0,1,5
311260,"2022",3,0,2,5
311260,"2023",1,1,4,6
311265,"2015",4,1,0,5
311265,"2016",1,1,0,2
311265,"2017",1,2,1,4
311265,"2018",0,1,0,1
311265,"2019",1,1,1,3
311265,"2020",1,0,2,3
311265,"2023",0,0,1,1
311270,"2015",3,0,17,20
311270,"2016",2,2,2,6
311270,"2017",5,1,7,13
311270,"2018",3,1,5,9
311270,"2019",2,0,5,7
311270,"2020",1,0,4,5
311270,"2021",3,1,9,13
311270,"2022",2,0,6,8
311270,"2023",1,0,1,2
311280,"2015",2,0,0,2
311280,"2016",2,1,3,6
311280,"2017",1,0,4,5
311280,"2018",5,1,6,12
311280,"2019",0,0,2,2
311280,"2020",1,0,3,4
311280,"2021",1,1,7,9
311280,"2022",2,2,5,9
311280,"2023",2,0,2,4
311290,"2015",2,0,2,4
311290,"2016",6,0,3,9
311290,"2017",4,1,4,9
311290,"2018",3,2,4,9
311290,"2019",5,2,3,10
311290,"2020",0,2,4,6
311290,"2021",0,1,5,6
311290,"2022",1,0,2,3
311290,"2023",5,1,1,7
311300,"2015",3,0,4,7
311300,"2016",1,1,8,10
311300,"2017",4,0,7,11
311300,"2018",4,0,3,7
311300,"2019",0,2,6,8
311300,"2020",2,1,2,5
311300,"2021",1,0,7,8
311300,"2022",1,2,5,8
311300,"2023",3,1,3,7
311310,"2015",0,1,2,3
311310,"2017",0,0,2,2
311310,"2018",0,0,1,1
311310,"2019",1,1,1,3
311310,"2020",1,0,1,2
311310,"2021",1,0,2,3
311310,"2022",3,0,1,4
311310,"2023",1,0,0,1
311320,"2015",14,5,15,34
311320,"2016",9,2,17,28
311320,"2017",10,3,12,25
311320,"2018",8,0,9,17
311320,"2019",6,4,5,15
311320,"2020",4,2,10,16
311320,"2021",1,4,5,10
311320,"2022",3,0,4,7
311320,"2023",1,0,6,7
311330,"2015",7,0,19,26
311330,"2016",6,4,11,21
311330,"2017",6,2,8,16
311330,"2018",7,2,12,21
311330,"2019",9,2,7,18
311330,"2020",6,0,6,12
311330,"2021",5,1,5,11
311330,"2022",3,1,5,9
311330,"2023",5,0,5,10
311340,"2015",18,3,43,64
311340,"2016",24,2,35,61
311340,"2017",24,2,47,73
311340,"2018",27,5,42,74
311340,"2019",13,3,24,40
311340,"2020",16,3,32,51
311340,"2021",17,6,29,52
311340,"2022",14,5,22,41
311340,"2023",10,3,18,31
311350,"2015",5,1,2,8
311350,"2016",3,1,5,9
311350,"2017",2,1,4,7
311350,"2018",4,2,5,11
311350,"2019",3,1,3,7
311350,"2020",0,0,4,4
311350,"2021",0,2,3,5
311350,"2022",1,1,0,2
311350,"2023",0,0,1,1
311360,"2015",1,0,3,4
311360,"2016",3,0,4,7
311360,"2017",0,0,1,1
311360,"2018",1,0,4,5
311360,"2019",4,0,1,5
311360,"2020",2,0,0,2
311360,"2021",2,0,5,7
311360,"2022",2,0,1,3
311360,"2023",1,0,2,3
311370,"2015",0,0,1,1
311370,"2016",2,0,2,4
311370,"2017",0,0,2,2
311370,"2018",0,0,2,2
311370,"2019",1,0,1,2
311370,"2021",0,0,1,1
311370,"2022",2,0,4,6
311370,"2023",1,0,2,3
311380,"2015",1,1,1,3
311380,"2016",2,1,1,4
311380,"2017",2,1,1,4
311380,"2018",2,0,1,3
311380,"2019",0,0,3,3
311380,"2020",1,0,1,2
311380,"2021",1,1,1,3
311380,"2022",1,1,1,3
311380,"2023",0,1,0,1
311390,"2015",2,0,4,6
311390,"2016",4,0,3,7
311390,"2017",1,0,3,4
311390,"2018",2,1,0,3
311390,"2019",3,0,1,4
311390,"2020",2,1,2,5
311390,"2021",3,0,5,8
311390,"2022",2,0,5,7
311390,"2023",0,0,3,3
311400,"2015",0,0,3,3
311400,"2016",0,0,2,2
311400,"2017",1,2,1,4
311400,"2018",1,0,0,1
311400,"2019",1,0,3,4
311400,"2020",0,0,2,2
311400,"2021",1,0,2,3
311400,"2022",1,0,0,1
311400,"2023",1,1,0,2
311410,"2015",3,0,1,4
311410,"2016",0,4,6,10
311410,"2017",4,0,2,6
311410,"2018",2,1,1,4
311410,"2019",2,1,0,3
311410,"2020",3,0,2,5
311410,"2021",1,0,3,4
311410,"2022",2,0,1,3
311410,"2023",0,1,2,3
311420,"2015",5,0,10,15
311420,"2016",5,3,16,24
311420,"2017",7,2,6,15
311420,"2018",2,1,6,9
311420,"2019",9,1,8,18
311420,"2020",7,1,18,26
311420,"2021",9,0,4,13
311420,"2022",3,1,5,9
311420,"2023",6,0,7,13
311430,"2015",10,5,15,30
311430,"2016",7,1,12,20
311430,"2017",15,6,16,37
311430,"2018",4,1,16,21
311430,"2019",12,2,18,32
311430,"2020",8,4,6,18
311430,"2021",10,4,6,20
311430,"2022",6,4,11,21
311430,"2023",3,1,9,13
311440,"2015",5,1,1,7
311440,"2016",4,0,6,10
311440,"2017",6,1,10,17
311440,"2018",7,0,16,23
311440,"2019",8,1,10,19
311440,"2020",5,2,7,14
311440,"2021",11,2,11,24
311440,"2022",5,2,12,19
311440,"2023",7,1,2,10
311450,"2015",8,3,9,20
311450,"2016",6,1,9,16
311450,"2017",6,0,5,11
311450,"2018",9,1,9,19
311450,"2019",5,1,3,9
311450,"2020",5,4,10,19
311450,"2021",6,1,2,9
311450,"2022",1,2,8,11
311450,"2023",2,0,3,5
311455,"2015",0,0,1,1
311455,"2016",1,0,0,1
311455,"2017",1,0,1,2
311455,"2018",0,0,2,2
311455,"2019",0,0,2,2
311455,"2020",0,0,2,2
311455,"2021",0,1,2,3
311460,"2015",3,2,0,5
311460,"2016",3,1,1,5
311460,"2017",0,0,2,2
311460,"2018",0,0,2,2
311460,"2019",0,0,1,1
311460,"2020",0,3,2,5
311460,"2021",3,0,2,5
311460,"2022",2,0,2,4
311470,"2016",0,0,1,1
311470,"2017",1,0,2,3
311470,"2018",0,0,1,1
311470,"2019",1,0,2,3
311470,"2020",2,0,1,3
311470,"2021",0,0,1,1
311470,"2022",1,0,1,2
311480,"2015",1,0,0,1
311480,"2017",0,0,1,1
311480,"2018",0,0,1,1
311480,"2020",1,0,1,2
311480,"2021",1,0,0,1
311480,"2022",0,1,0,1
311490,"2015",1,0,0,1
311490,"2016",2,0,0,2
311490,"2017",0,1,1,2
311490,"2018",1,0,0,1
311490,"2020",1,0,0,1
311490,"2023",0,0,1,1
311500,"2016",0,0,1,1
311500,"2017",0,0,1,1
311500,"2018",1,0,0,1
311500,"2019",0,1,0,1
311500,"2020",1,0,1,2
311500,"2021",0,0,1,1
311510,"2015",2,0,7,9
311510,"2016",4,0,4,8
311510,"2017",5,1,13,19
311510,"2018",9,1,7,17
311510,"2019",4,2,5,11
311510,"2020",6,1,7,14
311510,"2021",4,2,9,15
311510,"2022",6,0,9,15
311510,"2023",2,2,8,12
311520,"2016",0,0,2,2
311520,"2017",0,0,2,2
311520,"2018",0,0,2,2
311520,"2021",1,0,0,1
311520,"2022",0,0,1,1
311530,"2015",10,3,15,28
311530,"2016",2,1,8,11
311530,"2017",4,0,10,14
311530,"2018",10,1,9,20
311530,"2019",6,1,5,12
311530,"2020",12,3,11,26
311530,"2021",14,9,25,48
311530,"2022",8,3,17,28
311530,"2023",11,0,13,24
311535,"2015",1,0,5,6
311535,"2016",2,0,3,5
311535,"2017",3,0,2,5
311535,"2018",1,0,2,3
311535,"2019",2,0,5,7
311535,"2020",0,0,2,2
311535,"2021",3,0,1,4
311535,"2022",2,0,5,7
311535,"2023",0,1,1,2
311540,"2015",2,0,0,2
311540,"2016",1,0,0,1
311540,"2017",1,1,1,3
311540,"2018",1,2,1,4
311540,"2019",2,1,0,3
311540,"2020",1,0,0,1
311540,"2021",0,3,2,5
311540,"2022",1,0,2,3
311540,"2023",0,0,1,1
311545,"2015",1,0,1,2
311545,"2016",1,0,4,5
311545,"2017",2,0,3,5
311545,"2018",1,0,2,3
311545,"2019",0,1,1,2
311545,"2020",1,0,2,3
311545,"2021",0,2,6,8
311545,"2022",2,0,1,3
311545,"2023",2,0,0,2
311547,"2015",3,0,1,4
311547,"2016",2,0,0,2
311547,"2017",0,1,1,2
311547,"2018",1,2,1,4
311547,"2020",3,0,2,5
311547,"2021",1,0,2,3
311547,"2022",2,1,0,3
311547,"2023",1,1,1,3
311550,"2015",5,0,7,12
311550,"2016",5,1,8,14
311550,"2017",6,2,10,18
311550,"2018",10,1,7,18
311550,"2019",4,1,6,11
311550,"2020",1,1,6,8
311550,"2021",3,0,0,3
311550,"2022",3,3,4,10
311550,"2023",3,1,2,6
311560,"2017",0,0,1,1
311570,"2017",1,0,0,1
311570,"2020",0,1,0,1
311570,"2021",0,0,1,1
311580,"2015",0,0,5,5
311580,"2016",2,0,4,6
311580,"2017",0,0,3,3
311580,"2018",2,0,3,5
311580,"2019",1,0,1,2
311580,"2020",1,0,1,2
311580,"2021",0,0,5,5
311580,"2022",0,1,4,5
311580,"2023",0,0,2,2
311590,"2016",0,0,2,2
311590,"2017",0,1,2,3
311590,"2019",1,0,0,1
311590,"2021",2,0,0,2
311590,"2022",2,0,2,4
311600,"2015",1,1,4,6
311600,"2016",0,0,3,3
311600,"2017",0,2,1,3
311600,"2018",7,2,3,12
311600,"2019",1,0,1,2
311600,"2020",1,0,2,3
311600,"2021",0,0,1,1
311600,"2022",1,0,2,3
311600,"2023",1,1,2,4
311610,"2015",1,0,5,6
311610,"2016",4,1,3,8
311610,"2017",2,0,1,3
311610,"2018",1,1,2,4
311610,"2019",2,0,0,2
311610,"2020",1,0,1,2
311610,"2021",1,2,2,5
311610,"2022",0,0,2,2
311610,"2023",2,0,1,3
311615,"2015",4,0,7,11
311615,"2016",3,0,7,10
311615,"2017",0,2,6,8
311615,"2018",2,0,7,9
311615,"2019",4,0,7,11
311615,"2020",6,0,5,11
311615,"2021",2,1,7,10
311615,"2022",3,0,2,5
311615,"2023",1,0,1,2
311620,"2015",0,0,1,1
311620,"2017",1,0,0,1
311620,"2018",0,0,4,4
311620,"2019",1,1,1,3
311620,"2020",0,0,1,1
311620,"2023",0,0,1,1
311630,"2015",2,1,2,5
311630,"2016",1,0,3,4
311630,"2017",2,0,2,4
311630,"2018",1,0,0,1
311630,"2019",1,0,3,4
311630,"2020",0,0,1,1
311630,"2021",0,0,2,2
311630,"2022",0,0,3,3
311640,"2016",0,0,2,2
311640,"2018",0,0,1,1
311640,"2019",0,0,1,1
311650,"2015",2,0,3,5
311650,"2016",1,1,2,4
311650,"2017",4,1,4,9
311650,"2018",3,0,1,4
311650,"2019",1,0,3,4
311650,"2020",1,0,1,2
311650,"2021",3,1,6,10
311650,"2022",0,0,1,1
311650,"2023",0,2,2,4
311660,"2015",1,1,4,6
311660,"2016",2,1,3,6
311660,"2017",6,0,9,15
311660,"2018",0,1,6,7
311660,"2019",2,0,6,8
311660,"2020",1,1,6,8
311660,"2021",4,1,12,17
311660,"2022",2,1,5,8
311660,"2023",3,2,5,10
311670,"2015",0,1,0,1
311670,"2016",1,0,0,1
311670,"2017",0,0,4,4
311670,"2018",1,0,1,2
311670,"2019",1,0,1,2
311670,"2021",3,0,1,4
311670,"2022",1,0,1,2
311670,"2023",0,1,3,4
311680,"2016",1,0,0,1
311680,"2017",1,0,0,1
311680,"2019",1,0,0,1
311680,"2020",3,0,1,4
311680,"2021",3,0,1,4
311680,"2022",1,0,4,5
311680,"2023",0,0,1,1
311690,"2017",1,0,0,1
311690,"2018",0,1,0,1
311690,"2019",1,0,0,1
311690,"2020",1,0,0,1
311690,"2022",1,0,0,1
311700,"2015",2,2,2,6
311700,"2016",0,1,3,4
311700,"2017",4,1,3,8
311700,"2018",1,1,0,2
311700,"2019",1,0,1,2
311700,"2020",2,1,2,5
311700,"2021",1,0,4,5
311700,"2022",2,0,4,6
311700,"2023",1,2,3,6
311710,"2015",6,3,4,13
311710,"2016",1,0,2,3
311710,"2017",1,1,2,4
311710,"2018",2,2,4,8
311710,"2019",2,3,1,6
311710,"2020",2,0,4,6
311710,"2021",6,0,3,9
311710,"2022",2,0,2,4
311710,"2023",3,0,0,3
311720,"2015",0,0,2,2
311720,"2020",0,0,1,1
311720,"2022",1,0,0,1
311720,"2023",0,0,1,1
311730,"2015",3,0,8,11
311730,"2016",3,0,9,12
311730,"2017",2,0,5,7
311730,"2018",0,1,6,7
311730,"2019",7,2,7,16
311730,"2020",1,1,6,8
311730,"2021",8,0,9,17
311730,"2022",4,1,1,6
311730,"2023",1,0,6,7
311740,"2015",1,0,2,3
311740,"2017",1,0,2,3
311740,"2018",1,0,3,4
311740,"2019",3,0,3,6
311740,"2020",0,0,1,1
311740,"2021",0,1,0,1
311740,"2023",1,0,0,1
311750,"2015",7,4,18,29
311750,"2016",3,2,13,18
311750,"2017",3,3,10,16
311750,"2018",5,1,12,18
311750,"2019",11,0,7,18
311750,"2020",8,2,7,17
311750,"2021",15,3,12,30
311750,"2022",12,1,10,23
311750,"2023",8,2,8,18
311760,"2015",0,1,1,2
311760,"2016",1,0,1,2
311760,"2017",2,0,3,5
311760,"2018",0,1,2,3
311760,"2019",1,0,1,2
311760,"2020",1,0,0,1
311760,"2021",1,0,0,1
311760,"2022",0,0,1,1
311760,"2023",1,0,0,1
311770,"2015",0,0,1,1
311770,"2016",0,0,3,3
311770,"2017",2,1,3,6
311770,"2018",0,0,1,1
311770,"2019",1,0,0,1
311770,"2020",2,1,0,3
311770,"2021",0,1,5,6
311770,"2022",3,1,0,4
311770,"2023",0,1,1,2
311780,"2015",2,0,3,5
311780,"2016",2,3,1,6
311780,"2017",1,0,2,3
311780,"2018",0,1,3,4
311780,"2019",2,0,1,3
311780,"2020",4,0,2,6
311780,"2021",0,0,2,2
311780,"2022",2,0,3,5
311780,"2023",1,1,0,2
311783,"2015",2,0,3,5
311783,"2016",1,0,0,1
311783,"2017",1,1,1,3
311783,"2018",0,0,1,1
311783,"2021",0,0,1,1
311783,"2022",2,0,1,3
311783,"2023",1,0,1,2
311787,"2015",1,1,2,4
311787,"2016",1,0,6,7
311787,"2017",1,0,3,4
311787,"2018",1,0,4,5
311787,"2019",0,1,3,4
311787,"2020",3,1,2,6
311787,"2021",2,2,2,6
311787,"2022",2,0,3,5
311787,"2023",1,0,2,3
311790,"2015",3,0,4,7
311790,"2016",1,5,2,8
311790,"2017",1,3,9,13
311790,"2018",5,2,5,12
311790,"2019",5,0,3,8
311790,"2020",4,1,2,7
311790,"2021",2,1,6,9
311790,"2022",1,0,4,5
311790,"2023",0,1,3,4
311800,"2015",1,3,4,8
311800,"2016",2,1,4,7
311800,"2017",6,2,4,12
311800,"2018",5,1,11,17
311800,"2019",3,4,11,18
311800,"2020",3,0,5,8
311800,"2021",3,2,6,11
311800,"2022",6,2,6,14
311800,"2023",5,5,6,16
311810,"2015",2,0,3,5
311810,"2016",1,0,2,3
311810,"2017",1,0,4,5
311810,"2018",2,1,4,7
311810,"2019",3,0,3,6
311810,"2020",1,0,0,1
311810,"2021",1,1,2,4
311810,"2022",1,0,1,2
311810,"2023",1,0,0,1
311820,"2015",1,0,0,1
311820,"2016",0,2,1,3
311820,"2017",0,0,1,1
311820,"2018",2,0,1,3
311820,"2020",0,0,1,1
311820,"2021",1,0,2,3
311820,"2022",2,0,0,2
311820,"2023",2,0,1,3
311830,"2015",27,8,61,96
311830,"2016",27,12,36,75
311830,"2017",24,7,41,72
311830,"2018",25,12,44,81
311830,"2019",42,10,50,102
311830,"2020",32,11,51,94
311830,"2021",34,13,50,97
311830,"2022",33,11,45,89
311830,"2023",21,9,35,65
311840,"2015",4,1,2,7
311840,"2016",1,1,6,8
311840,"2017",2,1,4,7
311840,"2018",5,0,2,7
311840,"2019",2,0,3,5
311840,"2020",1,3,5,9
311840,"2021",1,0,7,8
311840,"2022",3,0,3,6
311840,"2023",4,0,4,8
311850,"2016",0,0,3,3
311850,"2017",0,0,1,1
311850,"2019",0,0,1,1
311850,"2020",1,0,0,1
311850,"2022",1,0,0,1
311850,"2023",0,0,1,1
311860,"2015",156,34,254,444
311860,"2016",146,35,227,408
311860,"2017",142,37,213,392
311860,"2018",171,22,206,399
311860,"2019",140,42,192,374
311860,"2020",108,35,140,283
311860,"2021",101,29,139,269
311860,"2022",98,26,168,292
311860,"2023",68,23,126,217
311870,"2015",2,0,6,8
311870,"2016",1,0,2,3
311870,"2017",3,1,0,4
311870,"2018",3,0,1,4
311870,"2019",0,0,5,5
311870,"2020",1,1,4,6
311870,"2021",0,0,3,3
311870,"2022",0,0,3,3
311870,"2023",3,0,0,3
311880,"2015",3,1,20,24
311880,"2016",3,3,13,19
311880,"2017",10,1,15,26
311880,"2018",14,1,12,27
311880,"2019",4,1,14,19
311880,"2020",9,1,6,16
311880,"2021",8,5,13,26
311880,"2022",13,3,13,29
311880,"2023",2,1,4,7
311890,"2015",1,1,2,4
311890,"2016",2,0,5,7
311890,"2017",4,0,1,5
311890,"2018",1,0,1,2
311890,"2019",2,3,5,10
311890,"2020",1,1,1,3
311890,"2021",0,1,5,6
311890,"2022",2,1,3,6
311890,"2023",3,0,1,4
311900,"2015",0,1,2,3
311900,"2016",1,0,2,3
311900,"2018",0,1,1,2
311900,"2019",0,0,1,1
311900,"2020",1,0,3,4
311900,"2021",1,2,3,6
311900,"2022",0,0,1,1
311900,"2023",0,0,4,4
311910,"2015",7,2,9,18
311910,"2016",10,0,7,17
311910,"2017",6,2,18,26
311910,"2018",6,3,12,21
311910,"2019",7,2,18,27
311910,"2020",8,3,6,17
311910,"2021",5,2,11,18
311910,"2022",10,0,9,19
311910,"2023",8,3,5,16
311920,"2015",1,0,4,5
311920,"2017",1,1,1,3
311920,"2018",0,0,2,2
311920,"2019",1,1,1,3
311920,"2020",3,0,2,5
311920,"2022",1,1,1,3
311930,"2015",2,0,6,8
311930,"2016",3,2,5,10
311930,"2017",6,1,16,23
311930,"2018",6,3,9,18
311930,"2019",9,2,9,20
311930,"2020",1,0,11,12
311930,"2021",1,3,8,12
311930,"2022",4,0,13,17
311930,"2023",3,3,6,12
311940,"2015",26,6,32,64
311940,"2016",27,8,41,76
311940,"2017",24,10,36,70
311940,"2018",30,3,32,65
311940,"2019",19,7,24,50
311940,"2020",12,7,11,30
311940,"2021",20,4,14,38
311940,"2022",13,2,11,26
311940,"2023",5,1,12,18
311950,"2016",1,0,1,2
311950,"2017",0,0,1,1
311950,"2018",1,0,1,2
311950,"2019",0,0,1,1
311950,"2021",0,0,1,1
311950,"2022",1,0,1,2
311950,"2023",0,0,1,1
311960,"2018",0,0,2,2
311960,"2022",1,0,0,1
311970,"2015",1,0,0,1
311970,"2016",0,0,1,1
311970,"2017",0,1,2,3
311970,"2018",1,0,0,1
311970,"2019",2,0,1,3
311970,"2020",1,0,1,2
311970,"2021",0,1,1,2
311970,"2022",1,0,1,2
311970,"2023",0,0,1,1
311980,"2015",1,1,1,3
311980,"2016",0,0,1,1
311980,"2017",2,1,1,4
311980,"2018",0,0,1,1
311980,"2020",0,0,1,1
311980,"2023",1,0,0,1
311990,"2015",0,0,1,1
311990,"2016",0,0,1,1
311990,"2018",1,0,1,2
311990,"2019",2,0,0,2
311990,"2022",1,0,1,2
311995,"2016",0,1,0,1
311995,"2017",0,1,1,2
311995,"2018",1,1,0,2
311995,"2019",2,0,0,2
311995,"2020",2,0,3,5
311995,"2022",0,0,1,1
311995,"2023",0,0,1,1
312000,"2015",1,0,1,2
312000,"2016",0,0,2,2
312000,"2017",0,1,0,1
312000,"2018",0,0,3,3
312000,"2019",2,0,1,3
312000,"2020",0,0,1,1
312000,"2021",1,0,1,2
312000,"2022",1,0,0,1
312000,"2023",0,1,0,1
312010,"2015",1,0,1,2
312010,"2016",1,0,2,3
312010,"2017",2,0,0,2
312010,"2018",0,0,2,2
312010,"2019",1,0,0,1
312010,"2020",0,2,3,5
312010,"2021",0,1,1,2
312010,"2022",1,0,1,2
312010,"2023",2,0,4,6
312015,"2015",0,0,1,1
312015,"2016",0,0,1,1
312015,"2018",1,0,0,1
312015,"2019",1,0,0,1
312015,"2020",3,0,0,3
312015,"2021",1,1,1,3
312015,"2022",1,1,1,3
312015,"2023",0,0,1,1
312020,"2015",4,0,4,8
312020,"2016",2,0,2,4
312020,"2017",1,2,6,9
312020,"2018",3,0,6,9
312020,"2019",3,1,7,11
312020,"2020",2,1,5,8
312020,"2021",2,0,7,9
312020,"2022",4,0,1,5
312020,"2023",1,0,2,3
312030,"2015",1,0,2,3
312030,"2016",0,0,2,2
312030,"2017",1,0,1,2
312030,"2018",0,0,1,1
312030,"2019",2,1,3,6
312030,"2020",0,0,2,2
312030,"2021",0,1,0,1
312030,"2022",1,0,2,3
312030,"2023",0,0,1,1
312040,"2015",1,0,1,2
312040,"2016",2,1,3,6
312040,"2018",2,0,0,2
312040,"2019",0,2,3,5
312040,"2020",3,0,1,4
312040,"2021",2,1,1,4
312040,"2022",1,0,0,1
312040,"2023",0,1,1,2
312050,"2015",1,0,3,4
312050,"2016",0,1,0,1
312050,"2017",1,0,0,1
312050,"2018",1,1,1,3
312050,"2019",2,0,2,4
312050,"2020",1,0,3,4
312050,"2021",1,0,2,3
312050,"2022",3,0,3,6
312050,"2023",4,0,1,5
312060,"2015",0,1,2,3
312060,"2016",1,0,2,3
312060,"2017",1,0,1,2
312060,"2019",2,0,2,4
312060,"2020",2,0,2,4
312060,"2021",1,1,0,2
312060,"2022",0,0,1,1
312070,"2015",0,0,2,2
312070,"2016",2,0,1,3
312070,"2017",3,0,0,3
312070,"2019",0,0,1,1
312070,"2020",1,1,0,2
312070,"2021",1,0,0,1
312070,"2022",0,1,2,3
312080,"2015",1,0,0,1
312080,"2016",0,0,2,2
312080,"2017",0,0,3,3
312080,"2018",2,0,0,2
312080,"2019",1,1,1,3
312080,"2020",2,0,0,2
312080,"2021",1,1,3,5
312080,"2022",2,0,1,3
312080,"2023",2,0,2,4
312083,"2015",1,1,5,7
312083,"2016",3,1,2,6
312083,"2017",3,1,4,8
312083,"2018",0,0,5,5
312083,"2019",1,1,2,4
312083,"2020",1,1,3,5
312083,"2021",1,1,2,4
312083,"2022",3,0,1,4
312083,"2023",4,0,0,4
312087,"2015",2,0,5,7
312087,"2016",3,1,3,7
312087,"2017",2,0,8,10
312087,"2018",4,0,5,9
312087,"2019",3,2,6,11
312087,"2020",2,0,2,4
312087,"2021",2,2,4,8
312087,"2022",2,1,2,5
312087,"2023",1,0,2,3
312090,"2015",38,9,49,96
312090,"2016",30,7,47,84
312090,"2017",37,0,42,79
312090,"2018",25,12,45,82
312090,"2019",27,6,50,83
312090,"2020",29,9,52,90
312090,"2021",25,5,36,66
312090,"2022",27,6,38,71
312090,"2023",27,10,39,76
312100,"2015",0,1,0,1
312100,"2016",1,0,4,5
312100,"2017",4,0,6,10
312100,"2018",1,0,1,2
312100,"2019",0,0,4,4
312100,"2021",0,0,2,2
312100,"2022",0,0,1,1
312100,"2023",3,0,4,7
312110,"2015",2,0,1,3
312110,"2016",0,0,4,4
312110,"2017",0,0,2,2
312110,"2020",1,0,1,2
312110,"2021",1,0,0,1
312110,"2022",0,1,2,3
312110,"2023",0,0,3,3
312120,"2015",1,0,0,1
312120,"2016",2,0,3,5
312120,"2017",5,0,5,10
312120,"2018",1,1,1,3
312120,"2019",2,0,3,5
312120,"2020",3,0,1,4
312120,"2021",4,0,5,9
312120,"2022",3,1,2,6
312120,"2023",1,0,3,4
312125,"2015",2,0,6,8
312125,"2016",3,0,7,10
312125,"2017",2,1,3,6
312125,"2018",2,0,5,7
312125,"2019",1,0,7,8
312125,"2020",0,0,5,5
312125,"2021",0,0,5,5
312125,"2022",1,0,4,5
312125,"2023",1,0,1,2
312130,"2015",1,0,1,2
312130,"2016",4,0,1,5
312130,"2017",3,0,2,5
312130,"2018",2,1,1,4
312130,"2019",1,0,1,2
312130,"2020",0,0,3,3
312130,"2021",2,0,1,3
312130,"2022",1,1,0,2
312130,"2023",2,0,0,2
312140,"2015",3,0,4,7
312140,"2016",1,0,1,2
312140,"2017",3,1,1,5
312140,"2018",1,0,0,1
312140,"2019",1,0,1,2
312140,"2020",0,0,2,2
312140,"2021",1,0,0,1
312140,"2022",2,3,1,6
312140,"2023",1,0,1,2
312150,"2015",1,0,0,1
312150,"2016",0,2,2,4
312150,"2017",3,2,0,5
312150,"2018",1,1,0,2
312150,"2019",1,2,0,3
312150,"2020",1,0,2,3
312150,"2022",1,0,0,1
312160,"2015",10,3,38,51
312160,"2016",11,4,33,48
312160,"2017",19,5,24,48
312160,"2018",14,7,30,51
312160,"2019",11,5,24,40
312160,"2020",16,3,18,37
312160,"2021",6,4,16,26
312160,"2022",13,3,16,32
312160,"2023",16,1,20,37
312170,"2016",0,0,1,1
312170,"2021",3,0,1,4
312170,"2022",1,2,2,5
312180,"2015",2,0,0,2
312180,"2016",1,0,2,3
312180,"2017",3,0,3,6
312180,"2018",2,2,3,7
312180,"2019",0,0,1,1
312180,"2020",1,0,2,3
312180,"2021",0,1,2,3
312180,"2023",0,0,1,1
312190,"2015",0,0,1,1
312190,"2016",0,0,2,2
312190,"2017",2,0,1,3
312190,"2018",0,1,0,1
312190,"2019",1,0,1,2
312190,"2020",4,0,0,4
312190,"2021",0,0,3,3
312190,"2022",2,1,0,3
312190,"2023",1,1,0,2
312200,"2015",1,2,8,11
312200,"2016",4,3,4,11
312200,"2017",7,1,10,18
312200,"2018",4,0,3,7
312200,"2019",3,3,5,11
312200,"2020",3,1,3,7
312200,"2021",1,1,4,6
312200,"2022",1,2,6,9
312200,"2023",2,1,2,5
312210,"2015",1,4,0,5
312210,"2017",0,1,0,1
312210,"2019",2,1,0,3
312210,"2021",0,0,1,1
312210,"2022",0,0,2,2
312210,"2023",0,0,1,1
312220,"2015",1,0,3,4
312220,"2016",0,2,4,6
312220,"2017",3,0,7,10
312220,"2018",4,0,4,8
312220,"2019",2,0,1,3
312220,"2020",3,0,1,4
312220,"2021",2,0,1,3
312220,"2022",1,0,2,3
312220,"2023",1,0,0,1
312230,"2015",65,17,88,170
312230,"2016",43,19,91,153
312230,"2017",57,24,86,167
312230,"2018",43,17,75,135
312230,"2019",78,20,75,173
312230,"2020",58,15,75,148
312230,"2021",51,19,45,115
312230,"2022",50,20,56,126
312230,"2023",23,12,40,75
312235,"2015",1,1,8,10
312235,"2016",3,1,8,12
312235,"2017",2,0,2,4
312235,"2018",1,0,3,4
312235,"2019",1,0,4,5
312235,"2020",2,1,4,7
312235,"2021",4,0,5,9
312235,"2022",2,1,3,6
312235,"2023",2,1,2,5
312240,"2015",4,0,5,9
312240,"2016",1,0,3,4
312240,"2017",0,1,4,5
312240,"2018",3,1,4,8
312240,"2019",4,0,2,6
312240,"2021",0,0,2,2
312240,"2022",0,2,3,5
312240,"2023",1,0,0,1
312245,"2015",0,1,6,7
312245,"2016",0,1,3,4
312245,"2017",3,0,8,11
312245,"2018",0,0,4,4
312245,"2019",0,0,7,7
312245,"2020",1,3,7,11
312245,"2021",0,0,4,4
312245,"2022",3,0,1,4
312245,"2023",1,0,4,5
312247,"2015",1,0,3,4
312247,"2016",0,0,2,2
312247,"2018",1,0,0,1
312247,"2019",0,0,1,1
312247,"2021",1,0,0,1
312247,"2023",1,0,0,1
312250,"2015",3,0,3,6
312250,"2016",0,0,3,3
312250,"2017",3,0,2,5
312250,"2018",0,0,2,2
312250,"2019",2,0,0,2
312250,"2020",2,0,0,2
312250,"2021",1,1,1,3
312250,"2022",0,3,0,3
312250,"2023",1,0,0,1
312260,"2015",1,0,1,2
312260,"2016",0,0,1,1
312260,"2017",1,0,3,4
312260,"2018",1,0,3,4
312260,"2019",1,0,3,4
312260,"2021",0,0,2,2
312260,"2022",1,0,1,2
312260,"2023",1,0,1,2
312270,"2017",1,0,0,1
312270,"2018",0,0,2,2
312270,"2020",4,0,0,4
312270,"2021",1,0,1,2
312270,"2022",0,1,0,1
312270,"2023",1,1,0,2
312280,"2015",1,0,1,2
312280,"2016",1,0,0,1
312280,"2018",1,0,0,1
312280,"2019",2,0,0,2
312280,"2021",2,1,0,3
312290,"2015",0,0,2,2
312290,"2018",0,0,2,2
312290,"2019",1,0,2,3
312290,"2020",0,1,0,1
312290,"2021",0,0,1,1
312290,"2022",0,0,4,4
312290,"2023",0,0,4,4
312300,"2015",2,0,9,11
312300,"2016",2,0,1,3
312300,"2017",3,0,2,5
312300,"2018",3,1,2,6
312300,"2019",3,1,4,8
312300,"2020",4,0,5,9
312300,"2021",2,1,3,6
312300,"2023",4,0,0,4
312310,"2015",1,0,1,2
312310,"2016",2,2,1,5
312310,"2017",1,0,5,6
312310,"2018",0,2,3,5
312310,"2019",2,1,1,4
312310,"2020",1,0,3,4
312310,"2021",4,0,0,4
312310,"2022",2,2,2,6
312310,"2023",4,0,1,5
312320,"2015",3,2,7,12
312320,"2016",0,0,3,3
312320,"2020",0,0,2,2
312320,"2022",4,0,1,5
312320,"2023",1,1,6,8
312330,"2016",4,0,0,4
312330,"2017",2,1,1,4
312330,"2018",0,0,2,2
312330,"2019",2,0,0,2
312330,"2020",1,0,2,3
312330,"2021",1,0,1,2
312330,"2022",4,0,3,7
312330,"2023",1,0,1,2
312340,"2019",0,0,1,1
312340,"2020",0,0,3,3
312340,"2022",0,0,1,1
312350,"2015",0,0,1,1
312350,"2017",1,0,0,1
312350,"2019",1,0,0,1
312350,"2020",2,0,0,2
312352,"2015",1,1,5,7
312352,"2016",3,0,6,9
312352,"2017",3,0,3,6
312352,"2018",6,1,11,18
312352,"2019",1,1,3,5
312352,"2020",1,0,0,1
312352,"2021",1,0,3,4
312352,"2022",1,0,0,1
312352,"2023",1,0,1,2
312360,"2015",9,2,12,23
312360,"2016",11,1,16,28
312360,"2017",7,1,13,21
312360,"2018",6,1,16,23
312360,"2019",9,1,11,21
312360,"2020",7,2,8,17
312360,"2021",3,1,6,10
312360,"2022",1,2,9,12
312360,"2023",1,2,5,8
312370,"2015",4,1,8,13
312370,"2016",2,0,4,6
312370,"2017",1,0,3,4
312370,"2018",1,0,10,11
312370,"2019",2,0,0,2
312370,"2020",0,1,1,2
312370,"2021",1,0,0,1
312370,"2022",1,1,5,7
312370,"2023",2,0,2,4
312380,"2015",0,1,4,5
312380,"2016",3,0,3,6
312380,"2017",5,2,7,14
312380,"2018",1,1,5,7
312380,"2019",1,1,5,7
312380,"2020",5,1,4,10
312380,"2021",2,1,2,5
312380,"2022",2,0,5,7
312380,"2023",1,0,1,2
312385,"2015",2,0,1,3
312385,"2016",1,0,4,5
312385,"2017",2,1,2,5
312385,"2018",1,1,3,5
312385,"2019",1,0,2,3
312385,"2020",3,0,1,4
312385,"2021",1,2,1,4
312385,"2022",0,1,2,3
312385,"2023",1,0,1,2
312390,"2015",4,0,4,8
312390,"2016",4,2,5,11
312390,"2017",7,2,9,18
312390,"2018",7,2,6,15
312390,"2019",5,1,5,11
312390,"2020",5,2,8,15
312390,"2021",5,2,9,16
312390,"2022",5,0,7,12
312390,"2023",1,0,4,5
312400,"2015",0,0,4,4
312400,"2016",5,1,4,10
312400,"2017",2,1,3,6
312400,"2018",2,1,2,5
312400,"2019",3,2,5,10
312400,"2020",4,1,5,10
312400,"2021",6,0,6,12
312400,"2022",5,0,6,11
312400,"2023",3,0,6,9
312410,"2015",16,4,30,50
312410,"2016",24,4,39,67
312410,"2017",18,5,33,56
312410,"2018",23,6,43,72
312410,"2019",27,8,32,67
312410,"2020",21,6,21,48
312410,"2021",17,3,34,54
312410,"2022",12,5,19,36
312410,"2023",12,2,15,29
312420,"2015",4,1,9,14
312420,"2016",4,1,7,12
312420,"2017",10,0,8,18
312420,"2018",7,1,9,17
312420,"2019",3,1,7,11
312420,"2020",3,0,2,5
312420,"2021",0,0,3,3
312420,"2022",3,1,5,9
312420,"2023",4,1,7,12
312430,"2015",8,2,18,28
312430,"2016",10,1,10,21
312430,"2017",3,3,15,21
312430,"2018",9,0,15,24
312430,"2019",6,1,8,15
312430,"2020",6,0,7,13
312430,"2021",13,1,11,25
312430,"2022",3,2,8,13
312430,"2023",1,0,1,2
312440,"2015",0,1,3,4
312440,"2016",1,0,0,1
312440,"2017",4,0,7,11
312440,"2018",2,0,5,7
312440,"2019",3,0,4,7
312440,"2020",1,1,5,7
312440,"2021",2,1,5,8
312440,"2022",1,0,1,2
312450,"2015",1,0,1,2
312450,"2016",4,0,4,8
312450,"2017",1,1,1,3
312450,"2018",2,0,1,3
312450,"2019",1,1,1,3
312450,"2020",1,0,2,3
312450,"2021",1,0,1,2
312450,"2022",1,1,4,6
312450,"2023",1,0,2,3
312460,"2016",1,0,0,1
312460,"2017",1,0,0,1
312460,"2019",2,0,2,4
312460,"2021",0,0,2,2
312470,"2016",1,0,0,1
312470,"2017",0,0,1,1
312470,"2018",3,0,0,3
312470,"2020",1,0,1,2
312470,"2021",1,0,1,2
312470,"2023",1,0,3,4
312480,"2017",1,0,1,2
312480,"2018",1,0,1,2
312480,"2019",2,0,0,2
312480,"2021",1,0,0,1
312480,"2023",0,0,1,1
312490,"2017",0,0,1,1
312490,"2022",1,0,0,1
312490,"2023",0,0,1,1
312500,"2015",0,2,1,3
312500,"2016",3,0,3,6
312500,"2017",1,1,0,2
312500,"2018",2,1,1,4
312500,"2019",0,0,1,1
312500,"2020",0,0,1,1
312500,"2021",2,0,2,4
312500,"2022",0,0,2,2
312500,"2023",0,0,1,1
312510,"2015",10,0,19,29
312510,"2016",6,1,14,21
312510,"2017",7,2,12,21
312510,"2018",12,4,19,35
312510,"2019",11,4,17,32
312510,"2020",3,1,14,18
312510,"2021",6,2,10,18
312510,"2022",6,2,10,18
312510,"2023",2,3,3,8
312520,"2015",2,0,0,2
312520,"2016",0,0,1,1
312520,"2017",2,0,0,2
312520,"2018",0,0,2,2
312520,"2019",0,0,1,1
312520,"2020",0,0,2,2
312520,"2021",1,0,0,1
312520,"2022",1,0,1,2
312530,"2015",0,1,2,3
312530,"2016",1,0,1,2
312530,"2017",0,1,2,3
312530,"2019",0,0,1,1
312530,"2020",0,1,1,2
312530,"2021",0,0,1,1
312530,"2023",1,0,0,1
312540,"2015",3,0,2,5
312540,"2016",1,0,3,4
312540,"2017",2,0,3,5
312540,"2018",2,1,1,4
312540,"2019",1,0,2,3
312540,"2020",0,1,3,4
312540,"2021",1,0,1,2
312540,"2022",1,0,2,3
312540,"2023",1,0,2,3
312550,"2015",1,0,0,1
312550,"2016",0,0,1,1
312550,"2017",2,1,0,3
312550,"2018",1,0,1,2
312550,"2019",1,0,1,2
312550,"2020",2,0,0,2
312550,"2021",1,0,2,3
312550,"2022",0,1,2,3
312560,"2016",0,0,1,1
312560,"2019",1,1,4,6
312560,"2020",1,1,2,4
312560,"2021",1,0,0,1
312560,"2022",2,0,2,4
312560,"2023",0,0,3,3
312570,"2015",3,1,10,14
312570,"2016",7,0,8,15
312570,"2017",2,0,5,7
312570,"2018",4,2,1,7
312570,"2019",3,0,6,9
312570,"2020",3,1,5,9
312570,"2021",7,0,2,9
312570,"2022",3,1,4,8
312570,"2023",2,0,5,7
312580,"2015",0,0,3,3
312580,"2016",0,0,1,1
312580,"2018",1,0,0,1
312580,"2019",0,0,2,2
312580,"2022",0,0,1,1
312580,"2023",0,0,1,1
312590,"2015",3,0,1,4
312590,"2016",2,1,2,5
312590,"2018",1,0,2,3
312590,"2019",1,0,0,1
312590,"2020",1,0,1,2
312590,"2021",5,2,2,9
312590,"2022",1,3,7,11
312590,"2023",3,1,1,5
312595,"2015",0,2,1,3
312595,"2016",2,0,8,10
312595,"2017",0,0,5,5
312595,"2018",2,0,3,5
312595,"2019",1,0,3,4
312595,"2020",1,0,1,2
312595,"2021",1,0,2,3
312595,"2022",2,0,5,7
312595,"2023",3,1,0,4
312600,"2015",1,1,0,2
312600,"2016",1,0,1,2
312600,"2017",1,0,0,1
312600,"2018",0,0,2,2
312600,"2019",0,2,3,5
312600,"2020",3,0,4,7
312600,"2021",0,0,2,2
312600,"2022",0,1,2,3
312600,"2023",0,0,1,1
312610,"2015",2,4,6,12
312610,"2016",10,3,12,25
312610,"2017",19,7,12,38
312610,"2018",23,7,26,56
312610,"2019",14,6,13,33
312610,"2020",4,7,11,22
312610,"2021",10,1,4,15
312610,"2022",3,2,8,13
312610,"2023",1,0,1,2
312620,"2015",0,0,1,1
312620,"2016",1,0,0,1
312620,"2017",1,0,5,6
312620,"2018",2,1,2,5
312620,"2019",1,0,1,2
312620,"2021",0,0,1,1
312620,"2022",1,0,0,1
312620,"2023",0,1,1,2
312630,"2016",1,0,0,1
312630,"2017",3,0,0,3
312630,"2019",1,0,0,1
312630,"2021",1,0,1,2
312630,"2022",0,0,1,1
312640,"2015",0,0,1,1
312640,"2016",1,0,3,4
312640,"2017",0,0,2,2
312640,"2018",0,1,1,2
312640,"2019",1,1,0,2
312640,"2020",1,0,0,1
312640,"2021",2,0,2,4
312640,"2022",0,0,3,3
312640,"2023",0,0,2,2
312650,"2016",1,0,0,1
312650,"2018",0,0,2,2
312650,"2020",1,0,0,1
312650,"2021",0,0,1,1
312650,"2023",1,0,1,2
312660,"2015",1,0,2,3
312660,"2016",0,2,1,3
312660,"2017",4,1,3,8
312660,"2018",2,0,2,4
312660,"2019",4,2,4,10
312660,"2020",1,0,5,6
312660,"2021",1,0,0,1
312660,"2022",0,1,3,4
312660,"2023",1,0,3,4
312670,"2015",5,3,12,20
312670,"2016",4,1,12,17
312670,"2017",2,0,8,10
312670,"2018",5,0,11,16
312670,"2019",3,0,8,11
312670,"2020",5,1,12,18
312670,"2021",8,1,9,18
312670,"2022",8,2,16,26
312670,"2023",2,0,6,8
312675,"2015",0,0,1,1
312675,"2016",0,0,1,1
312675,"2017",0,0,1,1
312675,"2019",0,0,1,1
312675,"2020",0,0,1,1
312675,"2021",0,0,1,1
312675,"2022",1,0,2,3
312675,"2023",1,0,0,1
312680,"2015",1,0,8,9
312680,"2016",0,0,4,4
312680,"2017",3,0,4,7
312680,"2018",1,0,2,3
312680,"2019",2,0,2,4
312680,"2020",0,1,3,4
312680,"2021",0,1,1,2
312680,"2022",1,1,2,4
312680,"2023",0,0,1,1
312690,"2015",1,0,3,4
312690,"2016",1,1,4,6
312690,"2017",1,0,2,3
312690,"2018",3,1,2,6
312690,"2019",3,1,5,9
312690,"2020",0,1,3,4
312690,"2021",1,1,2,4
312690,"2022",1,0,2,3
312690,"2023",0,0,1,1
312695,"2016",1,0,1,2
312695,"2017",0,0,1,1
312695,"2019",2,0,3,5
312695,"2020",1,0,2,3
312695,"2021",1,1,1,3
312695,"2022",0,2,0,2
312695,"2023",1,0,0,1
312700,"2015",2,0,5,7
312700,"2016",2,0,4,6
312700,"2017",2,0,5,7
312700,"2018",2,0,1,3
312700,"2019",0,0,2,2
312700,"2020",2,0,3,5
312700,"2021",0,0,4,4
312700,"2022",1,0,6,7
312700,"2023",1,0,2,3
312705,"2015",0,0,2,2
312705,"2016",0,0,1,1
312705,"2017",0,0,1,1
312705,"2018",0,0,1,1
312705,"2020",1,2,0,3
312705,"2022",1,0,0,1
312705,"2023",0,0,1,1
312707,"2015",1,0,5,6
312707,"2016",1,0,1,2
312707,"2017",2,0,7,9
312707,"2018",0,0,3,3
312707,"2019",2,1,3,6
312707,"2020",1,1,3,5
312707,"2021",1,0,5,6
312707,"2022",2,1,5,8
312707,"2023",1,0,1,2
312710,"2015",13,3,36,52
312710,"2016",9,2,24,35
312710,"2017",6,1,26,33
312710,"2018",13,2,28,43
312710,"2019",14,3,22,39
312710,"2020",9,1,17,27
312710,"2021",5,2,11,18
312710,"2022",5,2,16,23
312710,"2023",2,3,4,9
312720,"2015",2,0,2,4
312720,"2016",3,0,2,5
312720,"2017",0,1,4,5
312720,"2018",2,1,2,5
312720,"2019",0,1,1,2
312720,"2020",0,1,2,3
312720,"2021",0,1,2,3
312720,"2022",0,0,3,3
312720,"2023",0,1,0,1
312730,"2015",4,0,5,9
312730,"2016",1,0,3,4
312730,"2017",1,0,1,2
312730,"2018",0,0,6,6
312730,"2019",1,1,2,4
312730,"2020",1,0,1,2
312730,"2021",0,1,5,6
312730,"2022",1,0,1,2
312730,"2023",0,2,5,7
312733,"2015",1,1,1,3
312733,"2016",1,0,2,3
312733,"2017",1,0,2,3
312733,"2018",0,0,2,2
312733,"2019",2,0,3,5
312733,"2020",0,0,1,1
312733,"2021",0,0,2,2
312733,"2022",2,0,2,4
312735,"2016",1,0,1,2
312735,"2018",2,0,0,2
312735,"2021",1,1,1,3
312737,"2015",1,0,0,1
312737,"2017",0,0,3,3
312737,"2018",0,3,0,3
312737,"2019",1,0,0,1
312737,"2022",0,1,0,1
312737,"2023",1,0,0,1
312738,"2015",0,2,1,3
312738,"2016",1,0,0,1
312738,"2017",0,1,2,3
312738,"2018",0,2,1,3
312738,"2019",1,0,0,1
312738,"2021",1,0,1,2
312738,"2022",0,0,1,1
312738,"2023",1,0,0,1
312740,"2017",0,0,1,1
312740,"2019",1,0,0,1
312740,"2022",0,0,1,1
312750,"2015",1,0,1,2
312750,"2016",1,0,2,3
312750,"2017",0,1,1,2
312750,"2018",3,1,3,7
312750,"2019",1,0,0,1
312750,"2020",1,0,1,2
312750,"2022",0,0,2,2
312750,"2023",1,0,2,3
312760,"2015",4,1,2,7
312760,"2016",1,0,4,5
312760,"2017",7,1,3,11
312760,"2018",3,3,5,11
312760,"2019",5,1,4,10
312760,"2020",2,1,2,5
312760,"2021",3,2,2,7
312760,"2022",2,2,4,8
312760,"2023",5,0,2,7
312770,"2015",63,20,126,209
312770,"2016",56,21,104,181
312770,"2017",66,13,98,177
312770,"2018",87,20,94,201
312770,"2019",81,17,116,214
312770,"2020",43,22,74,139
312770,"2021",49,22,92,163
312770,"2022",54,22,76,152
312770,"2023",38,11,62,111
312780,"2015",5,1,8,14
312780,"2016",6,1,5,12
312780,"2017",5,3,12,20
312780,"2018",5,0,3,8
312780,"2019",1,2,5,8
312780,"2020",2,0,1,3
312780,"2021",0,0,3,3
312780,"2022",0,1,0,1
312780,"2023",2,2,4,8
312790,"2017",0,0,1,1
312800,"2015",23,4,33,60
312800,"2016",16,4,17,37
312800,"2017",14,7,23,44
312800,"2018",15,10,24,49
312800,"2019",26,4,14,44
312800,"2020",9,3,15,27
312800,"2021",11,2,17,30
312800,"2022",15,7,19,41
312800,"2023",10,4,18,32
312810,"2015",1,1,1,3
312810,"2016",0,2,2,4
312810,"2017",4,0,1,5
312810,"2018",2,1,2,5
312810,"2019",1,0,0,1
312810,"2020",1,1,3,5
312810,"2021",2,0,1,3
312810,"2023",2,0,3,5
312820,"2015",1,0,1,2
312820,"2018",0,0,1,1
312820,"2020",0,0,4,4
312820,"2021",1,0,3,4
312820,"2022",1,0,0,1
312825,"2015",1,0,3,4
312825,"2017",1,1,0,2
312825,"2018",2,1,2,5
312825,"2019",1,2,3,6
312825,"2020",4,0,2,6
312825,"2021",5,0,3,8
312825,"2022",1,1,5,7
312825,"2023",3,2,2,7
312830,"2015",5,0,6,11
312830,"2016",3,1,3,7
312830,"2017",4,0,5,9
312830,"2018",0,2,4,6
312830,"2019",0,2,0,2
312830,"2020",3,1,5,9
312830,"2021",3,0,6,9
312830,"2022",4,0,1,5
312830,"2023",3,0,2,5
312840,"2015",1,0,3,4
312840,"2016",2,0,2,4
312840,"2017",0,0,4,4
312840,"2018",2,0,0,2
312840,"2019",2,0,1,3
312840,"2020",1,0,1,2
312840,"2021",1,0,1,2
312840,"2022",0,0,1,1
312840,"2023",1,0,4,5
312850,"2015",2,0,1,3
312850,"2016",1,0,1,2
312850,"2017",0,1,0,1
312850,"2019",1,0,0,1
312850,"2020",1,0,1,2
312850,"2021",1,0,0,1
312850,"2022",0,0,1,1
312850,"2023",0,0,1,1
312860,"2016",2,0,2,4
312860,"2017",0,0,1,1
312860,"2018",0,0,2,2
312860,"2020",1,0,0,1
312860,"2022",1,0,2,3
312870,"2015",7,4,16,27
312870,"2016",13,5,18,36
312870,"2017",11,0,7,18
312870,"2018",16,4,17,37
312870,"2019",10,1,17,28
312870,"2020",8,2,17,27
312870,"2021",8,1,9,18
312870,"2022",6,3,17,26
312870,"2023",4,2,9,15
312880,"2015",2,0,0,2
312880,"2016",4,0,0,4
312880,"2017",2,2,4,8
312880,"2018",3,0,7,10
312880,"2019",1,0,3,4
312880,"2020",1,0,0,1
312880,"2021",1,1,1,3
312880,"2022",1,0,0,1
312880,"2023",2,0,1,3
312890,"2015",0,0,1,1
312890,"2016",1,1,0,2
312890,"2017",2,1,1,4
312890,"2018",1,0,0,1
312890,"2019",2,0,3,5
312890,"2020",1,0,1,2
312890,"2021",1,0,3,4
312890,"2022",1,2,0,3
312900,"2015",0,0,3,3
312900,"2016",1,0,3,4
312900,"2017",2,0,1,3
312900,"2018",2,0,1,3
312900,"2020",3,0,3,6
312900,"2021",0,0,3,3
312900,"2022",0,0,1,1
312900,"2023",2,0,1,3
312910,"2016",0,0,2,2
312910,"2017",0,0,2,2
312910,"2018",0,0,1,1
312910,"2019",0,0,1,1
312910,"2021",0,0,1,1
312910,"2022",1,0,0,1
312910,"2023",1,0,0,1
312920,"2015",1,0,1,2
312920,"2016",5,0,3,8
312920,"2017",3,0,3,6
312920,"2018",4,0,0,4
312920,"2019",0,0,1,1
312920,"2021",1,1,2,4
312920,"2022",5,1,1,7
312920,"2023",1,1,1,3
312930,"2015",1,1,3,5
312930,"2016",0,0,3,3
312930,"2017",1,1,0,2
312930,"2018",4,1,0,5
312930,"2019",3,0,0,3
312930,"2020",2,1,2,5
312930,"2021",0,0,2,2
312930,"2022",1,0,2,3
312940,"2015",1,0,1,2
312940,"2016",0,0,1,1
312940,"2017",2,0,6,8
312940,"2018",2,0,1,3
312940,"2019",3,0,3,6
312940,"2020",0,0,3,3
312940,"2021",3,0,0,3
312940,"2022",1,1,1,3
312940,"2023",0,1,0,1
312950,"2015",4,0,5,9
312950,"2016",0,0,2,2
312950,"2017",3,0,4,7
312950,"2018",2,0,1,3
312950,"2019",1,2,4,7
312950,"2020",3,1,9,13
312950,"2021",5,3,4,12
312950,"2022",2,0,3,5
312950,"2023",2,0,4,6
312960,"2015",2,0,2,4
312960,"2016",0,2,1,3
312960,"2017",0,0,4,4
312960,"2018",8,1,4,13
312960,"2019",2,2,2,6
312960,"2020",0,0,2,2
312960,"2021",1,0,2,3
312960,"2022",2,0,3,5
312960,"2023",0,0,4,4
312965,"2015",1,0,3,4
312965,"2016",1,0,2,3
312965,"2017",4,3,3,10
312965,"2018",3,1,4,8
312965,"2019",2,1,1,4
312965,"2020",1,2,2,5
312965,"2021",1,1,1,3
312965,"2022",2,2,0,4
312965,"2023",1,0,2,3
312970,"2015",2,3,2,7
312970,"2016",1,1,6,8
312970,"2017",2,4,7,13
312970,"2018",2,0,8,10
312970,"2019",7,0,3,10
312970,"2020",6,1,7,14
312970,"2021",5,1,8,14
312970,"2022",4,0,7,11
312970,"2023",5,2,5,12
312980,"2015",41,13,90,144
312980,"2016",44,14,95,153
312980,"2017",48,12,95,155
312980,"2018",52,13,84,149
312980,"2019",52,10,91,153
312980,"2020",39,8,65,112
312980,"2021",37,9,51,97
312980,"2022",24,15,55,94
312980,"2023",14,6,26,46
312990,"2015",1,0,1,2
312990,"2016",1,0,4,5
312990,"2017",0,0,2,2
312990,"2019",0,1,1,2
312990,"2021",0,0,1,1
312990,"2022",1,0,1,2
312990,"2023",0,1,0,1
313000,"2016",0,1,0,1
313000,"2017",0,0,1,1
313000,"2020",1,0,0,1
313000,"2022",0,1,0,1
313000,"2023",0,0,2,2
313005,"2015",0,3,9,12
313005,"2016",4,0,11,15
313005,"2017",5,1,7,13
313005,"2018",1,2,7,10
313005,"2019",3,2,6,11
313005,"2020",1,0,4,5
313005,"2021",1,2,0,3
313005,"2022",1,0,1,2
313005,"2023",1,1,0,2
313010,"2015",16,2,16,34
313010,"2016",7,7,21,35
313010,"2017",6,0,13,19
313010,"2018",3,5,20,28
313010,"2019",8,3,14,25
313010,"2020",12,3,13,28
313010,"2021",4,2,11,17
313010,"2022",8,3,15,26
313010,"2023",5,4,6,15
313020,"2015",1,0,6,7
313020,"2016",1,0,4,5
313020,"2017",0,0,4,4
313020,"2018",1,1,2,4
313020,"2019",4,0,8,12
313020,"2020",2,0,6,8
313020,"2021",2,2,2,6
313020,"2022",2,0,3,5
313020,"2023",1,0,0,1
313030,"2015",0,0,1,1
313030,"2016",1,0,0,1
313030,"2017",0,0,3,3
313030,"2018",2,0,2,4
313030,"2019",2,0,1,3
313030,"2020",0,0,2,2
313030,"2021",1,0,0,1
313030,"2022",1,0,3,4
313040,"2015",4,0,2,6
313040,"2016",2,1,6,9
313040,"2017",3,0,0,3
313040,"2018",0,0,5,5
313040,"2019",2,0,7,9
313040,"2020",2,0,5,7
313040,"2021",0,0,4,4
313040,"2022",2,0,4,6
313040,"2023",1,1,2,4
313050,"2015",2,0,0,2
313050,"2016",0,0,2,2
313050,"2017",0,0,3,3
313050,"2018",0,0,3,3
313050,"2019",4,1,4,9
313050,"2020",5,0,7,12
313050,"2021",2,0,2,4
313050,"2022",4,0,5,9
313050,"2023",1,0,8,9
313055,"2015",0,0,5,5
313055,"2016",2,0,2,4
313055,"2017",4,1,5,10
313055,"2018",5,0,3,8
313055,"2019",2,1,1,4
313055,"2020",4,0,2,6
313055,"2021",3,0,2,5
313055,"2022",2,0,5,7
313055,"2023",1,1,2,4
313060,"2015",2,0,5,7
313060,"2016",2,0,2,4
313060,"2017",2,0,4,6
313060,"2018",2,0,1,3
313060,"2019",3,1,2,6
313060,"2020",1,1,1,3
313060,"2021",0,0,1,1
313060,"2022",0,0,1,1
313060,"2023",1,2,1,4
313065,"2015",3,1,2,6
313065,"2016",1,2,2,5
313065,"2017",0,0,3,3
313065,"2018",1,0,4,5
313065,"2019",2,1,1,4
313065,"2020",2,1,2,5
313065,"2021",1,0,2,3
313065,"2022",2,0,0,2
313065,"2023",0,0,2,2
313070,"2015",1,0,0,1
313070,"2016",1,0,1,2
313070,"2017",0,0,2,2
313070,"2019",1,0,1,2
313070,"2020",0,0,3,3
313070,"2021",2,1,1,4
313070,"2022",1,0,0,1
313080,"2015",0,1,2,3
313080,"2016",1,1,0,2
313080,"2017",0,1,2,3
313080,"2018",1,0,1,2
313080,"2019",0,0,2,2
313080,"2020",0,0,1,1
313080,"2022",1,0,1,2
313080,"2023",1,0,0,1
313090,"2015",8,1,13,22
313090,"2016",8,2,16,26
313090,"2017",4,4,9,17
313090,"2018",2,1,6,9
313090,"2019",2,0,5,7
313090,"2020",8,0,8,16
313090,"2021",5,0,9,14
313090,"2022",5,0,6,11
313090,"2023",1,0,3,4
313100,"2015",2,0,1,3
313100,"2016",1,0,1,2
313100,"2017",3,0,1,4
313100,"2018",3,0,1,4
313100,"2019",2,0,1,3
313100,"2020",0,3,3,6
313100,"2021",3,1,1,5
313100,"2022",3,0,2,5
313100,"2023",1,0,3,4
313110,"2015",3,0,5,8
313110,"2016",2,0,3,5
313110,"2017",2,0,2,4
313110,"2018",6,0,1,7
313110,"2019",3,0,3,6
313110,"2020",1,1,4,6
313110,"2021",4,1,0,5
313110,"2022",2,1,3,6
313110,"2023",3,0,2,5
313115,"2015",3,0,5,8
313115,"2016",0,1,4,5
313115,"2017",1,0,5,6
313115,"2018",2,0,2,4
313115,"2019",3,1,6,10
313115,"2020",3,0,3,6
313115,"2021",2,1,3,6
313115,"2022",1,0,3,4
313115,"2023",0,0,2,2
313120,"2015",4,2,8,14
313120,"2016",6,3,6,15
313120,"2017",8,1,7,16
313120,"2018",6,2,16,24
313120,"2019",5,3,16,24
313120,"2020",6,3,13,22
313120,"2021",1,2,7,10
313120,"2022",6,2,7,15
313120,"2023",3,0,6,9
313130,"2015",56,25,88,169
313130,"2016",49,19,66,134
313130,"2017",41,12,71,124
313130,"2018",43,13,63,119
313130,"2019",34,15,46,95
313130,"2020",19,9,28,56
313130,"2021",15,6,28,49
313130,"2022",15,5,28,48
313130,"2023",18,7,17,42
313140,"2015",0,0,1,1
313140,"2020",0,1,1,2
313140,"2023",0,0,2,2
313150,"2015",1,1,1,3
313150,"2016",1,0,3,4
313150,"2017",0,0,5,5
313150,"2018",3,0,2,5
313150,"2019",0,1,3,4
313150,"2020",1,0,1,2
313150,"2021",1,0,1,2
313150,"2022",2,0,4,6
313160,"2015",0,1,4,5
313160,"2016",2,0,1,3
313160,"2018",0,0,1,1
313160,"2019",0,0,2,2
313160,"2020",1,0,0,1
313160,"2021",1,1,4,6
313160,"2023",1,1,1,3
313170,"2015",35,10,59,104
313170,"2016",35,9,55,99
313170,"2017",23,6,45,74
313170,"2018",23,6,30,59
313170,"2019",22,8,32,62
313170,"2020",19,2,23,44
313170,"2021",23,9,23,55
313170,"2022",25,5,36,66
313170,"2023",24,4,23,51
313180,"2015",0,0,2,2
313180,"2016",2,0,3,5
313180,"2017",1,0,0,1
313180,"2018",2,0,1,3
313180,"2019",1,0,2,3
313180,"2021",0,1,0,1
313180,"2023",0,0,3,3
313190,"2015",5,0,10,15
313190,"2016",10,4,19,33
313190,"2017",15,1,16,32
313190,"2018",6,5,11,22
313190,"2019",12,4,21,37
313190,"2020",6,3,24,33
313190,"2021",10,1,13,24
313190,"2022",17,4,12,33
313190,"2023",8,2,12,22
313200,"2015",0,1,2,3
313200,"2016",3,1,0,4
313200,"2017",1,0,0,1
313200,"2018",2,0,0,2
313200,"2019",1,0,0,1
313200,"2020",1,0,2,3
313200,"2021",0,1,0,1
313200,"2022",1,0,0,1
313210,"2015",0,3,10,13
313210,"2016",0,1,6,7
313210,"2017",2,2,8,12
313210,"2018",6,0,5,11
313210,"2019",1,0,2,3
313210,"2020",3,2,5,10
313210,"2021",2,0,5,7
313210,"2022",1,2,4,7
313210,"2023",2,2,3,7
313220,"2015",4,1,3,8
313220,"2016",8,2,7,17
313220,"2017",3,1,8,12
313220,"2018",8,1,2,11
313220,"2019",3,2,2,7
313220,"2020",3,2,4,9
313220,"2021",7,4,5,16
313220,"2022",4,0,7,11
313220,"2023",5,2,7,14
313230,"2015",0,0,1,1
313230,"2016",1,0,1,2
313230,"2017",1,0,3,4
313230,"2018",1,0,2,3
313230,"2019",2,0,1,3
313230,"2020",1,1,4,6
313230,"2021",2,0,3,5
313230,"2022",4,0,4,8
313230,"2023",1,1,7,9
313240,"2015",10,3,21,34
313240,"2016",20,7,25,52
313240,"2017",20,5,22,47
313240,"2018",11,6,17,34
313240,"2019",11,4,20,35
313240,"2020",8,7,9,24
313240,"2021",10,3,20,33
313240,"2022",12,3,19,34
313240,"2023",19,3,11,33
313250,"2015",11,3,18,32
313250,"2016",14,2,22,38
313250,"2017",17,1,7,25
313250,"2018",9,2,18,29
313250,"2019",16,3,9,28
313250,"2020",11,8,19,38
313250,"2021",3,1,12,16
313250,"2022",9,0,6,15
313250,"2023",6,1,3,10
313260,"2016",1,0,0,1
313260,"2018",0,0,1,1
313260,"2019",0,0,1,1
313260,"2020",0,0,2,2
313260,"2021",0,1,4,5
313260,"2022",1,0,0,1
313260,"2023",1,0,0,1
313270,"2015",6,0,11,17
313270,"2016",4,1,12,17
313270,"2017",4,3,18,25
313270,"2018",5,3,20,28
313270,"2019",7,1,8,16
313270,"2020",2,0,13,15
313270,"2021",8,0,10,18
313270,"2022",3,4,9,16
313270,"2023",3,0,3,6
313280,"2015",1,0,0,1
313280,"2016",1,0,1,2
313280,"2017",0,0,2,2
313280,"2018",1,0,1,2
313280,"2019",1,0,0,1
313280,"2020",1,1,0,2
313280,"2023",0,1,0,1
313290,"2015",1,0,0,1
313290,"2016",1,0,0,1
313290,"2017",0,0,1,1
313290,"2019",1,0,0,1
313290,"2020",0,0,1,1
313290,"2021",1,1,2,4
313290,"2022",2,0,5,7
313290,"2023",2,0,3,5
313300,"2015",5,1,9,15
313300,"2016",2,1,8,11
313300,"2017",6,0,10,16
313300,"2018",1,2,0,3
313300,"2019",1,0,2,3
313300,"2020",3,1,3,7
313300,"2021",4,1,1,6
313300,"2022",2,0,4,6
313300,"2023",0,0,1,1
313310,"2015",4,1,6,11
313310,"2016",1,1,4,6
313310,"2017",1,0,2,3
313310,"2018",4,1,5,10
313310,"2019",4,0,4,8
313310,"2020",1,0,4,5
313310,"2021",2,0,4,6
313310,"2022",3,0,3,6
313310,"2023",0,1,5,6
313320,"2015",2,1,3,6
313320,"2016",2,0,3,5
313320,"2017",1,0,15,16
313320,"2018",0,0,2,2
313320,"2019",2,1,2,5
313320,"2020",0,1,1,2
313320,"2021",2,0,0,2
313320,"2022",1,0,3,4
313320,"2023",0,0,1,1
313330,"2015",4,2,10,16
313330,"2016",13,0,9,22
313330,"2017",9,1,15,25
313330,"2018",6,0,12,18
313330,"2019",6,4,11,21
313330,"2020",13,3,14,30
313330,"2021",9,3,16,28
313330,"2022",7,0,11,18
313330,"2023",4,9,16,29
313340,"2015",1,0,5,6
313340,"2016",1,0,1,2
313340,"2017",1,0,0,1
313340,"2018",0,1,3,4
313340,"2019",2,0,1,3
313340,"2020",1,1,1,3
313340,"2022",0,0,1,1
313350,"2015",1,0,1,2
313350,"2016",1,0,5,6
313350,"2017",4,0,5,9
313350,"2018",0,0,3,3
313350,"2019",5,0,9,14
313350,"2020",5,0,2,7
313350,"2021",0,0,3,3
313350,"2022",0,0,3,3
313350,"2023",1,0,2,3
313360,"2015",1,0,4,5
313360,"2016",2,1,1,4
313360,"2017",2,1,3,6
313360,"2018",4,0,4,8
313360,"2019",3,1,8,12
313360,"2020",0,1,1,2
313360,"2021",1,0,3,4
313360,"2022",0,2,0,2
313360,"2023",3,0,2,5
313370,"2015",1,0,6,7
313370,"2016",1,1,2,4
313370,"2017",2,1,1,4
313370,"2018",2,0,6,8
313370,"2019",4,0,3,7
313370,"2020",1,0,4,5
313370,"2021",4,0,3,7
313370,"2022",4,0,8,12
313370,"2023",4,0,1,5
313375,"2015",2,1,1,4
313375,"2016",0,1,2,3
313375,"2017",4,1,2,7
313375,"2018",3,1,2,6
313375,"2019",2,0,1,3
313375,"2020",1,0,1,2
313375,"2021",0,1,2,3
313375,"2022",5,2,1,8
313375,"2023",1,1,4,6
313380,"2015",19,6,25,50
313380,"2016",16,5,33,54
313380,"2017",17,5,27,49
313380,"2018",26,6,29,61
313380,"2019",25,7,43,75
313380,"2020",23,8,46,77
313380,"2021",14,8,26,48
313380,"2022",17,9,37,63
313380,"2023",13,3,20,36
313390,"2015",1,0,1,2
313390,"2016",0,0,4,4
313390,"2017",0,0,2,2
313390,"2018",4,1,4,9
313390,"2019",2,1,2,5
313390,"2020",0,1,2,3
313390,"2021",0,0,3,3
313390,"2023",1,0,0,1
313400,"2015",2,1,6,9
313400,"2016",4,2,4,10
313400,"2017",7,2,3,12
313400,"2018",2,1,8,11
313400,"2019",7,2,6,15
313400,"2020",0,0,3,3
313400,"2021",1,0,9,10
313400,"2022",4,3,4,11
313400,"2023",4,1,5,10
313410,"2015",3,0,0,3
313410,"2016",3,0,1,4
313410,"2017",3,0,2,5
313410,"2018",0,0,2,2
313410,"2019",0,0,5,5
313410,"2020",4,1,3,8
313410,"2021",2,0,3,5
313410,"2022",2,0,2,4
313410,"2023",5,0,3,8
313420,"2015",16,4,22,42
313420,"2016",8,0,26,34
313420,"2017",6,0,10,16
313420,"2018",3,0,7,10
313420,"2019",4,1,2,7
313420,"2020",6,1,13,20
313420,"2021",14,4,33,51
313420,"2022",17,10,27,54
313420,"2023",9,6,20,35
313430,"2015",1,0,2,3
313430,"2016",1,1,4,6
313430,"2017",1,0,1,2
313430,"2018",3,0,2,5
313430,"2019",3,1,1,5
313430,"2020",0,1,2,3
313430,"2021",0,3,1,4
313430,"2022",2,0,5,7
313430,"2023",2,1,0,3
313440,"2015",4,0,8,12
313440,"2016",3,0,7,10
313440,"2017",7,1,11,19
313440,"2018",2,0,9,11
313440,"2019",6,0,2,8
313440,"2020",6,1,10,17
313440,"2021",3,1,5,9
313440,"2022",1,1,4,6
313440,"2023",1,0,4,5
313450,"2015",1,0,2,3
313450,"2016",2,0,4,6
313450,"2017",2,0,1,3
313450,"2018",2,1,2,5
313450,"2019",1,1,4,6
313450,"2020",3,3,1,7
313450,"2021",1,1,1,3
313450,"2023",1,0,2,3
313460,"2015",7,0,6,13
313460,"2016",3,0,3,6
313460,"2017",2,0,0,2
313460,"2018",5,2,2,9
313460,"2019",3,3,5,11
313460,"2020",1,3,6,10
313460,"2021",5,2,6,13
313460,"2022",5,2,4,11
313460,"2023",4,0,0,4
313470,"2015",4,0,2,6
313470,"2016",3,0,4,7
313470,"2017",7,0,4,11
313470,"2018",2,4,6,12
313470,"2019",4,0,6,10
313470,"2020",3,1,2,6
313470,"2021",5,1,7,13
313470,"2022",2,0,5,7
313470,"2023",3,1,2,6
313480,"2015",2,0,3,5
313480,"2016",0,0,3,3
313480,"2017",1,0,1,2
313480,"2021",2,0,3,5
313480,"2022",3,0,2,5
313490,"2015",18,2,6,26
313490,"2016",6,0,9,15
313490,"2017",6,1,11,18
313490,"2018",10,1,12,23
313490,"2019",6,2,12,20
313490,"2020",11,2,17,30
313490,"2021",7,4,7,18
313490,"2022",11,2,2,15
313490,"2023",6,0,6,12
313500,"2015",0,0,1,1
313500,"2016",1,0,1,2
313500,"2017",1,0,2,3
313500,"2018",0,0,1,1
313500,"2019",0,1,1,2
313500,"2020",1,0,0,1
313500,"2021",0,0,1,1
313500,"2022",0,0,1,1
313505,"2015",6,1,15,22
313505,"2016",3,5,25,33
313505,"2017",12,3,36,51
313505,"2018",13,2,24,39
313505,"2019",10,1,11,22
313505,"2020",8,0,10,18
313505,"2021",8,5,15,28
313505,"2022",9,1,13,23
313505,"2023",10,3,21,34
313507,"2015",0,0,3,3
313507,"2016",0,0,3,3
313507,"2017",2,0,0,2
313507,"2018",0,0,1,1
313507,"2019",1,0,1,2
313507,"2021",1,0,1,2
313507,"2022",0,0,1,1
313507,"2023",0,1,1,2
313510,"2015",34,4,59,97
313510,"2016",16,5,53,74
313510,"2017",36,8,67,111
313510,"2018",43,10,51,104
313510,"2019",20,2,32,54
313510,"2020",21,1,29,51
313510,"2021",28,12,37,77
313510,"2022",34,10,49,93
313510,"2023",32,9,35,76
313520,"2015",12,4,22,38
313520,"2016",5,1,6,12
313520,"2017",21,7,35,63
313520,"2018",15,5,7,27
313520,"2019",10,1,12,23
313520,"2020",9,4,6,19
313520,"2021",10,5,17,32
313520,"2022",18,2,12,32
313520,"2023",1,1,10,12
313530,"2015",0,0,1,1
313530,"2016",1,0,2,3
313530,"2017",0,0,2,2
313530,"2018",1,0,1,2
313530,"2019",0,0,1,1
313530,"2020",0,0,1,1
313530,"2022",2,0,0,2
313535,"2015",1,0,3,4
313535,"2016",1,0,6,7
313535,"2017",2,2,5,9
313535,"2018",6,0,5,11
313535,"2019",3,0,1,4
313535,"2020",1,0,4,5
313535,"2021",2,2,4,8
313535,"2022",4,0,0,4
313540,"2015",1,0,2,3
313540,"2017",1,1,1,3
313540,"2019",1,1,1,3
313540,"2020",0,0,1,1
313540,"2023",0,1,0,1
313545,"2015",0,0,1,1
313545,"2018",0,0,1,1
313545,"2019",1,0,0,1
313545,"2022",1,0,0,1
313545,"2023",1,0,0,1
313550,"2016",0,0,1,1
313550,"2017",0,0,1,1
313550,"2018",0,1,1,2
313550,"2020",2,2,0,4
313550,"2021",3,2,5,10
313550,"2022",2,3,2,7
313550,"2023",1,0,0,1
313560,"2015",1,0,5,6
313560,"2016",0,0,1,1
313560,"2017",3,0,0,3
313560,"2018",2,0,3,5
313560,"2019",0,0,3,3
313560,"2020",1,0,1,2
313560,"2021",1,0,1,2
313560,"2022",2,0,1,3
313560,"2023",1,1,1,3
313570,"2015",2,0,4,6
313570,"2016",1,1,4,6
313570,"2017",2,0,2,4
313570,"2018",3,0,3,6
313570,"2019",0,0,4,4
313570,"2020",1,0,1,2
313570,"2021",1,0,3,4
313570,"2022",0,0,2,2
313570,"2023",3,0,1,4
313580,"2015",0,0,11,11
313580,"2016",2,0,6,8
313580,"2017",2,0,1,3
313580,"2018",1,0,5,6
313580,"2019",4,0,2,6
313580,"2020",3,0,4,7
313580,"2021",1,0,3,4
313580,"2022",1,0,4,5
313580,"2023",6,0,2,8
313590,"2015",2,0,2,4
313590,"2016",2,0,3,5
313590,"2017",2,0,0,2
313590,"2018",1,0,1,2
313590,"2019",2,0,0,2
313590,"2020",0,2,3,5
313590,"2021",0,1,0,1
313590,"2023",2,0,1,3
313600,"2015",0,0,1,1
313600,"2016",1,0,0,1
313600,"2017",2,0,1,3
313600,"2018",0,0,1,1
313600,"2019",1,0,1,2
313600,"2020",1,0,4,5
313600,"2021",1,0,0,1
313600,"2022",0,0,1,1
313600,"2023",0,0,2,2
313610,"2015",4,1,1,6
313610,"2016",1,0,1,2
313610,"2017",0,0,1,1
313610,"2018",1,0,0,1
313610,"2020",2,0,0,2
313610,"2022",1,2,1,4
313610,"2023",0,0,1,1
313620,"2015",31,6,31,68
313620,"2016",24,8,25,57
313620,"2017",19,9,31,59
313620,"2018",23,7,29,59
313620,"2019",25,6,24,55
313620,"2020",17,9,16,42
313620,"2021",12,7,21,40
313620,"2022",12,11,18,41
313620,"2023",14,3,16,33
313630,"2015",17,1,28,46
313630,"2016",10,1,33,44
313630,"2017",12,1,22,35
313630,"2018",11,3,27,41
313630,"2019",15,2,26,43
313630,"2020",9,0,17,26
313630,"2021",6,1,19,26
313630,"2022",9,1,14,24
313630,"2023",10,0,13,23
313640,"2015",1,0,1,2
313640,"2016",1,0,0,1
313640,"2017",0,0,2,2
313640,"2018",1,0,7,8
313640,"2019",1,0,0,1
313640,"2020",1,2,0,3
313640,"2021",0,0,1,1
313640,"2022",0,0,3,3
313640,"2023",1,0,1,2
313650,"2015",3,1,7,11
313650,"2016",0,0,4,4
313650,"2017",0,0,6,6
313650,"2018",2,0,2,4
313650,"2019",4,0,2,6
313650,"2020",0,2,12,14
313650,"2021",1,1,7,9
313650,"2022",4,1,5,10
313650,"2023",2,1,4,7
313652,"2015",2,0,1,3
313652,"2016",2,0,2,4
313652,"2017",3,0,1,4
313652,"2018",1,0,5,6
313652,"2020",5,1,1,7
313652,"2021",2,0,2,4
313652,"2022",3,0,1,4
313652,"2023",2,0,0,2
313655,"2015",1,0,3,4
313655,"2016",0,0,4,4
313655,"2017",0,2,1,3
313655,"2018",1,2,0,3
313655,"2019",0,0,3,3
313655,"2020",2,2,0,4
313655,"2021",0,1,2,3
313655,"2022",1,1,0,2
313655,"2023",1,0,2,3
313657,"2015",1,1,0,2
313657,"2016",0,0,1,1
313657,"2017",2,0,2,4
313657,"2018",2,0,0,2
313657,"2019",0,0,4,4
313657,"2020",1,0,2,3
313657,"2021",0,0,3,3
313657,"2022",2,2,2,6
313657,"2023",0,0,2,2
313660,"2015",0,0,2,2
313660,"2016",1,0,3,4
313660,"2017",4,1,4,9
313660,"2018",5,0,5,10
313660,"2019",7,0,2,9
313660,"2020",0,0,2,2
313660,"2021",5,1,2,8
313660,"2022",2,0,3,5
313660,"2023",1,1,3,5
313665,"2015",5,1,7,13
313665,"2016",6,1,13,20
313665,"2017",6,0,11,17
313665,"2018",7,0,15,22
313665,"2019",5,1,9,15
313665,"2020",6,0,8,14
313665,"2021",8,4,6,18
313665,"2022",8,3,9,20
313665,"2023",4,1,6,11
313670,"2015",131,46,260,437
313670,"2016",154,40,257,451
313670,"2017",130,25,243,398
313670,"2018",114,20,169,303
313670,"2019",119,22,204,345
313670,"2020",90,36,152,278
313670,"2021",109,31,163,303
313670,"2022",99,33,113,245
313670,"2023",81,19,103,203
313680,"2016",0,0,1,1
313680,"2017",0,2,0,2
313680,"2018",2,0,2,4
313680,"2019",0,1,1,2
313680,"2020",0,0,1,1
313680,"2022",1,0,1,2
313680,"2023",0,0,1,1
313690,"2015",5,1,4,10
313690,"2016",3,1,9,13
313690,"2017",6,0,7,13
313690,"2018",2,0,9,11
313690,"2019",2,1,3,6
313690,"2020",5,0,3,8
313690,"2021",3,1,3,7
313690,"2022",3,1,1,5
313690,"2023",1,0,0,1
313695,"2015",2,0,0,2
313695,"2016",4,0,2,6
313695,"2017",1,0,2,3
313695,"2018",0,0,1,1
313695,"2019",0,0,2,2
313695,"2020",3,0,0,3
313695,"2021",0,0,1,1
313695,"2022",1,1,1,3
313695,"2023",0,0,1,1
313700,"2015",4,1,6,11
313700,"2016",2,0,4,6
313700,"2017",4,3,11,18
313700,"2018",5,1,7,13
313700,"2019",3,0,6,9
313700,"2020",2,2,6,10
313700,"2021",3,1,3,7
313700,"2022",2,1,5,8
313700,"2023",1,0,2,3
313710,"2016",0,0,1,1
313710,"2017",1,0,0,1
313710,"2018",1,0,0,1
313710,"2019",2,1,0,3
313710,"2022",0,0,2,2
313710,"2023",0,0,1,1
313720,"2015",7,2,30,39
313720,"2016",8,0,21,29
313720,"2017",5,0,15,20
313720,"2018",8,1,16,25
313720,"2019",11,2,24,37
313720,"2020",6,1,9,16
313720,"2021",9,3,11,23
313720,"2022",10,1,13,24
313720,"2023",3,2,9,14
313730,"2015",2,0,2,4
313730,"2016",1,0,1,2
313730,"2017",2,0,1,3
313730,"2019",0,0,1,1
313730,"2020",1,1,1,3
313730,"2021",3,0,4,7
313730,"2022",1,0,0,1
313730,"2023",0,0,2,2
313740,"2015",1,1,4,6
313740,"2016",8,0,2,10
313740,"2017",1,2,6,9
313740,"2018",2,0,5,7
313740,"2019",5,1,4,10
313740,"2020",1,0,10,11
313740,"2021",0,0,2,2
313740,"2022",5,0,1,6
313740,"2023",1,0,1,2
313750,"2015",1,0,5,6
313750,"2016",0,2,6,8
313750,"2017",5,0,1,6
313750,"2018",2,0,2,4
313750,"2019",0,2,5,7
313750,"2020",2,0,2,4
313750,"2021",2,0,2,4
313750,"2022",2,0,4,6
313750,"2023",1,0,2,3
313753,"2015",2,0,0,2
313753,"2016",0,0,2,2
313753,"2017",2,0,1,3
313753,"2018",0,0,2,2
313753,"2019",2,0,0,2
313753,"2020",3,0,1,4
313753,"2021",1,0,2,3
313753,"2022",1,0,3,4
313753,"2023",1,0,2,3
313760,"2015",14,7,25,46
313760,"2016",15,5,24,44
313760,"2017",12,7,19,38
313760,"2018",14,2,14,30
313760,"2019",16,8,13,37
313760,"2020",5,2,11,18
313760,"2021",20,2,22,44
313760,"2022",11,5,16,32
313760,"2023",7,3,17,27
313770,"2015",2,0,7,9
313770,"2016",2,0,9,11
313770,"2017",5,0,6,11
313770,"2018",3,2,9,14
313770,"2019",3,0,6,9
313770,"2020",4,1,3,8
313770,"2021",1,0,4,5
313770,"2022",1,1,2,4
313770,"2023",3,0,3,6
313780,"2015",7,1,6,14
313780,"2016",7,4,5,16
313780,"2017",4,2,1,7
313780,"2018",1,2,4,7
313780,"2019",4,0,3,7
313780,"2020",5,1,1,7
313780,"2021",5,0,4,9
313780,"2022",2,1,4,7
313780,"2023",4,2,1,7
313790,"2015",0,0,2,2
313790,"2016",0,1,1,2
313790,"2017",2,0,0,2
313790,"2018",2,1,0,3
313790,"2019",1,0,1,2
313790,"2020",0,0,1,1
313790,"2021",1,0,1,2
313790,"2022",0,0,1,1
313800,"2018",0,0,1,1
313800,"2019",0,0,1,1
313800,"2020",0,0,1,1
313800,"2021",1,0,1,2
313810,"2015",0,0,3,3
313810,"2016",1,1,3,5
313810,"2017",2,1,4,7
313810,"2018",2,0,2,4
313810,"2019",0,0,2,2
313810,"2020",2,0,2,4
313810,"2021",0,1,4,5
313810,"2022",1,0,1,2
313810,"2023",3,0,5,8
313820,"2015",19,9,48,76
313820,"2016",34,9,52,95
313820,"2017",42,13,46,101
313820,"2018",31,9,57,97
313820,"2019",37,11,44,92
313820,"2020",23,11,36,70
313820,"2021",30,8,31,69
313820,"2022",20,13,31,64
313820,"2023",19,7,22,48
313830,"2017",0,0,1,1
313830,"2018",2,0,0,2
313835,"2015",1,0,3,4
313835,"2016",0,0,1,1
313835,"2017",2,2,1,5
313835,"2018",1,0,3,4
313835,"2019",1,0,2,3
313835,"2020",2,0,2,4
313835,"2021",1,0,2,3
313835,"2022",1,4,3,8
313840,"2015",20,4,21,45
313840,"2016",21,7,13,41
313840,"2017",12,5,27,44
313840,"2018",14,5,23,42
313840,"2019",20,7,27,54
313840,"2020",10,6,19,35
313840,"2021",11,4,15,30
313840,"2022",16,6,25,47
313840,"2023",11,0,14,25
313850,"2015",1,1,1,3
313850,"2021",2,0,1,3
313850,"2023",2,0,0,2
313860,"2015",4,0,3,7
313860,"2016",5,0,6,11
313860,"2017",4,0,4,8
313860,"2018",2,0,4,6
313860,"2019",2,1,2,5
313860,"2020",1,1,5,7
313860,"2021",1,1,5,7
313860,"2022",2,2,1,5
313860,"2023",1,1,1,3
313862,"2016",1,0,0,1
313862,"2017",0,0,2,2
313862,"2018",1,0,1,2
313862,"2019",0,0,1,1
313862,"2021",0,0,3,3
313862,"2022",1,0,1,2
313862,"2023",0,0,1,1
313865,"2015",3,0,8,11
313865,"2016",3,0,1,4
313865,"2017",5,0,8,13
313865,"2018",2,0,6,8
313865,"2019",4,1,6,11
313865,"2020",0,0,1,1
313865,"2021",5,0,2,7
313865,"2022",2,0,0,2
313867,"2015",2,1,6,9
313867,"2016",5,0,4,9
313867,"2017",4,0,3,7
313867,"2018",3,0,6,9
313867,"2019",2,0,4,6
313867,"2020",2,0,4,6
313867,"2021",0,0,3,3
313867,"2022",0,2,4,6
313867,"2023",1,2,2,5
313868,"2015",5,0,5,10
313868,"2016",1,0,4,5
313868,"2017",4,0,2,6
313868,"2018",2,0,3,5
313868,"2019",1,0,0,1
313868,"2020",1,0,1,2
313868,"2021",2,0,1,3
313868,"2022",4,0,4,8
313868,"2023",3,0,2,5
313870,"2015",1,2,6,9
313870,"2016",1,1,0,2
313870,"2017",2,0,0,2
313870,"2018",1,0,2,3
313870,"2019",1,1,3,5
313870,"2020",3,1,3,7
313870,"2021",1,0,2,3
313870,"2022",3,0,1,4
313880,"2015",2,1,11,14
313880,"2016",5,2,12,19
313880,"2017",4,2,11,17
313880,"2018",8,3,11,22
313880,"2019",4,1,12,17
313880,"2020",3,0,4,7
313880,"2021",5,2,8,15
313880,"2022",6,0,3,9
313880,"2023",2,2,3,7
313890,"2016",2,0,1,3
313890,"2017",0,1,1,2
313890,"2018",2,1,5,8
313890,"2019",0,0,1,1
313890,"2020",4,0,2,6
313890,"2021",0,1,2,3
313890,"2022",1,1,3,5
313890,"2023",0,0,1,1
313900,"2015",7,0,16,23
313900,"2016",8,2,7,17
313900,"2017",6,1,11,18
313900,"2018",6,4,10,20
313900,"2019",6,2,12,20
313900,"2020",5,1,4,10
313900,"2021",5,0,10,15
313900,"2022",8,2,7,17
313900,"2023",2,0,5,7
313910,"2016",3,0,1,4
313910,"2017",3,1,0,4
313910,"2018",2,2,0,4
313910,"2019",1,0,1,2
313910,"2021",1,1,2,4
313910,"2022",0,0,1,1
313920,"2015",3,0,2,5
313920,"2016",2,0,3,5
313920,"2017",0,0,3,3
313920,"2018",2,1,2,5
313920,"2019",2,0,0,2
313920,"2020",0,0,1,1
313920,"2021",0,0,1,1
313920,"2022",0,0,3,3
313925,"2015",4,0,1,5
313925,"2016",1,1,2,4
313925,"2017",2,1,1,4
313925,"2018",0,0,2,2
313925,"2019",5,0,0,5
313925,"2020",0,1,3,4
313925,"2021",1,0,0,1
313925,"2022",2,1,1,4
313925,"2023",3,0,1,4
313930,"2015",6,0,9,15
313930,"2016",4,2,5,11
313930,"2017",1,0,13,14
313930,"2018",5,0,11,16
313930,"2019",1,1,3,5
313930,"2020",5,1,6,12
313930,"2021",4,0,6,10
313930,"2022",3,0,4,7
313930,"2023",0,0,8,8
313940,"2015",25,8,44,77
313940,"2016",29,8,57,94
313940,"2017",28,10,83,121
313940,"2018",30,11,79,120
313940,"2019",15,3,21,39
313940,"2020",24,9,29,62
313940,"2021",28,2,23,53
313940,"2022",7,1,10,18
313940,"2023",9,2,16,27
313950,"2015",5,2,9,16
313950,"2016",3,2,15,20
313950,"2017",11,1,15,27
313950,"2018",3,5,12,20
313950,"2019",2,3,6,11
313950,"2020",5,3,9,17
313950,"2021",0,2,6,8
313950,"2022",0,1,2,3
313950,"2023",3,0,1,4
313960,"2015",6,2,10,18
313960,"2016",3,1,5,9
313960,"2017",1,0,5,6
313960,"2018",2,2,6,10
313960,"2019",3,2,2,7
313960,"2020",3,0,4,7
313960,"2021",2,0,6,8
313960,"2022",6,0,6,12
313960,"2023",5,3,8,16
313970,"2015",1,2,3,6
313970,"2016",2,0,2,4
313970,"2017",1,2,1,4
313970,"2018",1,1,1,3
313970,"2019",3,0,0,3
313970,"2020",1,2,1,4
313970,"2021",2,0,2,4
313970,"2022",1,0,1,2
313970,"2023",2,0,1,3
313980,"2015",5,1,6,12
313980,"2016",2,0,3,5
313980,"2017",1,0,5,6
313980,"2018",3,0,2,5
313980,"2019",5,1,5,11
313980,"2020",3,0,3,6
313980,"2021",5,0,3,8
313980,"2022",1,1,1,3
313980,"2023",2,1,4,7
313990,"2015",2,1,2,5
313990,"2016",3,1,4,8
313990,"2017",2,0,4,6
313990,"2018",1,0,3,4
313990,"2019",1,0,2,3
313990,"2020",0,0,2,2
313990,"2021",1,0,2,3
313990,"2023",2,2,4,8
314000,"2015",21,5,27,53
314000,"2016",13,11,25,49
314000,"2017",19,3,12,34
314000,"2018",16,2,32,50
314000,"2019",4,6,8,18
314000,"2020",4,0,13,17
314000,"2021",4,3,17,24
314000,"2022",14,2,17,33
314000,"2023",6,2,19,27
314010,"2015",1,0,1,2
314010,"2016",0,0,1,1
314010,"2017",2,0,0,2
314010,"2018",1,0,1,2
314010,"2019",2,0,0,2
314010,"2021",1,0,0,1
314010,"2023",0,0,1,1
314015,"2015",5,0,9,14
314015,"2016",4,0,2,6
314015,"2017",10,2,6,18
314015,"2018",8,0,2,10
314015,"2019",5,0,6,11
314015,"2020",2,2,3,7
314015,"2021",3,0,4,7
314015,"2022",3,0,6,9
314015,"2023",0,0,2,2
314020,"2015",0,0,2,2
314020,"2016",1,0,1,2
314020,"2017",1,1,0,2
314020,"2018",1,0,1,2
314020,"2019",0,1,1,2
314020,"2020",3,0,1,4
314020,"2022",0,1,1,2
314020,"2023",0,0,2,2
314030,"2015",0,2,3,5
314030,"2016",1,0,0,1
314030,"2017",1,0,2,3
314030,"2018",2,0,0,2
314030,"2019",1,0,1,2
314030,"2021",0,0,1,1
314030,"2023",0,0,1,1
314040,"2018",1,0,1,2
314040,"2020",0,0,1,1
314040,"2021",0,1,0,1
314050,"2015",0,0,2,2
314050,"2016",0,1,2,3
314050,"2017",2,0,0,2
314050,"2019",1,0,1,2
314050,"2020",2,1,1,4
314050,"2022",1,2,0,3
314050,"2023",0,0,6,6
314053,"2015",3,0,4,7
314053,"2016",3,0,6,9
314053,"2017",2,0,3,5
314053,"2018",2,1,7,10
314053,"2019",2,0,0,2
314053,"2020",4,1,5,10
314053,"2021",3,0,4,7
314053,"2022",1,0,2,3
314053,"2023",2,0,1,3
314055,"2015",2,0,5,7
314055,"2016",4,0,4,8
314055,"2017",3,0,6,9
314055,"2018",1,1,9,11
314055,"2019",2,3,4,9
314055,"2020",2,2,5,9
314055,"2021",5,1,8,14
314055,"2022",1,1,5,7
314055,"2023",1,0,5,6
314060,"2015",3,1,2,6
314060,"2016",0,0,3,3
314060,"2017",3,1,2,6
314060,"2018",1,0,4,5
314060,"2019",2,1,2,5
314060,"2020",1,0,2,3
314060,"2021",2,1,0,3
314060,"2023",2,1,1,4
314070,"2015",4,1,6,11
314070,"2016",5,1,20,26
314070,"2017",8,1,12,21
314070,"2018",10,1,9,20
314070,"2019",11,0,13,24
314070,"2020",4,1,10,15
314070,"2021",7,0,5,12
314070,"2022",7,2,5,14
314070,"2023",4,0,5,9
314080,"2015",1,0,4,5
314080,"2016",4,1,5,10
314080,"2017",5,1,4,10
314080,"2018",2,2,4,8
314080,"2019",3,3,3,9
314080,"2020",7,1,6,14
314080,"2021",3,0,1,4
314080,"2022",4,0,5,9
314080,"2023",1,0,4,5
314085,"2015",2,0,3,5
314085,"2016",1,1,4,6
314085,"2017",3,1,2,6
314085,"2018",1,0,2,3
314085,"2019",2,1,2,5
314085,"2020",1,0,2,3
314085,"2021",0,0,1,1
314085,"2022",4,0,2,6
314085,"2023",1,1,0,2
314090,"2015",7,0,10,17
314090,"2016",6,1,10,17
314090,"2017",3,4,19,26
314090,"2018",6,2,6,14
314090,"2019",7,1,5,13
314090,"2020",8,1,10,19
314090,"2021",1,0,4,5
314090,"2022",1,0,1,2
314090,"2023",0,0,6,6
314100,"2015",5,1,9,15
314100,"2016",4,2,15,21
314100,"2017",8,1,10,19
314100,"2018",5,2,7,14
314100,"2019",8,3,6,17
314100,"2020",1,2,5,8
314100,"2021",2,0,6,8
314100,"2022",5,1,4,10
314100,"2023",2,0,3,5
314110,"2015",6,1,15,22
314110,"2016",15,2,22,39
314110,"2017",10,2,19,31
314110,"2018",20,3,15,38
314110,"2019",8,4,15,27
314110,"2020",5,3,17,25
314110,"2021",10,2,15,27
314110,"2022",13,3,15,31
314110,"2023",8,1,9,18
314120,"2015",0,0,1,1
314120,"2016",0,0,2,2
314120,"2018",0,0,1,1
314120,"2019",0,0,1,1
314120,"2023",0,0,1,1
314130,"2017",0,0,1,1
314130,"2018",1,0,1,2
314130,"2019",0,2,0,2
314130,"2020",1,0,1,2
314130,"2021",1,0,1,2
314130,"2022",0,0,1,1
314140,"2015",5,3,10,18
314140,"2016",4,3,7,14
314140,"2017",3,2,6,11
314140,"2018",4,1,7,12
314140,"2019",4,1,6,11
314140,"2020",11,0,14,25
314140,"2021",10,1,14,25
314140,"2022",8,1,10,19
314140,"2023",3,1,11,15
314150,"2016",2,0,1,3
314150,"2017",1,0,2,3
314150,"2018",1,1,0,2
314150,"2019",0,0,1,1
314150,"2021",1,0,0,1
314150,"2022",3,0,1,4
314160,"2015",0,1,1,2
314160,"2016",0,0,1,1
314160,"2017",3,0,2,5
314160,"2018",4,1,4,9
314160,"2019",4,0,2,6
314160,"2020",3,1,6,10
314160,"2021",4,0,2,6
314160,"2022",1,1,5,7
314160,"2023",1,1,1,3
314170,"2015",1,0,2,3
314170,"2016",0,2,1,3
314170,"2017",1,0,4,5
314170,"2018",2,0,1,3
314170,"2019",0,0,1,1
314170,"2020",0,0,2,2
314170,"2021",1,0,0,1
314170,"2022",1,0,3,4
314180,"2015",7,0,9,16
314180,"2016",3,3,8,14
314180,"2017",7,0,10,17
314180,"2018",5,1,10,16
314180,"2019",2,1,9,12
314180,"2020",4,1,9,14
314180,"2021",3,1,9,13
314180,"2022",2,2,6,10
314180,"2023",6,1,6,13
314190,"2017",0,0,1,1
314190,"2019",0,1,0,1
314190,"2020",1,0,0,1
314190,"2021",1,0,0,1
314190,"2023",0,0,1,1
314200,"2015",1,0,4,5
314200,"2016",4,0,8,12
314200,"2017",2,2,14,18
314200,"2018",5,2,7,14
314200,"2019",4,2,7,13
314200,"2020",5,1,4,10
314200,"2021",9,1,4,14
314200,"2022",2,1,3,6
314200,"2023",0,2,2,4
314210,"2017",0,0,1,1
314220,"2015",0,1,3,4
314220,"2016",0,0,2,2
314220,"2017",2,0,4,6
314220,"2018",1,1,4,6
314220,"2019",2,1,1,4
314220,"2020",0,1,0,1
314220,"2021",1,0,0,1
314225,"2016",0,1,0,1
314225,"2017",0,0,2,2
314225,"2020",1,1,1,3
314225,"2022",1,0,1,2
314225,"2023",0,0,2,2
314230,"2015",3,2,1,6
314230,"2016",1,0,2,3
314230,"2017",0,0,2,2
314230,"2018",0,1,1,2
314230,"2019",3,0,1,4
314230,"2020",2,0,0,2
314230,"2021",0,1,0,1
314230,"2022",2,1,2,5
314230,"2023",1,1,1,3
314240,"2015",1,0,0,1
314240,"2016",0,0,1,1
314240,"2017",2,0,1,3
314240,"2019",1,0,1,2
314240,"2020",1,1,0,2
314240,"2021",1,0,0,1
314240,"2022",0,1,0,1
314240,"2023",0,0,1,1
314250,"2015",0,0,1,1
314250,"2016",1,1,0,2
314250,"2017",1,0,0,1
314250,"2018",0,0,1,1
314250,"2019",0,0,1,1
314250,"2020",4,0,4,8
314250,"2021",0,0,1,1
314250,"2022",1,0,0,1
314260,"2015",1,0,3,4
314260,"2016",1,0,1,2
314260,"2017",0,0,2,2
314260,"2018",1,0,0,1
314260,"2019",1,1,1,3
314260,"2020",1,0,1,2
314260,"2021",2,0,1,3
314260,"2022",1,0,2,3
314260,"2023",3,0,1,4
314270,"2015",1,0,2,3
314270,"2016",3,3,6,12
314270,"2017",2,0,2,4
314270,"2018",6,0,4,10
314270,"2019",1,2,4,7
314270,"2020",1,0,2,3
314270,"2021",1,0,2,3
314270,"2022",1,2,5,8
314270,"2023",3,1,1,5
314280,"2015",3,0,13,16
314280,"2016",2,1,7,10
314280,"2017",1,0,10,11
314280,"2018",5,1,6,12
314280,"2019",2,1,8,11
314280,"2020",4,0,8,12
314280,"2021",1,0,3,4
314280,"2022",2,0,2,4
314280,"2023",1,0,1,2
314290,"2015",6,0,4,10
314290,"2016",6,1,6,13
314290,"2017",9,2,5,16
314290,"2018",5,0,4,9
314290,"2019",7,2,10,19
314290,"2020",10,1,9,20
314290,"2021",5,4,7,16
314290,"2022",8,3,3,14
314290,"2023",3,5,2,10
314300,"2015",1,0,3,4
314300,"2016",1,0,6,7
314300,"2017",2,0,4,6
314300,"2018",5,0,4,9
314300,"2019",1,0,1,2
314300,"2020",1,0,2,3
314300,"2021",2,0,1,3
314300,"2022",0,0,1,1
314300,"2023",2,0,0,2
314310,"2015",1,1,7,9
314310,"2016",5,0,8,13
314310,"2017",2,3,12,17
314310,"2018",4,5,5,14
314310,"2019",2,1,12,15
314310,"2020",3,0,7,10
314310,"2021",2,0,4,6
314310,"2022",2,0,1,3
314310,"2023",1,1,5,7
314315,"2015",3,0,2,5
314315,"2016",0,0,1,1
314315,"2017",4,0,2,6
314315,"2018",1,0,1,2
314315,"2019",0,1,5,6
314315,"2020",0,0,6,6
314315,"2021",0,0,4,4
314315,"2022",2,0,3,5
314315,"2023",2,0,0,2
314320,"2015",4,0,2,6
314320,"2016",0,0,2,2
314320,"2017",4,0,1,5
314320,"2018",1,0,0,1
314320,"2020",3,0,1,4
314320,"2021",2,0,3,5
314320,"2022",1,2,3,6
314320,"2023",1,0,1,2
314330,"2015",175,40,263,478
314330,"2016",178,41,244,463
314330,"2017",158,37,262,457
314330,"2018",133,41,239,413
314330,"2019",150,38,195,383
314330,"2020",120,39,147,306
314330,"2021",142,37,175,354
314330,"2022",108,50,151,309
314330,"2023",90,40,106,236
314340,"2015",3,0,5,8
314340,"2016",5,1,6,12
314340,"2017",2,2,3,7
314340,"2018",1,3,7,11
314340,"2019",3,0,5,8
314340,"2020",6,2,7,15
314340,"2021",1,1,4,6
314340,"2022",1,1,1,3
314340,"2023",1,0,2,3
314345,"2015",2,0,1,3
314345,"2016",1,1,2,4
314345,"2017",3,0,0,3
314345,"2018",2,0,3,5
314345,"2019",1,1,2,4
314345,"2020",3,1,2,6
314345,"2021",2,0,2,4
314345,"2022",1,1,1,3
314345,"2023",2,0,2,4
314350,"2015",4,0,3,7
314350,"2016",3,1,6,10
314350,"2017",2,0,1,3
314350,"2018",1,1,1,3
314350,"2019",0,0,5,5
314350,"2020",2,1,2,5
314350,"2021",4,0,1,5
314350,"2022",2,1,2,5
314350,"2023",0,0,1,1
314360,"2015",1,0,1,2
314360,"2016",1,0,1,2
314360,"2017",1,0,1,2
314360,"2018",0,0,1,1
314360,"2019",0,0,2,2
314360,"2020",0,0,2,2
314360,"2021",1,0,1,2
314360,"2022",1,0,0,1
314360,"2023",0,1,0,1
314370,"2015",2,0,2,4
314370,"2016",0,0,1,1
314370,"2017",0,0,1,1
314370,"2019",1,1,0,2
314370,"2020",0,0,1,1
314370,"2023",0,0,1,1
314380,"2015",0,0,1,1
314380,"2016",2,0,1,3
314380,"2017",1,1,2,4
314380,"2018",2,0,4,6
314380,"2019",0,0,1,1
314380,"2020",1,3,2,6
314380,"2021",0,2,4,6
314380,"2022",1,0,1,2
314380,"2023",0,1,2,3
314390,"2015",1,0,1,2
314390,"2016",4,0,2,6
314390,"2017",0,1,3,4
314390,"2018",2,1,7,10
314390,"2019",1,1,3,5
314390,"2020",2,0,6,8
314390,"2021",3,1,4,8
314390,"2022",1,0,6,7
314390,"2023",5,1,5,11
314400,"2015",5,1,7,13
314400,"2016",7,2,9,18
314400,"2017",6,0,7,13
314400,"2018",7,3,8,18
314400,"2019",4,2,5,11
314400,"2020",3,0,6,9
314400,"2021",1,1,3,5
314400,"2022",1,1,2,4
314400,"2023",3,1,4,8
314410,"2015",1,0,7,8
314410,"2016",2,0,0,2
314410,"2017",3,0,4,7
314410,"2018",0,0,8,8
314410,"2019",2,0,5,7
314410,"2020",6,2,3,11
314410,"2021",3,1,5,9
314410,"2022",4,2,5,11
314410,"2023",2,0,5,7
314420,"2016",0,0,1,1
314420,"2018",0,0,1,1
314420,"2020",0,0,1,1
314420,"2021",1,0,0,1
314420,"2022",0,1,0,1
314420,"2023",1,0,0,1
314430,"2015",2,0,9,11
314430,"2016",1,0,1,2
314430,"2017",1,0,3,4
314430,"2018",4,2,14,20
314430,"2019",7,2,16,25
314430,"2020",4,4,17,25
314430,"2021",4,3,18,25
314430,"2022",4,1,7,12
314430,"2023",6,0,12,18
314435,"2015",0,0,2,2
314435,"2016",2,0,0,2
314435,"2018",2,0,7,9
314435,"2019",0,0,3,3
314435,"2021",1,0,1,2
314435,"2022",0,0,2,2
314435,"2023",1,0,0,1
314437,"2015",0,0,1,1
314437,"2016",2,0,2,4
314437,"2017",1,1,1,3
314437,"2018",1,0,2,3
314437,"2019",0,0,1,1
314437,"2020",0,1,1,2
314437,"2021",0,1,0,1
314437,"2022",0,1,0,1
314440,"2015",2,0,0,2
314440,"2016",2,0,0,2
314440,"2017",1,0,1,2
314440,"2018",2,0,0,2
314440,"2019",0,2,1,3
314440,"2021",0,1,0,1
314440,"2022",1,1,1,3
314450,"2015",0,0,2,2
314450,"2016",2,0,3,5
314450,"2017",1,0,0,1
314450,"2019",0,0,3,3
314450,"2020",1,0,1,2
314450,"2021",0,0,1,1
314450,"2022",1,1,1,3
314450,"2023",0,0,1,1
314460,"2015",5,0,9,14
314460,"2016",9,0,9,18
314460,"2017",4,3,11,18
314460,"2018",9,1,8,18
314460,"2019",13,0,7,20
314460,"2020",5,3,6,14
314460,"2021",8,1,7,16
314460,"2022",7,0,10,17
314460,"2023",3,1,10,14
314465,"2015",1,0,4,5
314465,"2016",1,2,4,7
314465,"2017",1,1,3,5
314465,"2018",1,1,5,7
314465,"2019",2,3,4,9
314465,"2020",2,0,2,4
314465,"2021",1,0,4,5
314465,"2022",5,1,2,8
314465,"2023",1,2,2,5
314467,"2015",1,0,0,1
314467,"2017",0,0,3,3
314467,"2018",1,0,1,2
314467,"2019",0,0,1,1
314467,"2021",1,0,0,1
314467,"2022",0,0,1,1
314470,"2015",3,4,9,16
314470,"2016",4,0,7,11
314470,"2017",3,2,3,8
314470,"2018",3,0,0,3
314470,"2019",3,4,4,11
314470,"2020",2,1,0,3
314470,"2021",2,0,2,4
314470,"2022",1,1,2,4
314470,"2023",2,1,7,10
314480,"2015",7,3,11,21
314480,"2016",12,4,14,30
314480,"2017",8,2,12,22
314480,"2018",5,0,15,20
314480,"2019",9,3,16,28
314480,"2020",12,1,19,32
314480,"2021",11,2,21,34
314480,"2022",8,2,21,31
314480,"2023",4,4,7,15
314490,"2015",0,1,1,2
314490,"2016",0,1,1,2
314490,"2019",2,0,3,5
314490,"2020",0,0,2,2
314490,"2021",0,0,1,1
314490,"2022",0,0,1,1
314490,"2023",0,0,1,1
314500,"2015",2,0,4,6
314500,"2016",2,0,6,8
314500,"2017",3,0,11,14
314500,"2018",1,0,2,3
314500,"2019",1,0,2,3
314500,"2020",1,0,1,2
314500,"2021",0,0,6,6
314500,"2022",1,0,0,1
314500,"2023",1,0,1,2
314505,"2015",3,0,10,13
314505,"2016",2,1,4,7
314505,"2017",3,0,11,14
314505,"2018",2,2,4,8
314505,"2019",1,0,1,2
314505,"2020",5,1,3,9
314505,"2021",0,0,2,2
314505,"2022",2,1,3,6
314505,"2023",1,1,5,7
314510,"2015",4,1,6,11
314510,"2016",6,1,3,10
314510,"2017",5,1,6,12
314510,"2018",4,1,3,8
314510,"2019",1,1,4,6
314510,"2020",7,0,3,10
314510,"2021",6,0,2,8
314510,"2022",1,1,5,7
314510,"2023",0,0,3,3
314520,"2015",5,0,7,12
314520,"2016",23,7,57,87
314520,"2017",49,12,89,150
314520,"2018",42,6,59,107
314520,"2019",43,8,56,107
314520,"2020",20,5,49,74
314520,"2021",20,2,43,65
314520,"2022",36,9,32,77
314520,"2023",16,4,25,45
314530,"2015",3,1,10,14
314530,"2016",5,3,8,16
314530,"2017",5,0,7,12
314530,"2018",0,0,8,8
314530,"2019",1,0,6,7
314530,"2020",0,1,2,3
314530,"2021",0,0,4,4
314530,"2022",1,0,2,3
314530,"2023",1,0,2,3
314535,"2015",2,0,4,6
314535,"2016",2,1,3,6
314535,"2017",3,3,1,7
314535,"2018",2,1,1,4
314535,"2019",2,0,6,8
314535,"2020",1,2,1,4
314535,"2021",1,0,2,3
314535,"2022",1,0,3,4
314535,"2023",2,0,3,5
314537,"2015",2,0,2,4
314537,"2016",3,0,2,5
314537,"2017",1,1,2,4
314537,"2018",1,0,3,4
314537,"2019",1,0,3,4
314537,"2020",1,0,4,5
314537,"2021",3,0,2,5
314537,"2022",0,1,4,5
314537,"2023",1,0,4,5
314540,"2015",0,0,1,1
314540,"2016",0,0,1,1
314540,"2018",1,0,0,1
314540,"2021",1,1,1,3
314540,"2022",0,0,3,3
314545,"2015",1,1,3,5
314545,"2016",1,1,3,5
314545,"2017",4,1,3,8
314545,"2018",2,0,1,3
314545,"2019",3,0,2,5
314545,"2020",1,2,7,10
314545,"2021",3,0,4,7
314545,"2022",1,0,0,1
314550,"2016",1,1,0,2
314550,"2017",0,0,1,1
314550,"2019",0,0,1,1
314550,"2020",1,0,1,2
314550,"2022",0,1,0,1
314560,"2015",12,0,16,28
314560,"2016",10,2,10,22
314560,"2017",11,1,9,21
314560,"2018",6,4,13,23
314560,"2019",12,0,15,27
314560,"2020",6,0,8,14
314560,"2021",3,5,6,14
314560,"2022",4,2,10,16
314560,"2023",4,3,3,10
314570,"2015",2,0,0,2
314570,"2016",1,0,1,2
314570,"2017",0,0,1,1
314570,"2018",1,0,1,2
314570,"2019",0,0,1,1
314570,"2020",1,0,0,1
314570,"2021",1,0,0,1
314570,"2023",1,0,1,2
314580,"2015",1,0,1,2
314580,"2016",2,1,2,5
314580,"2017",0,0,1,1
314580,"2018",1,0,2,3
314580,"2019",2,0,3,5
314580,"2020",0,0,1,1
314580,"2021",2,0,0,2
314580,"2022",1,0,0,1
314580,"2023",0,0,2,2
314585,"2016",1,0,0,1
314585,"2018",3,0,1,4
314585,"2020",1,0,0,1
314585,"2021",1,0,3,4
314585,"2022",0,1,4,5
314587,"2015",2,1,1,4
314587,"2016",0,1,3,4
314587,"2017",2,0,4,6
314587,"2018",1,0,3,4
314587,"2019",2,1,2,5
314587,"2020",1,0,1,2
314587,"2021",0,1,5,6
314587,"2022",1,1,3,5
314587,"2023",1,0,2,3
314590,"2015",3,1,10,14
314590,"2016",4,1,12,17
314590,"2017",17,5,18,40
314590,"2018",5,1,9,15
314590,"2019",4,0,2,6
314590,"2020",2,1,3,6
314590,"2021",5,0,7,12
314590,"2022",5,0,6,11
314590,"2023",4,2,11,17
314600,"2015",6,2,7,15
314600,"2016",16,0,5,21
314600,"2017",3,3,10,16
314600,"2018",7,4,7,18
314600,"2019",6,2,13,21
314600,"2020",2,0,12,14
314600,"2021",7,0,4,11
314600,"2022",8,3,6,17
314600,"2023",7,1,7,15
314610,"2015",2,2,10,14
314610,"2016",17,3,32,52
314610,"2017",12,6,26,44
314610,"2018",11,3,26,40
314610,"2019",4,1,28,33
314610,"2020",13,1,22,36
314610,"2021",12,5,15,32
314610,"2022",8,2,18,28
314610,"2023",10,4,14,28
314620,"2015",0,0,2,2
314620,"2016",0,0,3,3
314620,"2017",1,0,1,2
314620,"2018",0,0,1,1
314620,"2019",0,1,1,2
314620,"2020",1,0,1,2
314620,"2021",0,1,6,7
314620,"2022",1,2,1,4
314620,"2023",2,1,1,4
314625,"2015",1,0,1,2
314625,"2016",2,1,4,7
314625,"2017",1,1,1,3
314625,"2018",1,0,4,5
314625,"2019",4,0,1,5
314625,"2020",4,0,4,8
314625,"2021",4,1,1,6
314625,"2022",3,0,3,6
314625,"2023",1,0,0,1
314630,"2015",3,1,4,8
314630,"2016",2,0,3,5
314630,"2017",5,0,6,11
314630,"2018",5,1,4,10
314630,"2019",1,1,6,8
314630,"2020",3,1,2,6
314630,"2021",3,0,6,9
314630,"2022",1,2,0,3
314630,"2023",2,0,2,4
314640,"2015",1,0,1,2
314640,"2016",0,0,1,1
314640,"2017",1,0,0,1
314640,"2018",2,2,1,5
314640,"2019",1,0,0,1
314640,"2021",1,0,2,3
314650,"2015",4,0,3,7
314650,"2016",2,1,2,5
314650,"2017",3,0,0,3
314650,"2018",4,0,1,5
314650,"2019",3,0,3,6
314650,"2020",1,1,0,2
314650,"2021",1,1,2,4
314650,"2022",0,1,7,8
314650,"2023",0,0,2,2
314655,"2015",0,0,3,3
314655,"2016",3,0,4,7
314655,"2017",4,0,1,5
314655,"2018",1,0,3,4
314655,"2019",1,2,0,3
314655,"2020",0,0,1,1
314655,"2021",1,0,1,2
314655,"2022",1,1,2,4
314655,"2023",2,1,1,4
314660,"2015",0,0,3,3
314660,"2016",0,0,2,2
314660,"2018",0,0,1,1
314660,"2019",0,0,1,1
314660,"2020",1,0,0,1
314660,"2022",0,0,1,1
314670,"2015",0,0,2,2
314670,"2016",0,0,1,1
314670,"2019",2,0,2,4
314670,"2020",1,0,2,3
314670,"2022",2,0,1,3
314670,"2023",1,0,1,2
314675,"2015",1,0,1,2
314675,"2016",1,0,1,2
314675,"2017",4,0,4,8
314675,"2018",1,2,1,4
314675,"2019",0,0,5,5
314675,"2020",2,1,9,12
314675,"2021",2,1,5,8
314675,"2022",2,1,3,6
314675,"2023",2,1,2,5
314690,"2015",4,0,7,11
314690,"2016",4,0,3,7
314690,"2017",4,2,3,9
314690,"2018",2,3,4,9
314690,"2019",1,0,4,5
314690,"2020",3,0,4,7
314690,"2021",2,1,3,6
314690,"2022",2,0,6,8
314690,"2023",2,0,3,5
314700,"2015",20,5,36,61
314700,"2016",23,10,38,71
314700,"2017",24,11,48,83
314700,"2018",25,7,43,75
314700,"2019",33,18,38,89
314700,"2020",25,9,44,78
314700,"2021",34,9,47,90
314700,"2022",20,5,18,43
314700,"2023",10,1,20,31
314710,"2015",24,5,31,60
314710,"2016",22,8,26,56
314710,"2017",11,7,35,53
314710,"2018",34,7,40,81
314710,"2019",19,10,53,82
314710,"2020",26,11,26,63
314710,"2021",23,15,23,61
314710,"2022",21,6,24,51
314710,"2023",11,3,27,41
314720,"2015",4,1,14,19
314720,"2016",2,2,6,10
314720,"2017",4,1,11,16
314720,"2018",10,3,14,27
314720,"2019",13,4,16,33
314720,"2020",8,0,9,17
314720,"2021",8,2,5,15
314720,"2022",1,0,3,4
314720,"2023",2,0,1,3
314730,"2015",0,1,1,2
314730,"2017",1,0,2,3
314730,"2019",3,0,2,5
314730,"2020",0,0,1,1
314730,"2021",1,0,1,2
314730,"2022",4,0,3,7
314730,"2023",4,0,0,4
314740,"2015",8,6,19,33
314740,"2016",10,1,12,23
314740,"2017",1,0,9,10
314740,"2018",5,0,8,13
314740,"2019",11,2,11,24
314740,"2020",3,0,11,14
314740,"2021",3,0,5,8
314740,"2022",3,1,9,13
314740,"2023",5,0,3,8
314750,"2015",0,0,1,1
314750,"2019",1,0,0,1
314750,"2021",1,0,0,1
314760,"2015",3,0,3,6
314760,"2016",3,2,3,8
314760,"2017",3,0,3,6
314760,"2018",2,0,3,5
314760,"2019",1,1,4,6
314760,"2020",3,0,4,7
314760,"2021",4,0,3,7
314760,"2022",1,1,1,3
314760,"2023",0,0,1,1
314770,"2015",1,1,1,3
314770,"2016",2,0,0,2
314770,"2017",0,1,0,1
314770,"2018",1,0,0,1
314770,"2019",0,0,1,1
314770,"2020",2,0,2,4
314770,"2021",0,1,2,3
314770,"2022",3,2,5,10
314770,"2023",1,1,2,4
314780,"2017",1,0,2,3
314780,"2019",0,0,1,1
314780,"2021",1,0,0,1
314790,"2015",18,6,27,51
314790,"2016",8,3,19,30
314790,"2017",19,4,34,57
314790,"2018",22,2,38,62
314790,"2019",16,2,34,52
314790,"2020",19,3,18,40
314790,"2021",29,7,32,68
314790,"2022",17,4,37,58
314790,"2023",12,7,11,30
314795,"2015",0,0,3,3
314795,"2016",1,0,1,2
314795,"2017",3,0,5,8
314795,"2018",0,0,1,1
314795,"2019",1,4,4,9
314795,"2020",2,1,2,5
314795,"2021",0,0,1,1
314795,"2022",0,0,1,1
314795,"2023",0,0,2,2
314800,"2015",19,6,32,57
314800,"2016",14,3,33,50
314800,"2017",14,4,21,39
314800,"2018",21,5,21,47
314800,"2019",10,4,23,37
314800,"2020",13,4,21,38
314800,"2021",6,5,21,32
314800,"2022",18,5,20,43
314800,"2023",8,2,14,24
314810,"2015",26,4,64,94
314810,"2016",28,3,50,81
314810,"2017",31,7,70,108
314810,"2018",40,8,67,115
314810,"2019",37,6,56,99
314810,"2020",20,14,48,82
314810,"2021",21,6,43,70
314810,"2022",22,7,41,70
314810,"2023",12,5,23,40
314820,"2017",0,0,1,1
314820,"2020",1,0,0,1
314830,"2015",0,0,2,2
314830,"2016",3,0,1,4
314830,"2017",2,0,4,6
314830,"2018",2,0,1,3
314830,"2019",1,0,2,3
314830,"2020",1,0,0,1
314830,"2021",2,0,7,9
314830,"2022",2,0,0,2
314830,"2023",2,0,3,5
314840,"2015",2,0,1,3
314840,"2016",0,0,3,3
314840,"2017",1,0,2,3
314840,"2018",4,1,7,12
314840,"2019",1,0,2,3
314840,"2020",3,0,1,4
314840,"2021",2,0,3,5
314850,"2015",2,0,0,2
314850,"2016",0,0,1,1
314850,"2017",0,0,2,2
314850,"2019",0,0,2,2
314850,"2020",0,0,1,1
314850,"2021",0,0,2,2
314850,"2022",1,0,3,4
314860,"2015",2,3,5,10
314860,"2016",1,0,7,8
314860,"2017",1,4,6,11
314860,"2018",2,2,4,8
314860,"2019",5,0,4,9
314860,"2020",6,1,7,14
314860,"2021",4,2,9,15
314860,"2022",4,2,7,13
314860,"2023",4,1,3,8
314870,"2015",3,4,6,13
314870,"2016",8,0,7,15
314870,"2017",6,0,12,18
314870,"2018",2,3,11,16
314870,"2019",2,3,6,11
314870,"2020",6,0,7,13
314870,"2021",2,2,7,11
314870,"2022",4,0,5,9
314870,"2023",4,2,6,12
314875,"2015",2,0,4,6
314875,"2016",0,1,9,10
314875,"2017",1,1,1,3
314875,"2018",2,0,3,5
314875,"2019",0,0,3,3
314875,"2020",2,0,1,3
314875,"2021",1,2,1,4
314875,"2022",2,0,1,3
314875,"2023",1,1,4,6
314880,"2016",0,0,1,1
314880,"2017",0,0,1,1
314880,"2019",0,0,2,2
314880,"2020",0,0,2,2
314880,"2021",0,0,1,1
314880,"2023",0,0,1,1
314890,"2015",1,0,2,3
314890,"2016",0,0,1,1
314890,"2017",1,0,0,1
314890,"2018",0,0,1,1
314890,"2019",0,0,1,1
314890,"2020",0,0,2,2
314890,"2023",3,0,0,3
314900,"2015",0,0,1,1
314900,"2016",0,0,1,1
314900,"2017",0,0,3,3
314900,"2018",0,0,4,4
314900,"2020",1,0,1,2
314900,"2021",0,0,1,1
314900,"2022",0,0,1,1
314910,"2015",0,0,2,2
314910,"2016",1,2,2,5
314910,"2017",0,5,3,8
314910,"2018",0,0,1,1
314910,"2019",2,0,1,3
314910,"2020",0,0,3,3
314910,"2021",1,0,1,2
314910,"2022",0,0,2,2
314915,"2015",0,0,2,2
314915,"2016",2,0,0,2
314915,"2017",2,1,3,6
314915,"2018",0,1,3,4
314915,"2019",0,0,5,5
314915,"2020",0,0,2,2
314915,"2021",0,0,1,1
314915,"2022",2,1,0,3
314915,"2023",1,0,0,1
314920,"2015",1,0,3,4
314920,"2016",1,0,2,3
314920,"2020",0,0,1,1
314920,"2022",0,0,1,1
314930,"2015",15,1,37,53
314930,"2016",14,3,41,58
314930,"2017",20,3,54,77
314930,"2018",19,2,28,49
314930,"2019",22,4,30,56
314930,"2020",29,3,15,47
314930,"2021",21,7,28,56
314930,"2022",15,11,29,55
314930,"2023",13,12,15,40
314940,"2015",1,1,2,4
314940,"2016",1,0,0,1
314940,"2017",2,0,2,4
314940,"2018",0,1,0,1
314940,"2019",1,0,0,1
314940,"2020",0,0,5,5
314940,"2021",1,0,0,1
314940,"2022",0,0,1,1
314940,"2023",0,0,1,1
314950,"2015",0,0,1,1
314950,"2016",2,0,1,3
314950,"2017",1,0,0,1
314950,"2018",0,0,2,2
314950,"2019",0,0,2,2
314950,"2021",0,1,2,3
314950,"2022",1,0,1,2
314950,"2023",1,0,0,1
314960,"2015",1,0,1,2
314960,"2016",2,1,2,5
314960,"2017",0,1,2,3
314960,"2018",0,2,0,2
314960,"2019",2,0,0,2
314960,"2020",2,0,1,3
314960,"2021",1,0,1,2
314960,"2022",3,0,1,4
314970,"2015",1,2,5,8
314970,"2016",5,0,9,14
314970,"2017",1,2,8,11
314970,"2018",1,0,13,14
314970,"2019",2,0,6,8
314970,"2020",4,1,10,15
314970,"2021",3,0,3,6
314970,"2022",1,0,9,10
314970,"2023",4,1,5,10
314980,"2015",4,0,2,6
314980,"2016",1,0,4,5
314980,"2017",4,0,8,12
314980,"2018",7,0,4,11
314980,"2019",0,0,6,6
314980,"2020",3,1,5,9
314980,"2021",3,0,3,6
314980,"2022",0,1,2,3
314980,"2023",1,0,0,1
314990,"2015",5,2,6,13
314990,"2016",2,0,5,7
314990,"2017",4,3,8,15
314990,"2018",4,0,7,11
314990,"2019",1,1,4,6
314990,"2020",2,3,8,13
314990,"2021",4,0,1,5
314990,"2022",5,0,4,9
314990,"2023",1,0,3,4
314995,"2015",4,0,5,9
314995,"2016",3,0,3,6
314995,"2017",2,1,0,3
314995,"2018",0,0,1,1
314995,"2019",0,0,2,2
314995,"2020",2,0,5,7
314995,"2021",0,0,3,3
314995,"2022",1,1,1,3
314995,"2023",0,0,1,1
315000,"2015",0,0,1,1
315000,"2016",1,1,2,4
315000,"2017",1,0,2,3
315000,"2018",1,0,3,4
315000,"2019",0,0,2,2
315000,"2021",1,0,1,2
315000,"2022",1,1,2,4
315010,"2015",0,0,1,1
315010,"2017",1,0,0,1
315010,"2018",1,0,1,2
315010,"2019",1,1,0,2
315015,"2015",3,0,5,8
315015,"2016",0,0,1,1
315015,"2017",7,0,2,9
315015,"2018",1,0,7,8
315015,"2019",2,0,7,9
315015,"2020",0,0,2,2
315015,"2021",1,1,7,9
315015,"2022",0,0,2,2
315015,"2023",5,0,4,9
315020,"2015",0,0,1,1
315020,"2018",0,1,1,2
315020,"2020",1,0,1,2
315020,"2021",3,0,4,7
315020,"2022",1,2,1,4
315020,"2023",0,0,1,1
315030,"2015",2,1,3,6
315030,"2016",1,0,0,1
315030,"2017",0,0,2,2
315030,"2018",2,0,0,2
315030,"2019",1,1,0,2
315030,"2020",2,0,1,3
315030,"2023",1,0,1,2
315040,"2016",1,0,1,2
315040,"2017",0,0,2,2
315040,"2018",0,0,1,1
315040,"2019",1,0,0,1
315040,"2020",0,0,1,1
315040,"2021",1,0,2,3
315040,"2023",1,1,1,3
315050,"2015",1,0,1,2
315050,"2016",0,0,2,2
315050,"2017",1,1,1,3
315050,"2018",1,0,2,3
315050,"2019",3,0,2,5
315050,"2020",2,0,0,2
315050,"2021",1,1,1,3
315050,"2022",3,0,4,7
315050,"2023",3,1,3,7
315053,"2016",1,0,3,4
315053,"2017",0,0,4,4
315053,"2018",3,0,1,4
315053,"2019",2,0,5,7
315053,"2020",0,1,0,1
315053,"2021",1,0,1,2
315053,"2022",1,0,3,4
315053,"2023",0,0,1,1
315057,"2015",3,0,2,5
315057,"2016",1,0,6,7
315057,"2017",0,1,3,4
315057,"2018",2,0,3,5
315057,"2019",0,1,3,4
315057,"2020",3,0,4,7
315057,"2021",1,1,0,2
315057,"2022",0,0,2,2
315060,"2015",2,1,3,6
315060,"2016",1,1,2,4
315060,"2017",2,0,3,5
315060,"2018",0,0,1,1
315060,"2019",1,2,0,3
315060,"2020",2,0,0,2
315060,"2021",1,0,0,1
315060,"2022",0,1,2,3
315060,"2023",3,0,2,5
315070,"2015",0,0,2,2
315070,"2017",0,2,1,3
315070,"2018",0,0,3,3
315070,"2019",3,0,7,10
315070,"2020",2,0,1,3
315070,"2021",1,0,1,2
315070,"2023",0,0,1,1
315080,"2015",3,1,3,7
315080,"2016",1,1,3,5
315080,"2017",1,1,6,8
315080,"2018",1,1,4,6
315080,"2019",1,0,8,9
315080,"2020",3,1,5,9
315080,"2021",4,1,2,7
315080,"2022",1,3,3,7
315080,"2023",4,1,0,5
315090,"2015",1,1,1,3
315090,"2016",0,0,1,1
315090,"2017",1,0,1,2
315090,"2018",1,0,2,3
315090,"2019",0,0,1,1
315090,"2020",0,0,1,1
315090,"2022",1,0,0,1
315100,"2016",0,1,0,1
315100,"2017",4,0,1,5
315100,"2018",2,0,1,3
315100,"2019",1,1,2,4
315100,"2020",0,0,1,1
315100,"2021",0,0,2,2
315100,"2022",1,0,1,2
315100,"2023",0,1,1,2
315110,"2015",1,1,1,3
315110,"2017",0,0,1,1
315110,"2019",0,0,2,2
315110,"2020",0,0,2,2
315110,"2021",1,0,2,3
315110,"2023",0,2,0,2
315120,"2015",13,2,28,43
315120,"2016",8,0,22,30
315120,"2017",9,2,24,35
315120,"2018",16,3,34,53
315120,"2019",17,1,15,33
315120,"2020",10,0,20,30
315120,"2021",10,1,16,27
315120,"2022",12,5,19,36
315120,"2023",8,2,15,25
315130,"2015",3,0,6,9
315130,"2016",4,3,3,10
315130,"2017",2,1,6,9
315130,"2018",6,1,10,17
315130,"2019",7,0,1,8
315130,"2020",7,0,4,11
315130,"2021",4,0,1,5
315130,"2022",8,3,1,12
315130,"2023",2,2,3,7
315140,"2015",4,0,7,11
315140,"2016",5,2,6,13
315140,"2017",0,2,6,8
315140,"2018",4,0,9,13
315140,"2019",3,2,8,13
315140,"2020",5,1,6,12
315140,"2021",2,1,4,7
315140,"2022",4,3,9,16
315140,"2023",1,1,3,5
315150,"2015",11,1,9,21
315150,"2016",4,1,8,13
315150,"2017",8,2,14,24
315150,"2018",10,0,15,25
315150,"2019",5,5,16,26
315150,"2020",3,0,8,11
315150,"2021",6,4,7,17
315150,"2022",12,6,13,31
315150,"2023",7,4,6,17
315160,"2015",1,0,6,7
315160,"2016",0,0,5,5
315160,"2017",1,0,2,3
315160,"2018",2,0,1,3
315160,"2019",2,2,2,6
315160,"2020",2,0,5,7
315160,"2021",1,0,3,4
315160,"2022",1,0,2,3
315160,"2023",0,0,2,2
315170,"2015",5,0,0,5
315170,"2016",2,0,1,3
315170,"2017",0,0,3,3
315170,"2018",0,0,3,3
315170,"2019",2,0,1,3
315170,"2021",2,0,3,5
315170,"2022",0,1,1,2
315170,"2023",1,0,1,2
315180,"2015",16,9,37,62
315180,"2016",18,5,49,72
315180,"2017",18,2,19,39
315180,"2018",16,4,38,58
315180,"2019",17,8,45,70
315180,"2020",32,3,31,66
315180,"2021",25,10,35,70
315180,"2022",23,13,36,72
315180,"2023",18,7,37,62
315190,"2015",0,0,2,2
315190,"2017",1,0,1,2
315190,"2018",0,2,1,3
315190,"2019",1,0,0,1
315190,"2022",2,1,2,5
315190,"2023",0,1,0,1
315200,"2015",8,0,20,28
315200,"2016",5,2,22,29
315200,"2017",5,1,16,22
315200,"2018",12,5,16,33
315200,"2019",6,1,16,23
315200,"2020",3,0,10,13
315200,"2021",9,4,13,26
315200,"2022",8,0,10,18
315200,"2023",4,1,9,14
315210,"2015",6,0,8,14
315210,"2016",1,1,2,4
315210,"2017",0,0,1,1
315210,"2018",7,0,3,10
315210,"2019",7,1,4,12
315210,"2020",9,2,15,26
315210,"2021",19,3,23,45
315210,"2022",21,5,26,52
315210,"2023",8,0,12,20
315213,"2015",0,0,1,1
315213,"2016",5,0,0,5
315213,"2017",0,0,1,1
315213,"2018",4,0,1,5
315213,"2020",1,0,1,2
315213,"2021",2,1,0,3
315213,"2022",2,0,2,4
315213,"2023",1,0,1,2
315217,"2015",1,1,8,10
315217,"2016",7,3,11,21
315217,"2017",2,1,7,10
315217,"2018",5,2,8,15
315217,"2019",1,0,5,6
315217,"2020",1,1,8,10
315217,"2021",1,2,10,13
315217,"2022",4,1,5,10
315217,"2023",6,0,2,8
315220,"2015",20,2,41,63
315220,"2016",16,7,29,52
315220,"2017",18,7,24,49
315220,"2018",22,3,19,44
315220,"2019",9,2,17,28
315220,"2020",8,4,9,21
315220,"2021",13,2,18,33
315220,"2022",9,2,22,33
315220,"2023",15,4,21,40
315230,"2015",1,0,2,3
315230,"2016",0,1,1,2
315230,"2017",0,0,2,2
315230,"2018",0,1,4,5
315230,"2019",1,0,0,1
315230,"2020",2,0,3,5
315230,"2021",1,0,2,3
315230,"2022",2,0,5,7
315230,"2023",1,0,3,4
315240,"2015",3,2,1,6
315240,"2016",2,1,0,3
315240,"2017",5,2,1,8
315240,"2018",1,0,2,3
315240,"2019",2,2,1,5
315240,"2020",3,0,1,4
315240,"2021",4,1,2,7
315240,"2022",1,0,2,3
315240,"2023",1,2,7,10
315250,"2015",21,3,55,79
315250,"2016",31,8,43,82
315250,"2017",35,5,55,95
315250,"2018",38,4,63,105
315250,"2019",23,7,35,65
315250,"2020",24,8,36,68
315250,"2021",28,11,40,79
315250,"2022",31,6,42,79
315250,"2023",21,6,34,61
315260,"2015",0,0,2,2
315260,"2016",1,0,2,3
315260,"2017",3,0,0,3
315260,"2018",1,0,0,1
315260,"2020",1,1,2,4
315260,"2021",2,1,1,4
315260,"2022",0,1,1,2
315260,"2023",1,0,0,1
315270,"2015",1,1,1,3
315270,"2016",0,1,3,4
315270,"2017",2,1,3,6
315270,"2018",1,1,3,5
315270,"2019",0,0,6,6
315270,"2020",1,1,2,4
315270,"2022",3,1,0,4
315270,"2023",2,2,1,5
315280,"2015",4,1,15,20
315280,"2016",0,0,12,12
315280,"2017",2,0,12,14
315280,"2018",3,2,8,13
315280,"2019",3,0,9,12
315280,"2020",3,3,17,23
315280,"2021",5,1,9,15
315280,"2022",1,1,16,18
315280,"2023",2,1,8,11
315290,"2015",1,1,0,2
315290,"2016",0,1,0,1
315290,"2017",0,0,1,1
315290,"2018",0,0,1,1
315290,"2019",0,1,1,2
315290,"2020",1,1,4,6
315290,"2021",2,0,4,6
315290,"2022",1,0,1,2
315290,"2023",0,0,1,1
315300,"2015",3,0,0,3
315300,"2017",0,0,1,1
315300,"2018",0,0,3,3
315300,"2019",0,0,1,1
315300,"2021",0,0,1,1
315300,"2023",0,1,0,1
315310,"2015",0,0,1,1
315310,"2016",1,0,0,1
315310,"2017",1,0,0,1
315310,"2018",0,1,4,5
315310,"2019",1,1,2,4
315310,"2022",0,0,2,2
315310,"2023",0,1,1,2
315320,"2015",0,1,0,1
315320,"2016",3,0,2,5
315320,"2017",1,0,0,1
315320,"2018",2,0,1,3
315320,"2019",2,0,2,4
315320,"2020",1,0,2,3
315320,"2021",1,0,0,1
315320,"2022",1,1,0,2
315320,"2023",2,0,1,3
315330,"2016",0,1,1,2
315330,"2017",1,1,2,4
315330,"2018",1,1,0,2
315330,"2019",2,0,2,4
315330,"2020",1,0,2,3
315330,"2021",0,1,2,3
315330,"2022",1,0,2,3
315340,"2015",1,1,19,21
315340,"2016",2,0,5,7
315340,"2017",0,1,4,5
315340,"2018",1,0,1,2
315340,"2019",1,0,3,4
315340,"2020",5,0,3,8
315340,"2021",1,0,1,2
315340,"2022",0,0,1,1
315340,"2023",0,1,0,1
315350,"2015",1,0,1,2
315350,"2016",3,0,1,4
315350,"2017",2,1,5,8
315350,"2018",2,0,4,6
315350,"2019",0,1,1,2
315350,"2020",4,1,2,7
315350,"2021",1,0,0,1
315350,"2022",3,0,1,4
315350,"2023",0,0,1,1
315360,"2015",4,1,10,15
315360,"2016",3,0,0,3
315360,"2017",2,1,2,5
315360,"2018",4,0,6,10
315360,"2019",1,0,4,5
315360,"2020",1,1,4,6
315360,"2021",4,2,6,12
315360,"2022",2,1,2,5
315360,"2023",2,0,3,5
315370,"2015",1,1,0,2
315370,"2016",0,0,1,1
315370,"2022",0,0,1,1
315380,"2015",0,0,1,1
315380,"2017",1,0,0,1
315380,"2019",0,0,1,1
315390,"2015",2,0,3,5
315390,"2016",2,1,2,5
315390,"2017",1,0,3,4
315390,"2018",4,0,2,6
315390,"2019",4,0,1,5
315390,"2020",1,0,1,2
315390,"2021",3,1,3,7
315390,"2022",2,1,3,6
315390,"2023",1,0,2,3
315400,"2015",0,0,1,1
315400,"2016",3,0,1,4
315400,"2017",3,1,6,10
315400,"2018",6,1,0,7
315400,"2019",1,0,5,6
315400,"2020",4,1,1,6
315400,"2021",3,0,4,7
315400,"2022",4,0,3,7
315400,"2023",1,2,2,5
315410,"2015",3,0,3,6
315410,"2016",0,1,2,3
315410,"2017",2,0,1,3
315410,"2018",1,0,2,3
315410,"2019",0,0,1,1
315410,"2020",1,1,4,6
315410,"2021",2,1,5,8
315410,"2022",0,0,3,3
315410,"2023",3,0,0,3
315415,"2015",6,0,5,11
315415,"2016",5,0,5,10
315415,"2017",7,0,4,11
315415,"2018",0,2,6,8
315415,"2019",1,0,4,5
315415,"2020",3,1,4,8
315415,"2021",4,0,1,5
315415,"2023",1,1,2,4
315420,"2015",3,0,0,3
315420,"2016",2,1,1,4
315420,"2017",6,3,3,12
315420,"2018",3,1,6,10
315420,"2019",5,0,2,7
315420,"2020",1,0,4,5
315420,"2021",2,1,4,7
315420,"2022",5,0,4,9
315420,"2023",0,0,2,2
315430,"2015",4,0,6,10
315430,"2016",4,0,13,17
315430,"2017",4,1,5,10
315430,"2018",7,1,17,25
315430,"2019",4,3,6,13
315430,"2020",6,0,11,17
315430,"2021",9,2,7,18
315430,"2022",7,1,9,17
315430,"2023",5,1,2,8
315440,"2015",0,1,3,4
315440,"2016",1,1,3,5
315440,"2017",0,0,4,4
315440,"2018",0,0,3,3
315440,"2019",1,3,1,5
315440,"2020",2,1,3,6
315440,"2021",1,0,2,3
315440,"2023",1,0,1,2
315445,"2015",1,3,7,11
315445,"2016",0,0,5,5
315445,"2017",2,1,6,9
315445,"2018",0,1,2,3
315445,"2019",1,0,1,2
315445,"2020",2,0,2,4
315445,"2021",2,0,3,5
315445,"2022",2,0,0,2
315445,"2023",0,1,0,1
315450,"2015",3,0,4,7
315450,"2016",2,0,4,6
315450,"2017",2,0,6,8
315450,"2018",1,0,4,5
315450,"2019",3,1,3,7
315450,"2020",0,0,3,3
315450,"2021",1,0,3,4
315450,"2022",2,0,2,4
315450,"2023",1,1,4,6
315460,"2015",62,21,146,229
315460,"2016",95,17,183,295
315460,"2017",75,20,148,243
315460,"2018",96,24,146,266
315460,"2019",82,27,108,217
315460,"2020",68,13,98,179
315460,"2021",67,22,120,209
315460,"2022",57,14,107,178
315460,"2023",30,14,80,124
315470,"2015",0,0,1,1
315470,"2016",2,0,0,2
315470,"2017",1,0,2,3
315470,"2018",4,0,1,5
315470,"2019",1,0,0,1
315470,"2020",1,0,2,3
315470,"2021",1,0,2,3
315470,"2022",2,1,0,3
315470,"2023",0,0,3,3
315480,"2015",0,0,2,2
315480,"2016",1,0,3,4
315480,"2017",1,1,1,3
315480,"2018",2,0,0,2
315480,"2019",1,0,0,1
315480,"2020",0,1,1,2
315480,"2021",2,0,3,5
315480,"2022",0,0,2,2
315480,"2023",0,1,1,2
315490,"2015",3,0,0,3
315490,"2018",0,0,3,3
315490,"2019",0,0,1,1
315490,"2020",4,0,7,11
315490,"2021",4,1,5,10
315490,"2022",4,1,5,10
315490,"2023",3,0,1,4
315500,"2019",0,0,1,1
315500,"2021",2,0,0,2
315500,"2022",2,1,1,4
315510,"2015",1,1,0,2
315510,"2017",1,0,1,2
315510,"2018",1,1,0,2
315510,"2019",1,0,1,2
315510,"2020",1,0,2,3
315510,"2021",1,2,1,4
315510,"2022",0,0,1,1
315510,"2023",1,0,2,3
315520,"2015",0,0,2,2
315520,"2016",1,1,1,3
315520,"2017",1,0,1,2
315520,"2018",1,0,3,4
315520,"2019",0,0,1,1
315520,"2020",1,1,4,6
315520,"2021",2,1,1,4
315520,"2022",1,0,0,1
315520,"2023",0,0,1,1
315530,"2015",1,0,1,2
315530,"2017",1,1,0,2
315530,"2019",1,0,2,3
315530,"2020",1,0,0,1
315530,"2021",1,1,0,2
315530,"2022",2,0,2,4
315530,"2023",1,0,0,1
315540,"2015",2,0,5,7
315540,"2016",2,0,4,6
315540,"2017",3,1,3,7
315540,"2018",0,0,2,2
315540,"2019",0,0,2,2
315540,"2020",1,0,2,3
315540,"2021",2,3,3,8
315540,"2022",1,1,2,4
315540,"2023",2,0,2,4
315550,"2015",5,0,7,12
315550,"2016",2,0,9,11
315550,"2017",2,0,2,4
315550,"2018",1,0,6,7
315550,"2019",3,0,3,6
315550,"2020",0,0,3,3
315550,"2022",1,0,3,4
315550,"2023",0,0,1,1
315560,"2015",13,1,10,24
315560,"2016",6,0,11,17
315560,"2017",4,1,5,10
315560,"2018",1,1,5,7
315560,"2019",4,1,3,8
315560,"2020",2,0,9,11
315560,"2021",2,1,9,12
315560,"2022",3,3,4,10
315560,"2023",2,1,2,5
315570,"2015",3,0,3,6
315570,"2016",1,0,3,4
315570,"2017",1,1,4,6
315570,"2018",6,3,4,13
315570,"2019",2,2,6,10
315570,"2020",1,2,3,6
315570,"2021",2,1,2,5
315570,"2022",2,0,4,6
315570,"2023",1,1,1,3
315580,"2015",1,0,6,7
315580,"2016",2,0,6,8
315580,"2017",3,1,1,5
315580,"2018",8,3,9,20
315580,"2019",4,0,2,6
315580,"2020",0,0,1,1
315580,"2021",1,1,12,14
315580,"2022",2,0,1,3
315580,"2023",1,2,4,7
315590,"2015",0,0,1,1
315590,"2016",0,0,1,1
315590,"2017",0,0,1,1
315590,"2019",0,0,1,1
315590,"2022",1,0,0,1
315600,"2015",5,1,4,10
315600,"2016",2,3,7,12
315600,"2017",6,0,5,11
315600,"2018",3,2,3,8
315600,"2019",4,1,5,10
315600,"2020",5,1,3,9
315600,"2021",5,1,8,14
315600,"2022",2,1,3,6
315600,"2023",4,1,3,8
315610,"2017",2,0,2,4
315610,"2018",0,1,3,4
315610,"2019",1,0,1,2
315610,"2020",0,0,2,2
315610,"2021",1,0,0,1
315610,"2023",0,0,1,1
315620,"2015",0,0,2,2
315620,"2016",1,0,1,2
315620,"2017",0,0,1,1
315620,"2018",0,0,2,2
315620,"2019",2,0,1,3
315620,"2020",2,0,3,5
315620,"2022",2,0,3,5
315620,"2023",0,0,1,1
315630,"2015",4,1,1,6
315630,"2016",2,0,7,9
315630,"2017",4,0,4,8
315630,"2018",5,1,7,13
315630,"2019",2,0,4,6
315630,"2020",1,1,6,8
315630,"2021",4,1,1,6
315630,"2022",2,0,2,4
315630,"2023",5,0,2,7
315640,"2015",0,2,3,5
315640,"2016",0,0,1,1
315640,"2021",1,0,1,2
315640,"2023",1,0,1,2
315645,"2015",0,0,1,1
315645,"2017",1,0,0,1
315645,"2019",0,0,1,1
315650,"2015",1,0,0,1
315650,"2016",0,0,1,1
315650,"2017",1,0,4,5
315650,"2018",4,0,3,7
315650,"2019",1,0,1,2
315650,"2020",0,0,4,4
315650,"2021",4,0,0,4
315650,"2022",3,0,1,4
315650,"2023",0,0,1,1
315660,"2015",1,0,6,7
315660,"2016",2,0,9,11
315660,"2017",3,0,4,7
315660,"2018",1,0,3,4
315660,"2019",2,0,2,4
315660,"2020",1,0,9,10
315660,"2021",5,0,5,10
315660,"2022",1,0,3,4
315660,"2023",2,0,0,2
315670,"2015",28,7,45,80
315670,"2016",32,6,46,84
315670,"2017",36,7,57,100
315670,"2018",36,4,47,87
315670,"2019",26,5,49,80
315670,"2020",20,5,36,61
315670,"2021",14,4,39,57
315670,"2022",20,12,36,68
315670,"2023",12,0,15,27
315680,"2015",2,1,2,5
315680,"2016",1,2,3,6
315680,"2017",2,0,13,15
315680,"2018",5,0,4,9
315680,"2019",5,2,4,11
315680,"2020",8,1,5,14
315680,"2021",4,4,9,17
315680,"2022",4,1,8,13
315680,"2023",1,2,5,8
315690,"2015",7,0,8,15
315690,"2016",4,1,14,19
315690,"2017",1,2,6,9
315690,"2018",3,3,14,20
315690,"2019",7,4,12,23
315690,"2020",5,1,9,15
315690,"2021",3,0,10,13
315690,"2022",9,1,5,15
315690,"2023",6,1,6,13
315700,"2015",17,2,25,44
315700,"2016",21,3,26,50
315700,"2017",20,6,34,60
315700,"2018",22,3,28,53
315700,"2019",13,4,33,50
315700,"2020",15,3,15,33
315700,"2021",21,12,22,55
315700,"2022",19,4,22,45
315700,"2023",10,5,19,34
315710,"2015",3,1,4,8
315710,"2016",2,0,3,5
315710,"2017",2,1,2,5
315710,"2018",1,1,2,4
315710,"2019",0,0,1,1
315710,"2020",1,0,2,3
315710,"2021",0,0,3,3
315710,"2022",0,2,3,5
315710,"2023",1,0,2,3
315720,"2015",7,3,18,28
315720,"2016",5,2,16,23
315720,"2017",10,5,16,31
315720,"2018",7,2,23,32
315720,"2019",9,2,17,28
315720,"2020",11,5,15,31
315720,"2021",11,1,7,19
315720,"2022",7,4,9,20
315720,"2023",7,3,10,20
315725,"2015",1,0,1,2
315725,"2016",2,0,5,7
315725,"2017",1,0,7,8
315725,"2018",4,1,4,9
315725,"2019",3,0,4,7
315725,"2020",2,0,2,4
315725,"2021",1,1,2,4
315725,"2022",0,3,1,4
315725,"2023",3,0,2,5
315727,"2015",2,0,0,2
315727,"2017",1,0,2,3
315727,"2018",0,0,1,1
315727,"2019",1,0,0,1
315727,"2020",1,0,1,2
315727,"2022",1,0,2,3
315727,"2023",0,1,0,1
315730,"2015",1,0,3,4
315730,"2016",3,0,2,5
315730,"2017",1,0,4,5
315730,"2018",2,0,1,3
315730,"2020",2,0,3,5
315733,"2015",3,0,3,6
315733,"2016",0,0,1,1
315733,"2017",2,0,3,5
315733,"2018",0,0,1,1
315733,"2019",1,0,1,2
315733,"2020",0,0,1,1
315733,"2021",0,0,3,3
315733,"2022",1,1,1,3
315733,"2023",1,1,0,2
315737,"2015",0,1,0,1
315737,"2016",2,0,1,3
315737,"2017",3,0,0,3
315737,"2018",1,1,2,4
315737,"2019",1,0,2,3
315737,"2020",1,0,4,5
315737,"2021",3,0,2,5
315737,"2022",1,0,3,4
315737,"2023",0,0,1,1
315740,"2015",2,1,2,5
315740,"2018",0,0,2,2
315740,"2021",2,0,1,3
315740,"2023",0,1,1,2
315750,"2015",0,0,1,1
315750,"2016",1,0,2,3
315750,"2017",0,0,1,1
315750,"2018",0,0,1,1
315750,"2019",5,0,1,6
315750,"2020",0,0,1,1
315750,"2021",0,0,1,1
315750,"2022",1,0,1,2
315750,"2023",1,0,0,1
315760,"2016",0,0,1,1
315760,"2017",0,1,1,2
315760,"2018",1,0,2,3
315760,"2020",1,0,3,4
315760,"2022",0,0,1,1
315760,"2023",0,0,1,1
315765,"2015",1,0,3,4
315765,"2016",1,0,2,3
315765,"2017",0,0,4,4
315765,"2018",1,0,2,3
315765,"2019",1,0,5,6
315765,"2020",1,0,1,2
315765,"2021",1,0,5,6
315765,"2022",0,0,1,1
315765,"2023",0,0,1,1
315770,"2015",3,1,5,9
315770,"2016",2,1,6,9
315770,"2017",1,0,2,3
315770,"2018",6,1,4,11
315770,"2019",5,0,7,12
315770,"2020",2,1,3,6
315770,"2021",6,1,6,13
315770,"2022",2,0,5,7
315770,"2023",0,0,3,3
315780,"2015",59,11,99,169
315780,"2016",52,16,94,162
315780,"2017",61,10,101,172
315780,"2018",54,6,86,146
315780,"2019",53,13,64,130
315780,"2020",54,10,68,132
315780,"2021",43,18,67,128
315780,"2022",37,13,74,124
315780,"2023",28,12,45,85
315790,"2015",4,2,9,15
315790,"2016",4,1,14,19
315790,"2017",3,0,13,16
315790,"2018",7,2,9,18
315790,"2019",2,0,7,9
315790,"2020",4,0,10,14
315790,"2021",5,0,4,9
315790,"2022",1,0,0,1
315790,"2023",2,1,1,4
315800,"2015",4,0,7,11
315800,"2016",1,0,3,4
315800,"2017",2,1,4,7
315800,"2018",4,0,3,7
315800,"2019",1,0,0,1
315800,"2020",2,3,3,8
315800,"2021",2,0,3,5
315800,"2022",2,1,1,4
315800,"2023",1,2,5,8
315810,"2015",3,0,1,4
315810,"2016",3,0,1,4
315810,"2017",1,0,3,4
315810,"2018",0,0,4,4
315810,"2019",1,0,0,1
315810,"2020",1,3,1,5
315810,"2021",1,0,1,2
315810,"2022",4,0,1,5
315810,"2023",1,0,0,1
315820,"2015",3,2,8,13
315820,"2016",2,2,5,9
315820,"2017",7,1,5,13
315820,"2018",1,2,2,5
315820,"2019",4,1,10,15
315820,"2020",5,4,3,12
315820,"2021",7,0,5,12
315820,"2022",1,0,3,4
315820,"2023",1,1,7,9
315830,"2015",2,2,4,8
315830,"2016",3,1,3,7
315830,"2017",1,0,3,4
315830,"2018",0,1,2,3
315830,"2019",3,0,1,4
315830,"2020",2,0,2,4
315830,"2021",2,1,5,8
315830,"2022",0,2,3,5
315840,"2016",0,0,1,1
315840,"2019",0,0,1,1
315840,"2021",2,0,0,2
315840,"2022",1,1,0,2
315850,"2015",3,0,2,5
315850,"2016",1,1,2,4
315850,"2017",2,0,1,3
315850,"2018",2,1,1,4
315850,"2019",2,1,1,4
315850,"2020",1,1,1,3
315850,"2021",2,1,1,4
315850,"2022",2,1,0,3
315860,"2015",3,0,0,3
315860,"2016",0,0,2,2
315860,"2017",1,1,3,5
315860,"2019",1,0,2,3
315860,"2020",1,0,0,1
315870,"2015",0,1,0,1
315870,"2016",1,0,0,1
315870,"2018",1,0,0,1
315870,"2019",0,0,1,1
315870,"2021",1,0,0,1
315870,"2022",0,0,1,1
315870,"2023",1,0,1,2
315880,"2015",1,0,2,3
315880,"2016",3,0,1,4
315880,"2017",1,1,3,5
315880,"2018",0,0,3,3
315880,"2019",0,0,2,2
315880,"2020",3,0,0,3
315880,"2021",2,1,1,4
315880,"2023",1,0,3,4
315890,"2015",5,0,4,9
315890,"2016",4,1,8,13
315890,"2017",5,1,12,18
315890,"2018",0,1,7,8
315890,"2019",0,0,3,3
315890,"2020",1,0,8,9
315890,"2021",1,0,2,3
315890,"2022",0,0,2,2
315890,"2023",1,0,5,6
315895,"2015",9,2,15,26
315895,"2016",9,0,11,20
315895,"2017",5,2,5,12
315895,"2018",12,1,16,29
315895,"2019",7,1,11,19
315895,"2020",4,3,4,11
315895,"2021",3,2,10,15
315895,"2022",2,0,6,8
315895,"2023",0,2,4,6
315900,"2015",1,1,2,4
315900,"2016",1,0,1,2
315900,"2017",2,0,1,3
315900,"2018",1,2,3,6
315900,"2021",2,1,1,4
315900,"2022",2,0,1,3
315900,"2023",0,1,0,1
315910,"2015",0,0,1,1
315910,"2016",0,0,1,1
315910,"2017",3,0,1,4
315910,"2018",2,0,1,3
315910,"2019",0,0,1,1
315910,"2020",1,0,2,3
315910,"2021",1,0,1,2
315910,"2022",1,0,2,3
315920,"2015",2,0,3,5
315920,"2016",1,1,3,5
315920,"2017",1,1,1,3
315920,"2018",2,0,1,3
315920,"2020",1,0,0,1
315920,"2021",0,0,2,2
315920,"2022",3,0,1,4
315930,"2015",1,0,1,2
315930,"2016",3,0,0,3
315930,"2017",0,0,1,1
315930,"2020",2,0,1,3
315930,"2021",0,0,1,1
315930,"2023",0,0,1,1
315935,"2015",1,0,3,4
315935,"2016",2,0,3,5
315935,"2017",1,0,2,3
315935,"2018",1,0,7,8
315935,"2020",2,0,4,6
315935,"2021",2,0,2,4
315935,"2022",0,0,1,1
315935,"2023",1,0,0,1
315940,"2015",2,1,1,4
315940,"2016",0,0,2,2
315940,"2017",1,0,0,1
315940,"2018",0,1,3,4
315940,"2019",2,1,1,4
315940,"2020",1,0,0,1
315940,"2021",0,0,2,2
315940,"2022",0,0,1,1
315950,"2015",3,0,4,7
315950,"2016",2,1,2,5
315950,"2017",3,1,1,5
315950,"2018",1,1,3,5
315950,"2019",5,0,5,10
315950,"2020",3,1,6,10
315950,"2021",1,1,3,5
315950,"2022",1,0,1,2
315950,"2023",3,2,1,6
315960,"2015",4,3,13,20
315960,"2016",11,2,9,22
315960,"2017",4,2,6,12
315960,"2018",9,4,8,21
315960,"2019",11,1,17,29
315960,"2020",5,3,11,19
315960,"2021",6,1,9,16
315960,"2022",2,0,10,12
315960,"2023",5,1,8,14
315970,"2015",1,0,0,1
315970,"2016",0,0,3,3
315970,"2017",0,0,1,1
315970,"2018",2,0,1,3
315970,"2020",0,0,1,1
315970,"2023",0,0,1,1
315980,"2015",2,1,13,16
315980,"2016",5,0,9,14
315980,"2017",4,2,9,15
315980,"2018",1,1,6,8
315980,"2019",1,1,5,7
315980,"2020",1,1,3,5
315980,"2021",2,4,5,11
315980,"2022",2,1,4,7
315980,"2023",3,0,1,4
315990,"2015",8,0,9,17
315990,"2016",6,1,5,12
315990,"2017",3,1,7,11
315990,"2018",5,1,2,8
315990,"2019",5,0,6,11
315990,"2020",1,1,4,6
315990,"2021",4,0,5,9
315990,"2022",0,1,2,3
315990,"2023",1,0,3,4
316000,"2015",1,0,0,1
316000,"2017",2,0,2,4
316000,"2018",0,1,1,2
316000,"2019",1,0,2,3
316000,"2020",1,0,1,2
316000,"2022",0,1,2,3
316010,"2015",0,0,2,2
316010,"2016",0,0,1,1
316010,"2018",0,0,1,1
316010,"2020",2,0,0,2
316010,"2021",4,0,0,4
316010,"2022",2,0,2,4
316020,"2015",3,0,4,7
316020,"2016",1,0,2,3
316020,"2017",0,0,2,2
316020,"2018",1,1,1,3
316020,"2019",0,0,2,2
316020,"2020",1,0,0,1
316020,"2021",1,0,0,1
316020,"2022",0,0,3,3
316020,"2023",1,0,0,1
316030,"2015",2,0,7,9
316030,"2016",2,0,4,6
316030,"2017",2,0,5,7
316030,"2018",4,2,4,10
316030,"2019",2,1,5,8
316030,"2020",1,0,9,10
316030,"2021",4,1,3,8
316030,"2022",0,0,4,4
316030,"2023",0,1,6,7
316040,"2015",10,1,16,27
316040,"2016",6,1,12,19
316040,"2017",6,0,22,28
316040,"2018",9,4,16,29
316040,"2019",7,6,15,28
316040,"2020",11,0,10,21
316040,"2021",11,1,14,26
316040,"2022",8,2,13,23
316040,"2023",2,0,10,12
316045,"2015",3,0,6,9
316045,"2016",0,0,3,3
316045,"2018",2,0,2,4
316045,"2019",0,1,3,4
316045,"2020",4,0,0,4
316045,"2021",3,0,0,3
316045,"2022",0,0,2,2
316045,"2023",3,1,1,5
316050,"2015",2,0,2,4
316050,"2016",1,0,0,1
316050,"2017",1,0,0,1
316050,"2019",1,0,0,1
316050,"2020",0,0,1,1
316050,"2022",1,0,1,2
316050,"2023",2,0,0,2
316060,"2015",2,0,3,5
316060,"2016",1,0,0,1
316060,"2018",1,0,1,2
316060,"2020",0,0,2,2
316060,"2021",0,0,1,1
316060,"2022",1,1,0,2
316070,"2015",12,3,16,31
316070,"2016",10,4,18,32
316070,"2017",16,2,16,34
316070,"2018",21,4,23,48
316070,"2019",11,2,19,32
316070,"2020",11,9,13,33
316070,"2021",13,2,16,31
316070,"2022",8,6,15,29
316070,"2023",12,6,15,33
316080,"2015",1,0,2,3
316080,"2016",1,0,0,1
316080,"2017",0,1,2,3
316080,"2018",1,0,3,4
316080,"2019",0,2,3,5
316080,"2020",3,1,4,8
316080,"2021",2,3,5,10
316080,"2022",0,0,2,2
316080,"2023",1,0,0,1
316090,"2015",2,0,0,2
316090,"2016",2,0,0,2
316090,"2017",0,0,1,1
316090,"2019",1,0,0,1
316090,"2022",1,0,2,3
316095,"2015",1,0,0,1
316095,"2016",2,0,2,4
316095,"2017",5,0,2,7
316095,"2018",7,0,6,13
316095,"2019",0,0,2,2
316095,"2020",1,1,2,4
316095,"2021",2,0,0,2
316095,"2022",3,0,1,4
316095,"2023",1,1,1,3
316100,"2015",4,1,7,12
316100,"2016",6,1,3,10
316100,"2017",8,0,3,11
316100,"2018",1,4,5,10
316100,"2019",6,2,5,13
316100,"2020",2,0,5,7
316100,"2021",3,2,3,8
316100,"2022",1,0,7,8
316100,"2023",2,2,1,5
316105,"2018",0,0,1,1
316105,"2021",1,0,1,2
316105,"2023",1,0,0,1
316110,"2015",16,4,41,61
316110,"2016",15,2,27,44
316110,"2017",17,6,27,50
316110,"2018",16,5,20,41
316110,"2019",8,5,16,29
316110,"2020",25,5,32,62
316110,"2021",14,3,26,43
316110,"2022",15,4,29,48
316110,"2023",13,1,11,25
316120,"2015",6,0,4,10
316120,"2016",1,3,2,6
316120,"2017",0,0,2,2
316120,"2018",2,1,0,3
316120,"2019",1,0,1,2
316120,"2020",2,1,1,4
316120,"2021",2,0,2,4
316120,"2022",0,1,0,1
316120,"2023",1,0,0,1
316130,"2016",2,0,3,5
316130,"2018",0,1,0,1
316140,"2017",0,0,1,1
316140,"2018",0,0,1,1
316140,"2019",0,0,1,1
316140,"2020",1,0,0,1
316140,"2023",1,0,1,2
316150,"2015",0,1,1,2
316150,"2016",0,0,5,5
316150,"2017",0,1,6,7
316150,"2018",2,0,2,4
316150,"2019",1,1,4,6
316150,"2020",1,0,5,6
316150,"2021",1,0,1,2
316150,"2022",1,0,3,4
316150,"2023",3,0,0,3
316160,"2015",1,0,2,3
316160,"2016",0,1,5,6
316160,"2017",3,1,0,4
316160,"2018",0,1,0,1
316160,"2019",1,1,3,5
316160,"2021",2,0,1,3
316160,"2022",0,0,1,1
316160,"2023",0,0,2,2
316165,"2016",0,0,1,1
316165,"2017",0,1,0,1
316165,"2018",1,0,0,1
316165,"2019",1,1,0,2
316165,"2020",0,0,1,1
316165,"2021",0,0,1,1
316165,"2023",0,0,1,1
316170,"2015",0,1,1,2
316170,"2016",0,0,2,2
316170,"2017",0,0,1,1
316170,"2018",0,1,0,1
316170,"2019",2,0,0,2
316170,"2020",1,1,0,2
316170,"2023",0,0,1,1
316180,"2015",0,2,2,4
316180,"2016",5,0,4,9
316180,"2017",6,1,9,16
316180,"2018",4,2,6,12
316180,"2019",1,0,4,5
316180,"2020",2,1,3,6
316180,"2021",1,0,4,5
316180,"2022",1,2,7,10
316180,"2023",1,0,3,4
316190,"2015",4,1,6,11
316190,"2016",1,1,4,6
316190,"2017",3,1,5,9
316190,"2018",3,0,5,8
316190,"2019",2,0,6,8
316190,"2020",4,1,1,6
316190,"2021",0,2,6,8
316190,"2022",2,0,2,4
316190,"2023",0,1,2,3
316200,"2015",8,3,12,23
316200,"2016",9,6,13,28
316200,"2017",10,5,10,25
316200,"2018",11,3,15,29
316200,"2019",11,1,15,27
316200,"2020",11,1,21,33
316200,"2021",15,5,16,36
316200,"2022",9,6,16,31
316200,"2023",5,2,4,11
316210,"2015",6,1,23,30
316210,"2016",10,1,22,33
316210,"2017",5,2,17,24
316210,"2018",13,2,21,36
316210,"2019",2,0,26,28
316210,"2020",9,1,14,24
316210,"2021",8,1,16,25
316210,"2022",9,3,25,37
316210,"2023",11,0,33,44
316220,"2015",0,0,3,3
316220,"2016",1,0,1,2
316220,"2017",0,1,5,6
316220,"2018",1,0,2,3
316220,"2019",1,1,1,3
316220,"2020",1,2,0,3
316220,"2021",0,0,2,2
316220,"2022",1,0,1,2
316220,"2023",1,0,0,1
316225,"2015",0,2,5,7
316225,"2016",1,0,0,1
316225,"2017",1,0,2,3
316225,"2018",1,0,2,3
316225,"2019",0,0,4,4
316225,"2020",3,2,1,6
316225,"2021",0,0,3,3
316225,"2022",0,0,4,4
316225,"2023",2,1,1,4
316230,"2015",0,1,0,1
316230,"2016",2,1,0,3
316230,"2017",3,0,0,3
316230,"2018",0,2,0,2
316230,"2019",0,0,3,3
316230,"2020",1,0,0,1
316230,"2021",1,0,0,1
316230,"2022",2,1,2,5
316240,"2015",5,2,10,17
316240,"2016",4,2,11,17
316240,"2017",6,1,9,16
316240,"2018",6,5,9,20
316240,"2019",4,3,6,13
316240,"2020",5,1,8,14
316240,"2021",4,0,5,9
316240,"2022",3,1,8,12
316240,"2023",3,3,2,8
316245,"2015",2,0,4,6
316245,"2016",1,0,2,3
316245,"2017",2,1,6,9
316245,"2018",4,1,1,6
316245,"2019",2,0,7,9
316245,"2020",2,0,4,6
316245,"2021",5,0,7,12
316245,"2022",1,1,7,9
316245,"2023",0,0,4,4
316250,"2015",6,3,12,21
316250,"2016",7,1,20,28
316250,"2017",10,3,21,34
316250,"2018",5,3,15,23
316250,"2019",7,6,17,30
316250,"2020",9,2,10,21
316250,"2021",6,2,11,19
316250,"2022",4,1,10,15
316250,"2023",6,0,4,10
316255,"2015",0,1,6,7
316255,"2016",2,1,8,11
316255,"2017",2,1,4,7
316255,"2018",5,0,11,16
316255,"2019",1,1,6,8
316255,"2020",5,1,7,13
316255,"2021",0,2,2,4
316255,"2022",0,0,2,2
316255,"2023",2,2,4,8
316257,"2015",0,0,2,2
316257,"2016",0,1,4,5
316257,"2017",0,1,3,4
316257,"2018",0,0,2,2
316257,"2019",0,0,1,1
316257,"2020",0,0,1,1
316257,"2021",0,0,1,1
316257,"2022",1,0,0,1
316257,"2023",0,0,1,1
316260,"2015",2,0,1,3
316260,"2016",3,0,2,5
316260,"2017",0,1,2,3
316260,"2018",1,1,2,4
316260,"2019",1,0,2,3
316260,"2021",1,0,1,2
316260,"2023",0,1,0,1
316265,"2016",1,0,1,2
316265,"2017",0,0,1,1
316265,"2018",2,0,5,7
316265,"2019",3,0,0,3
316265,"2020",0,1,1,2
316265,"2021",1,0,2,3
316265,"2023",1,0,1,2
316270,"2015",5,0,8,13
316270,"2016",7,0,7,14
316270,"2017",8,1,6,15
316270,"2018",4,3,11,18
316270,"2019",8,3,5,16
316270,"2020",6,0,5,11
316270,"2021",3,1,4,8
316270,"2022",5,5,6,16
316270,"2023",7,1,5,13
316280,"2015",4,1,1,6
316280,"2016",3,0,1,4
316280,"2017",11,1,7,19
316280,"2018",5,1,13,19
316280,"2019",7,1,10,18
316280,"2020",3,3,10,16
316280,"2021",1,4,5,10
316280,"2022",6,2,5,13
316280,"2023",2,0,0,2
316290,"2015",16,4,20,40
316290,"2016",10,4,9,23
316290,"2017",13,2,20,35
316290,"2018",7,3,12,22
316290,"2019",7,2,11,20
316290,"2020",8,1,13,22
316290,"2021",5,1,6,12
316290,"2022",6,3,8,17
316290,"2023",1,0,6,7
316292,"2015",7,1,11,19
316292,"2016",13,1,10,24
316292,"2017",8,3,12,23
316292,"2018",5,2,8,15
316292,"2019",3,1,12,16
316292,"2020",5,2,12,19
316292,"2021",4,0,9,13
316292,"2022",3,2,5,10
316292,"2023",5,3,9,17
316294,"2015",1,0,1,2
316294,"2017",3,0,2,5
316294,"2018",0,1,2,3
316294,"2019",2,0,0,2
316294,"2020",2,0,2,4
316294,"2021",2,0,3,5
316294,"2022",1,0,2,3
316294,"2023",0,0,1,1
316295,"2015",4,2,11,17
316295,"2016",13,0,13,26
316295,"2017",7,2,9,18
316295,"2018",6,5,10,21
316295,"2019",5,0,6,11
316295,"2020",6,1,11,18
316295,"2021",4,0,4,8
316295,"2022",8,2,5,15
316295,"2023",2,1,4,7
316300,"2015",0,0,2,2
316300,"2016",2,1,2,5
316300,"2017",1,0,3,4
316300,"2018",0,0,2,2
316300,"2020",0,0,2,2
316300,"2021",1,0,0,1
316300,"2022",1,0,1,2
316300,"2023",1,0,1,2
316310,"2016",0,0,1,1
316310,"2017",2,0,2,4
316310,"2018",0,2,1,3
316310,"2019",3,1,1,5
316310,"2020",1,0,1,2
316310,"2021",1,0,3,4
316320,"2015",0,0,1,1
316320,"2016",2,0,3,5
316320,"2018",0,0,2,2
316320,"2019",1,0,0,1
316320,"2020",1,0,2,3
316320,"2022",0,0,1,1
316330,"2015",2,0,3,5
316330,"2016",1,0,2,3
316330,"2017",0,0,4,4
316330,"2018",0,0,3,3
316330,"2019",1,0,0,1
316330,"2020",2,1,0,3
316330,"2021",1,0,3,4
316330,"2022",1,1,0,2
316330,"2023",1,0,1,2
316340,"2018",1,0,0,1
316340,"2020",2,1,4,7
316340,"2021",2,1,2,5
316340,"2022",1,1,0,2
316340,"2023",1,2,1,4
316350,"2015",1,0,1,2
316350,"2016",0,0,1,1
316350,"2017",2,1,6,9
316350,"2018",1,0,2,3
316350,"2019",2,0,5,7
316350,"2020",1,0,2,3
316350,"2021",0,0,3,3
316350,"2022",0,1,2,3
316350,"2023",2,0,1,3
316360,"2015",1,0,3,4
316360,"2016",1,1,1,3
316360,"2017",0,0,3,3
316360,"2018",1,0,2,3
316360,"2019",0,0,2,2
316360,"2020",1,0,2,3
316360,"2021",2,0,1,3
316360,"2023",1,1,0,2
316370,"2015",4,0,6,10
316370,"2016",3,0,12,15
316370,"2017",6,2,9,17
316370,"2018",7,0,7,14
316370,"2019",6,1,10,17
316370,"2020",10,1,8,19
316370,"2021",7,1,14,22
316370,"2022",8,2,12,22
316370,"2023",1,5,6,12
316380,"2015",1,0,0,1
316380,"2016",1,0,1,2
316380,"2017",0,0,2,2
316380,"2018",1,1,0,2
316380,"2019",1,1,2,4
316380,"2020",1,0,0,1
316380,"2021",0,1,0,1
316380,"2022",5,0,3,8
316380,"2023",2,1,1,4
316390,"2016",0,0,1,1
316390,"2017",0,0,1,1
316390,"2018",1,1,0,2
316390,"2019",2,0,1,3
316390,"2021",0,0,3,3
316400,"2015",1,0,1,2
316400,"2016",1,0,0,1
316400,"2018",2,0,2,4
316400,"2019",0,0,2,2
316400,"2020",1,0,0,1
316400,"2021",1,0,0,1
316400,"2022",2,1,2,5
316400,"2023",2,0,1,3
316410,"2015",0,0,2,2
316410,"2016",4,0,3,7
316410,"2017",0,1,0,1
316410,"2018",0,1,2,3
316410,"2019",0,1,5,6
316410,"2020",1,1,1,3
316410,"2021",1,0,4,5
316410,"2023",1,0,0,1
316420,"2015",2,0,8,10
316420,"2016",1,0,9,10
316420,"2017",1,1,4,6
316420,"2018",3,0,2,5
316420,"2019",1,0,4,5
316420,"2020",2,0,4,6
316420,"2021",3,0,1,4
316420,"2022",1,0,3,4
316420,"2023",1,0,1,2
316430,"2015",1,1,1,3
316430,"2016",1,1,1,3
316430,"2017",0,1,3,4
316430,"2018",0,0,2,2
316430,"2019",0,0,1,1
316430,"2020",2,0,1,3
316430,"2021",1,0,1,2
316430,"2022",2,1,0,3
316430,"2023",1,0,1,2
316440,"2015",4,0,1,5
316440,"2016",2,0,3,5
316440,"2017",4,2,3,9
316440,"2018",1,0,0,1
316440,"2019",1,1,2,4
316440,"2020",0,0,1,1
316440,"2021",1,0,0,1
316440,"2022",3,2,1,6
316440,"2023",0,0,3,3
316443,"2015",0,0,1,1
316443,"2017",0,0,1,1
316443,"2022",0,1,0,1
316447,"2015",3,1,6,10
316447,"2016",2,0,7,9
316447,"2017",1,1,5,7
316447,"2018",1,0,2,3
316447,"2020",1,1,2,4
316447,"2021",1,0,2,3
316447,"2022",3,1,1,5
316447,"2023",0,0,6,6
316450,"2015",2,1,3,6
316450,"2016",1,0,3,4
316450,"2017",2,0,7,9
316450,"2018",4,0,2,6
316450,"2019",0,0,2,2
316450,"2020",2,0,3,5
316450,"2021",4,0,4,8
316450,"2022",1,0,4,5
316450,"2023",2,1,1,4
316460,"2015",2,1,1,4
316460,"2016",0,0,3,3
316460,"2017",2,0,3,5
316460,"2018",1,0,5,6
316460,"2019",2,2,10,14
316460,"2020",2,2,9,13
316460,"2021",1,1,3,5
316460,"2022",0,0,2,2
316460,"2023",2,0,3,5
316470,"2015",7,6,19,32
316470,"2016",3,1,7,11
316470,"2017",6,2,12,20
316470,"2018",4,0,5,9
316470,"2019",4,1,1,6
316470,"2020",9,2,10,21
316470,"2021",8,4,18,30
316470,"2022",13,2,17,32
316470,"2023",5,1,12,18
316480,"2015",0,1,0,1
316480,"2016",0,1,2,3
316480,"2017",1,0,0,1
316480,"2018",1,0,0,1
316480,"2020",0,0,1,1
316480,"2023",1,0,0,1
316490,"2017",1,0,0,1
316490,"2019",1,0,0,1
316490,"2021",1,0,0,1
316500,"2015",0,0,1,1
316500,"2017",4,0,2,6
316500,"2018",2,0,5,7
316500,"2019",2,0,2,4
316500,"2020",1,0,1,2
316500,"2021",2,0,0,2
316500,"2022",0,0,1,1
316500,"2023",0,0,1,1
316510,"2015",1,0,4,5
316510,"2016",1,0,0,1
316510,"2017",1,0,2,3
316510,"2019",0,1,0,1
316510,"2020",2,0,0,2
316510,"2021",2,0,0,2
316510,"2022",0,3,1,4
316510,"2023",2,0,1,3
316520,"2015",1,1,2,4
316520,"2016",4,2,1,7
316520,"2017",1,0,1,2
316520,"2018",3,1,3,7
316520,"2019",0,0,2,2
316520,"2020",0,0,4,4
316520,"2021",1,0,2,3
316520,"2022",3,0,6,9
316520,"2023",0,0,3,3
316530,"2015",1,0,3,4
316530,"2016",2,0,2,4
316530,"2017",3,1,1,5
316530,"2018",1,0,0,1
316530,"2019",2,1,4,7
316530,"2020",1,0,2,3
316530,"2021",1,0,0,1
316530,"2022",1,0,1,2
316540,"2015",2,1,0,3
316540,"2016",2,2,2,6
316540,"2017",1,2,4,7
316540,"2018",5,0,0,5
316540,"2019",0,0,1,1
316540,"2020",1,0,0,1
316540,"2023",1,0,0,1
316550,"2015",0,0,1,1
316550,"2016",2,0,4,6
316550,"2017",1,0,0,1
316550,"2018",2,0,2,4
316550,"2019",0,1,0,1
316550,"2020",1,0,0,1
316550,"2022",0,0,5,5
316550,"2023",2,0,1,3
316553,"2015",16,1,15,32
316553,"2016",8,5,10,23
316553,"2017",6,4,13,23
316553,"2018",13,1,13,27
316553,"2019",9,1,10,20
316553,"2020",11,2,18,31
316553,"2021",7,1,9,17
316553,"2022",6,1,4,11
316553,"2023",4,2,4,10
316555,"2015",0,0,1,1
316555,"2016",2,0,2,4
316555,"2017",0,0,4,4
316555,"2018",1,0,2,3
316555,"2019",2,0,3,5
316555,"2020",0,0,1,1
316555,"2021",1,0,0,1
316555,"2022",1,0,1,2
316556,"2020",1,0,3,4
316556,"2021",0,0,1,1
316557,"2015",4,0,2,6
316557,"2016",1,0,1,2
316557,"2017",3,1,4,8
316557,"2018",0,0,1,1
316557,"2019",2,0,2,4
316557,"2020",1,0,1,2
316557,"2021",2,1,1,4
316557,"2022",1,1,2,4
316557,"2023",1,2,2,5
316560,"2015",3,0,0,3
316560,"2016",0,0,1,1
316560,"2017",1,0,2,3
316560,"2019",0,0,1,1
316560,"2021",0,0,1,1
316570,"2015",1,0,2,3
316570,"2016",5,0,1,6
316570,"2017",2,1,2,5
316570,"2018",0,0,3,3
316570,"2019",0,2,1,3
316570,"2020",1,0,2,3
316570,"2021",1,0,2,3
316570,"2022",0,1,1,2
316570,"2023",1,0,0,1
316580,"2015",0,1,1,2
316580,"2016",0,0,2,2
316580,"2017",1,1,0,2
316580,"2018",0,1,0,1
316580,"2021",0,0,1,1
316590,"2016",3,0,1,4
316590,"2018",2,1,3,6
316590,"2022",1,0,0,1
316590,"2023",1,0,0,1
316600,"2015",1,0,1,2
316600,"2016",1,0,0,1
316600,"2017",5,0,0,5
316600,"2018",1,0,2,3
316600,"2019",1,0,3,4
316600,"2020",1,1,1,3
316600,"2021",1,0,2,3
316600,"2022",0,1,3,4
316600,"2023",1,0,2,3
316610,"2015",2,0,1,3
316610,"2016",1,0,1,2
316610,"2017",1,0,1,2
316610,"2018",1,1,2,4
316610,"2019",1,0,0,1
316610,"2020",1,0,2,3
316610,"2021",0,0,3,3
316610,"2022",0,1,5,6
316610,"2023",3,0,2,5
316620,"2015",5,0,7,12
316620,"2016",3,2,4,9
316620,"2017",5,1,5,11
316620,"2018",1,1,4,6
316620,"2019",3,0,4,7
316620,"2020",1,1,2,4
316620,"2021",3,0,1,4
316620,"2022",0,1,0,1
316620,"2023",2,0,1,3
316630,"2015",0,1,1,2
316630,"2016",1,0,0,1
316630,"2017",0,0,1,1
316630,"2018",2,0,1,3
316630,"2019",1,1,1,3
316630,"2020",2,0,4,6
316630,"2021",2,0,4,6
316630,"2022",6,1,4,11
316630,"2023",2,0,2,4
316640,"2015",0,1,2,3
316640,"2018",0,1,0,1
316640,"2022",1,0,0,1
316650,"2015",0,0,2,2
316650,"2016",2,1,0,3
316650,"2017",1,2,0,3
316650,"2018",1,0,2,3
316650,"2019",2,0,1,3
316650,"2020",0,0,1,1
316650,"2021",1,1,1,3
316650,"2022",1,0,1,2
316650,"2023",1,0,0,1
316660,"2017",0,0,1,1
316670,"2016",1,0,1,2
316670,"2017",1,0,0,1
316670,"2018",1,0,3,4
316670,"2019",1,0,0,1
316670,"2020",0,0,1,1
316670,"2022",4,0,2,6
316670,"2023",1,0,2,3
316680,"2015",1,0,6,7
316680,"2016",3,0,10,13
316680,"2017",3,2,6,11
316680,"2018",3,0,4,7
316680,"2019",2,2,0,4
316680,"2020",1,0,6,7
316680,"2021",1,0,2,3
316680,"2022",0,1,3,4
316680,"2023",2,0,1,3
316690,"2015",2,2,1,5
316690,"2016",0,2,0,2
316690,"2017",3,0,2,5
316690,"2018",1,0,0,1
316690,"2019",1,1,2,4
316690,"2020",1,0,2,3
316690,"2021",2,0,2,4
316690,"2022",0,0,3,3
316690,"2023",0,1,1,2
316695,"2015",3,0,1,4
316695,"2016",4,0,2,6
316695,"2017",0,0,3,3
316695,"2018",4,1,0,5
316695,"2020",0,0,1,1
316695,"2021",3,0,2,5
316695,"2022",1,0,2,3
316695,"2023",1,0,4,5
316700,"2016",1,0,1,2
316700,"2017",0,0,1,1
316700,"2022",1,0,0,1
316710,"2015",11,3,14,28
316710,"2016",8,1,6,15
316710,"2017",6,0,9,15
316710,"2018",10,2,11,23
316710,"2019",9,2,16,27
316710,"2020",9,3,10,22
316710,"2021",3,1,6,10
316710,"2022",1,1,6,8
316710,"2023",5,0,7,12
316720,"2015",65,15,105,185
316720,"2016",68,19,117,204
316720,"2017",51,15,93,159
316720,"2018",63,22,82,167
316720,"2019",64,18,86,168
316720,"2020",48,9,50,107
316720,"2021",41,15,68,124
316720,"2022",35,6,55,96
316720,"2023",32,7,32,71
316730,"2015",1,0,1,2
316730,"2016",0,0,1,1
316730,"2017",0,1,0,1
316730,"2018",1,0,2,3
316730,"2019",0,0,1,1
316730,"2020",0,0,1,1
316730,"2021",1,0,0,1
316730,"2022",1,1,0,2
316740,"2015",2,0,0,2
316740,"2016",3,0,1,4
316740,"2017",3,0,2,5
316740,"2018",1,1,1,3
316740,"2019",2,0,1,3
316740,"2021",3,0,1,4
316740,"2022",0,0,3,3
316740,"2023",0,0,2,2
316750,"2015",0,0,2,2
316750,"2017",1,1,1,3
316750,"2018",1,0,0,1
316750,"2019",0,0,1,1
316750,"2022",1,0,0,1
316750,"2023",0,0,1,1
316760,"2015",7,1,9,17
316760,"2016",3,2,10,15
316760,"2017",12,4,20,36
316760,"2018",2,2,14,18
316760,"2019",3,1,6,10
316760,"2020",6,0,8,14
316760,"2021",11,0,5,16
316760,"2022",2,0,3,5
316760,"2023",1,0,1,2
316770,"2015",1,1,1,3
316770,"2016",1,0,0,1
316770,"2017",2,1,2,5
316770,"2018",2,0,2,4
316770,"2019",3,0,0,3
316770,"2021",0,0,1,1
316770,"2022",0,0,3,3
316770,"2023",1,0,1,2
316780,"2015",1,0,1,2
316780,"2016",0,0,3,3
316780,"2017",1,0,1,2
316780,"2018",1,0,0,1
316780,"2019",0,1,0,1
316780,"2020",0,0,2,2
316780,"2021",2,0,2,4
316790,"2015",0,0,2,2
316790,"2016",0,0,1,1
316790,"2017",0,2,1,3
316790,"2018",1,0,0,1
316790,"2019",0,0,1,1
316790,"2020",1,1,1,3
316790,"2021",1,0,1,2
316790,"2022",2,0,1,3
316790,"2023",0,0,1,1
316800,"2015",9,0,15,24
316800,"2016",5,1,16,22
316800,"2017",5,1,17,23
316800,"2018",9,2,12,23
316800,"2019",2,1,12,15
316800,"2020",7,3,11,21
316800,"2021",6,2,14,22
316800,"2022",6,3,5,14
316800,"2023",9,1,2,12
316805,"2015",0,0,2,2
316805,"2016",0,0,1,1
316805,"2017",1,0,0,1
316805,"2018",0,0,4,4
316805,"2020",3,0,2,5
316805,"2021",0,0,1,1
316805,"2022",1,0,0,1
316805,"2023",1,0,1,2
316810,"2015",0,0,1,1
316810,"2016",1,0,2,3
316810,"2017",0,0,2,2
316810,"2019",0,0,1,1
316810,"2020",1,0,0,1
316810,"2021",0,1,0,1
316810,"2022",1,0,2,3
316820,"2020",1,0,0,1
316820,"2022",1,0,1,2
316830,"2015",1,0,2,3
316830,"2016",2,0,2,4
316830,"2017",1,1,2,4
316830,"2018",1,1,2,4
316830,"2019",1,1,0,2
316830,"2021",1,0,0,1
316830,"2022",2,0,1,3
316830,"2023",1,0,0,1
316840,"2015",2,2,1,5
316840,"2016",3,0,6,9
316840,"2017",2,2,2,6
316840,"2018",1,0,0,1
316840,"2019",0,0,3,3
316840,"2020",1,1,3,5
316840,"2021",2,0,2,4
316840,"2022",1,0,1,2
316840,"2023",2,0,3,5
316850,"2015",2,0,3,5
316850,"2016",1,0,3,4
316850,"2017",2,1,1,4
316850,"2018",0,2,1,3
316850,"2019",2,0,3,5
316850,"2020",2,0,3,5
316850,"2021",2,0,5,7
316850,"2022",1,0,6,7
316850,"2023",0,1,3,4
316860,"2015",25,3,56,84
316860,"2016",25,7,51,83
316860,"2017",29,8,65,102
316860,"2018",35,7,61,103
316860,"2019",26,8,46,80
316860,"2020",21,9,38,68
316860,"2021",34,6,32,72
316860,"2022",26,7,40,73
316860,"2023",24,3,31,58
316870,"2015",21,4,32,57
316870,"2016",28,5,31,64
316870,"2017",27,3,29,59
316870,"2018",11,1,36,48
316870,"2019",16,13,20,49
316870,"2020",10,4,11,25
316870,"2021",11,3,17,31
316870,"2022",6,4,8,18
316870,"2023",6,5,8,19
316880,"2016",1,0,3,4
316880,"2017",0,0,2,2
316880,"2018",3,0,1,4
316880,"2019",1,1,3,5
316880,"2020",4,0,1,5
316880,"2021",0,0,1,1
316880,"2022",1,0,1,2
316880,"2023",1,0,3,4
316890,"2015",1,0,0,1
316890,"2016",0,0,3,3
316890,"2017",1,0,0,1
316890,"2018",1,0,0,1
316890,"2019",0,0,1,1
316890,"2020",2,0,0,2
316890,"2021",2,0,2,4
316890,"2022",2,0,1,3
316890,"2023",0,1,1,2
316900,"2015",1,0,6,7
316900,"2016",0,0,4,4
316900,"2017",5,1,8,14
316900,"2018",7,0,16,23
316900,"2019",6,1,2,9
316900,"2020",2,0,1,3
316900,"2021",2,1,8,11
316900,"2022",3,2,3,8
316900,"2023",4,0,6,10
316905,"2015",0,0,2,2
316905,"2016",0,0,1,1
316905,"2017",2,0,2,4
316905,"2018",1,1,1,3
316905,"2020",0,0,1,1
316905,"2022",1,1,1,3
316905,"2023",0,1,0,1
316910,"2015",1,0,3,4
316910,"2016",1,0,2,3
316910,"2017",3,0,1,4
316910,"2018",1,1,1,3
316910,"2019",1,0,4,5
316910,"2020",1,1,1,3
316910,"2021",1,0,1,2
316910,"2023",0,1,1,2
316920,"2015",2,0,2,4
316920,"2016",1,0,3,4
316920,"2017",0,3,0,3
316920,"2018",1,0,0,1
316920,"2019",0,1,0,1
316920,"2020",0,0,1,1
316920,"2021",0,1,0,1
316920,"2022",0,1,2,3
316920,"2023",1,0,3,4
316930,"2015",27,7,38,72
316930,"2016",24,3,32,59
316930,"2017",17,3,31,51
316930,"2018",22,9,28,59
316930,"2019",26,7,23,56
316930,"2020",13,5,23,41
316930,"2021",23,5,22,50
316930,"2022",14,6,29,49
316930,"2023",11,3,21,35
316935,"2015",12,2,18,32
316935,"2016",8,7,15,30
316935,"2017",9,3,15,27
316935,"2018",6,6,17,29
316935,"2019",12,1,4,17
316935,"2020",8,4,6,18
316935,"2021",10,2,7,19
316935,"2022",12,0,6,18
316935,"2023",4,1,5,10
316940,"2015",12,6,19,37
316940,"2016",21,6,24,51
316940,"2017",8,5,21,34
316940,"2018",17,6,14,37
316940,"2019",10,3,20,33
316940,"2020",16,4,22,42
316940,"2021",9,7,15,31
316940,"2022",7,0,16,23
316940,"2023",6,4,16,26
316950,"2015",0,1,2,3
316950,"2016",2,1,3,6
316950,"2017",1,0,1,2
316950,"2019",0,0,5,5
316950,"2021",0,0,1,1
316950,"2023",1,0,1,2
316960,"2015",2,0,2,4
316960,"2016",1,1,4,6
316960,"2017",0,1,9,10
316960,"2018",1,0,3,4
316960,"2019",3,0,1,4
316960,"2020",0,1,2,3
316960,"2021",1,0,2,3
316960,"2022",1,0,1,2
316970,"2015",6,2,16,24
316970,"2016",11,1,19,31
316970,"2017",12,2,11,25
316970,"2018",13,1,9,23
316970,"2019",9,2,9,20
316970,"2020",9,4,16,29
316970,"2021",6,6,15,27
316970,"2022",6,2,8,16
316970,"2023",7,1,9,17
316980,"2015",2,0,2,4
316980,"2016",0,0,2,2
316980,"2017",0,0,4,4
316980,"2018",2,0,3,5
316980,"2019",1,0,1,2
316980,"2020",0,0,1,1
316980,"2021",2,0,2,4
316980,"2022",2,1,3,6
316980,"2023",0,0,1,1
316990,"2015",22,3,26,51
316990,"2016",17,5,40,62
316990,"2017",30,5,49,84
316990,"2018",33,9,50,92
316990,"2019",33,10,49,92
316990,"2020",39,6,29,74
316990,"2021",28,3,35,66
316990,"2022",39,5,42,86
316990,"2023",25,4,42,71
317000,"2015",7,2,5,14
317000,"2016",6,0,5,11
317000,"2017",7,1,6,14
317000,"2018",3,2,2,7
317000,"2019",5,0,5,10
317000,"2020",6,2,4,12
317000,"2021",1,0,4,5
317000,"2022",1,1,5,7
317000,"2023",0,0,5,5
317005,"2015",5,1,3,9
317005,"2016",9,4,5,18
317005,"2017",0,0,2,2
317005,"2018",4,1,6,11
317005,"2019",4,0,5,9
317005,"2020",1,2,3,6
317005,"2021",2,1,3,6
317005,"2022",3,2,4,9
317005,"2023",6,1,3,10
317010,"2015",78,18,116,212
317010,"2016",60,9,113,182
317010,"2017",53,17,119,189
317010,"2018",64,15,115,194
317010,"2019",69,7,118,194
317010,"2020",60,18,84,162
317010,"2021",29,15,72,116
317010,"2022",39,9,64,112
317010,"2023",15,7,29,51
317020,"2015",81,13,165,259
317020,"2016",73,9,118,200
317020,"2017",58,17,114,189
317020,"2018",52,9,120,181
317020,"2019",38,9,76,123
317020,"2020",42,10,80,132
317020,"2021",38,17,81,136
317020,"2022",36,6,75,117
317020,"2023",30,5,46,81
317030,"2015",1,0,0,1
317030,"2017",0,1,0,1
317030,"2018",0,0,2,2
317030,"2019",1,0,0,1
317030,"2021",1,1,0,2
317030,"2022",0,0,1,1
317040,"2015",29,12,42,83
317040,"2016",23,7,52,82
317040,"2017",28,10,36,74
317040,"2018",22,1,54,77
317040,"2019",7,3,16,26
317040,"2020",13,2,28,43
317040,"2021",26,2,23,51
317040,"2022",16,2,22,40
317040,"2023",8,5,14,27
317043,"2015",0,0,1,1
317043,"2016",0,0,1,1
317043,"2018",0,0,1,1
317043,"2019",2,0,1,3
317043,"2021",0,0,1,1
317043,"2022",0,1,0,1
317047,"2015",2,0,0,2
317047,"2016",0,0,2,2
317047,"2017",1,0,1,2
317047,"2018",1,0,2,3
317047,"2019",1,0,1,2
317047,"2021",0,1,0,1
317050,"2015",0,1,0,1
317050,"2016",0,0,1,1
317050,"2018",0,0,1,1
317050,"2019",1,0,2,3
317050,"2020",2,0,7,9
317050,"2021",2,1,4,7
317050,"2022",3,1,5,9
317050,"2023",2,0,3,5
317052,"2015",0,0,5,5
317052,"2016",0,0,2,2
317052,"2017",1,0,1,2
317052,"2018",1,0,0,1
317052,"2019",1,0,1,2
317052,"2020",1,0,1,2
317052,"2021",1,0,3,4
317052,"2022",1,0,1,2
317052,"2023",2,0,2,4
317057,"2015",1,0,5,6
317057,"2016",0,0,2,2
317057,"2017",1,0,3,4
317057,"2018",1,2,4,7
317057,"2019",2,0,2,4
317057,"2020",2,0,4,6
317057,"2021",2,0,1,3
317057,"2022",1,0,0,1
317057,"2023",1,1,1,3
317060,"2016",0,0,1,1
317060,"2020",0,0,3,3
317060,"2022",2,0,2,4
317060,"2023",0,0,1,1
317065,"2015",2,0,1,3
317065,"2016",1,0,2,3
317065,"2017",2,1,1,4
317065,"2018",2,0,0,2
317065,"2019",1,0,0,1
317065,"2020",2,0,0,2
317065,"2022",0,1,0,1
317065,"2023",0,0,3,3
317070,"2015",47,5,54,106
317070,"2016",50,9,68,127
317070,"2017",47,10,45,102
317070,"2018",25,10,42,77
317070,"2019",37,5,42,84
317070,"2020",31,9,37,77
317070,"2021",20,10,52,82
317070,"2022",17,8,32,57
317070,"2023",21,7,28,56
317075,"2015",1,0,0,1
317075,"2016",2,0,1,3
317075,"2017",1,0,2,3
317075,"2018",1,1,0,2
317075,"2019",0,1,2,3
317075,"2020",0,0,1,1
317075,"2021",0,1,0,1
317075,"2022",2,0,2,4
317080,"2015",6,2,23,31
317080,"2016",10,1,14,25
317080,"2017",7,1,10,18
317080,"2018",7,2,15,24
317080,"2019",5,2,7,14
317080,"2020",5,1,13,19
317080,"2021",2,0,16,18
317080,"2022",6,2,11,19
317080,"2023",2,2,14,18
317090,"2015",6,3,5,14
317090,"2016",7,2,11,20
317090,"2017",8,0,5,13
317090,"2018",9,0,5,14
317090,"2019",13,1,9,23
317090,"2020",5,2,9,16
317090,"2021",5,2,7,14
317090,"2022",4,7,6,17
317090,"2023",2,1,4,7
317100,"2015",1,0,5,6
317100,"2016",1,0,4,5
317100,"2017",2,0,1,3
317100,"2018",3,0,1,4
317100,"2019",1,1,1,3
317100,"2020",1,0,0,1
317100,"2021",1,1,1,3
317100,"2022",0,0,4,4
317100,"2023",2,0,0,2
317103,"2015",1,0,13,14
317103,"2016",4,0,5,9
317103,"2017",1,0,8,9
317103,"2018",4,0,9,13
317103,"2019",1,0,5,6
317103,"2020",2,0,5,7
317103,"2021",3,0,0,3
317103,"2022",0,0,1,1
317103,"2023",2,0,4,6
317107,"2015",4,1,6,11
317107,"2016",5,2,3,10
317107,"2017",2,1,2,5
317107,"2018",1,1,4,6
317107,"2019",0,1,4,5
317107,"2020",2,2,2,6
317107,"2021",0,0,4,4
317107,"2022",3,1,5,9
317107,"2023",2,1,0,3
317110,"2015",0,1,0,1
317110,"2016",0,0,1,1
317110,"2017",0,0,1,1
317110,"2019",0,1,0,1
317110,"2020",1,0,1,2
317110,"2021",1,0,1,2
317110,"2023",1,0,0,1
317115,"2015",2,0,5,7
317115,"2016",3,0,1,4
317115,"2017",1,0,5,6
317115,"2018",2,0,1,3
317115,"2020",0,1,4,5
317115,"2021",0,1,0,1
317115,"2022",0,0,1,1
317115,"2023",1,0,3,4
317120,"2015",44,5,55,104
317120,"2016",34,5,59,98
317120,"2017",31,2,64,97
317120,"2018",29,8,36,73
317120,"2019",31,3,29,63
317120,"2020",32,2,46,80
317120,"2021",21,8,37,66
317120,"2022",30,6,36,72
317120,"2023",22,5,18,45
317130,"2015",7,2,12,21
317130,"2016",12,1,24,37
317130,"2017",17,5,19,41
317130,"2018",9,4,24,37
317130,"2019",7,1,9,17
317130,"2020",10,1,17,28
317130,"2021",10,2,17,29
317130,"2022",16,5,21,42
317130,"2023",7,2,9,18
317140,"2019",0,0,1,1
317140,"2023",0,1,1,2
317150,"2015",1,0,1,2
317150,"2016",0,0,3,3
317150,"2017",1,0,1,2
317150,"2018",1,0,4,5
317150,"2019",1,0,1,2
317150,"2020",1,1,3,5
317150,"2022",1,0,0,1
317150,"2023",0,0,1,1
317160,"2015",0,0,3,3
317160,"2016",0,1,3,4
317160,"2018",1,1,5,7
317160,"2019",1,0,1,2
317160,"2020",0,0,1,1
317160,"2022",0,0,1,1
317160,"2023",3,0,0,3
317170,"2015",1,0,1,2
317170,"2016",1,0,2,3
317170,"2017",1,0,1,2
317170,"2018",1,1,1,3
317170,"2019",1,0,3,4
317170,"2020",2,2,0,4
317170,"2021",1,0,3,4
317170,"2022",1,1,1,3
317170,"2023",1,0,0,1
317180,"2015",3,2,10,15
317180,"2016",6,1,6,13
317180,"2017",10,0,5,15
317180,"2018",8,1,4,13
317180,"2019",2,3,5,10
317180,"2020",5,1,3,9
317180,"2021",3,1,6,10
317180,"2022",4,1,6,11
317180,"2023",3,0,3,6
317190,"2015",1,0,3,4
317190,"2016",1,0,0,1
317190,"2018",0,0,2,2
317190,"2019",0,0,1,1
317190,"2020",1,0,1,2
317190,"2022",1,0,0,1
317200,"2015",5,0,12,17
317200,"2016",4,0,6,10
317200,"2017",9,2,10,21
317200,"2018",11,0,4,15
317200,"2019",11,1,9,21
317200,"2020",12,1,11,24
317200,"2021",5,1,3,9
317200,"2022",4,1,3,8
317200,"2023",6,2,4,12
317210,"2015",0,0,1,1
317210,"2016",1,0,4,5
317210,"2017",0,1,1,2
317210,"2018",2,0,0,2
317210,"2019",1,0,1,2
317210,"2020",1,1,0,2
317210,"2021",1,0,0,1
317210,"2022",1,0,0,1
317220,"2015",2,0,1,3
317220,"2016",1,0,0,1
317220,"2017",2,0,0,2
317220,"2019",0,1,0,1
317220,"2020",0,0,1,1
317220,"2021",1,0,0,1
317220,"2022",0,1,0,1
320010,"2015",11,0,14,25
320010,"2016",9,1,19,29
320010,"2017",2,2,19,23
320010,"2018",13,3,14,30
320010,"2019",7,2,11,20
320010,"2020",13,1,5,19
320010,"2021",9,2,12,23
320010,"2022",10,2,3,15
320010,"2023",5,2,4,11
320013,"2015",0,0,1,1
320013,"2017",0,1,1,2
320013,"2019",0,0,1,1
320013,"2020",0,0,1,1
320013,"2021",1,1,3,5
320013,"2022",2,0,4,6
320013,"2023",0,1,2,3
320016,"2015",1,0,4,5
320016,"2016",1,0,0,1
320016,"2017",1,0,2,3
320016,"2019",1,0,3,4
320016,"2020",1,1,1,3
320016,"2021",2,0,4,6
320016,"2022",4,0,2,6
320016,"2023",0,0,3,3
320020,"2015",5,0,6,11
320020,"2016",1,0,4,5
320020,"2017",7,0,5,12
320020,"2018",3,0,4,7
320020,"2019",3,2,2,7
320020,"2020",2,1,3,6
320020,"2021",1,0,4,5
320020,"2022",2,1,7,10
320020,"2023",2,0,1,3
320030,"2015",1,2,3,6
320030,"2016",1,1,0,2
320030,"2017",1,0,5,6
320030,"2018",2,2,5,9
320030,"2019",1,0,1,2
320030,"2020",2,1,5,8
320030,"2021",1,1,3,5
320030,"2022",3,0,3,6
320030,"2023",0,0,2,2
320035,"2015",0,0,7,7
320035,"2016",2,0,4,6
320035,"2017",1,1,0,2
320035,"2018",2,0,3,5
320035,"2019",1,0,4,5
320035,"2020",2,0,2,4
320035,"2021",1,1,2,4
320035,"2022",2,0,0,2
320035,"2023",2,0,1,3
320040,"2015",1,0,0,1
320040,"2016",4,2,4,10
320040,"2017",6,2,13,21
320040,"2018",3,0,8,11
320040,"2019",9,4,5,18
320040,"2020",7,3,9,19
320040,"2021",7,2,10,19
320040,"2022",4,5,8,17
320040,"2023",7,1,7,15
320050,"2016",1,0,0,1
320050,"2019",3,1,3,7
320050,"2020",0,0,1,1
320050,"2021",2,0,0,2
320050,"2022",0,0,1,1
320050,"2023",1,0,1,2
320060,"2015",18,9,34,61
320060,"2016",21,9,53,83
320060,"2017",29,6,45,80
320060,"2018",14,3,36,53
320060,"2019",26,4,36,66
320060,"2020",22,8,28,58
320060,"2021",32,5,34,71
320060,"2022",16,8,27,51
320060,"2023",18,5,17,40
320070,"2017",0,1,0,1
320070,"2018",1,0,3,4
320070,"2019",1,0,3,4
320070,"2020",4,0,1,5
320070,"2021",3,0,2,5
320070,"2022",1,0,3,4
320070,"2023",1,0,1,2
320080,"2015",7,4,10,21
320080,"2016",5,0,8,13
320080,"2017",5,4,11,20
320080,"2018",10,0,13,23
320080,"2019",13,3,15,31
320080,"2020",6,2,10,18
320080,"2021",3,2,11,16
320080,"2022",7,2,7,16
320080,"2023",3,1,4,8
320090,"2015",4,2,8,14
320090,"2016",1,0,1,2
320090,"2017",4,3,8,15
320090,"2018",0,0,3,3
320090,"2019",4,2,6,12
320090,"2020",5,3,7,15
320090,"2021",4,2,13,19
320090,"2022",9,3,13,25
320090,"2023",4,0,7,11
320100,"2015",2,1,0,3
320100,"2016",1,0,2,3
320100,"2017",0,1,1,2
320100,"2019",0,0,1,1
320100,"2020",1,0,0,1
320100,"2021",0,0,3,3
320100,"2022",1,0,1,2
320110,"2018",1,1,1,3
320110,"2019",1,1,0,2
320110,"2020",1,0,1,2
320110,"2021",1,1,0,2
320115,"2015",3,0,0,3
320115,"2016",2,1,6,9
320115,"2017",1,1,5,7
320115,"2018",2,0,9,11
320115,"2019",4,0,2,6
320115,"2020",3,1,1,5
320115,"2021",4,0,2,6
320115,"2022",2,1,3,6
320115,"2023",2,0,2,4
320120,"2015",8,1,18,27
320120,"2016",7,0,16,23
320120,"2017",26,2,24,52
320120,"2018",22,5,22,49
320120,"2019",31,3,34,68
320120,"2020",29,9,41,79
320120,"2021",27,8,35,70
320120,"2022",25,10,42,77
320120,"2023",11,5,19,35
320130,"2015",106,21,196,323
320130,"2016",75,16,173,264
320130,"2017",91,14,139,244
320130,"2018",91,21,149,261
320130,"2019",68,24,109,201
320130,"2020",68,14,108,190
320130,"2021",68,7,86,161
320130,"2022",51,21,95,167
320130,"2023",43,12,62,117
320140,"2015",5,2,8,15
320140,"2016",7,0,10,17
320140,"2017",5,1,7,13
320140,"2018",5,2,13,20
320140,"2019",17,3,7,27
320140,"2020",9,3,17,29
320140,"2021",8,2,6,16
320140,"2022",9,5,10,24
320140,"2023",8,0,12,20
320150,"2015",25,5,47,77
320150,"2016",21,2,49,72
320150,"2017",26,6,38,70
320150,"2018",15,5,32,52
320150,"2019",21,4,35,60
320150,"2020",22,8,24,54
320150,"2021",13,7,21,41
320150,"2022",22,4,29,55
320150,"2023",12,6,18,36
320160,"2015",6,1,13,20
320160,"2016",9,0,16,25
320160,"2017",6,1,15,22
320160,"2018",11,0,12,23
320160,"2019",8,2,14,24
320160,"2020",5,2,13,20
320160,"2021",6,4,18,28
320160,"2022",6,0,10,16
320160,"2023",2,0,6,8
320170,"2015",2,0,4,6
320170,"2016",2,2,8,12
320170,"2017",5,1,6,12
320170,"2018",5,1,5,11
320170,"2019",3,0,3,6
320170,"2020",3,0,7,10
320170,"2021",1,0,6,7
320170,"2022",2,0,3,5
320170,"2023",1,0,2,3
320180,"2016",0,0,1,1
320180,"2018",0,0,1,1
320180,"2019",0,0,2,2
320180,"2020",1,0,0,1
320180,"2021",1,0,0,1
320180,"2022",1,0,1,2
320180,"2023",0,1,1,2
320190,"2015",2,0,15,17
320190,"2016",4,0,8,12
320190,"2017",6,2,9,17
320190,"2018",5,2,5,12
320190,"2019",4,3,5,12
320190,"2020",4,1,9,14
320190,"2021",6,1,9,16
320190,"2022",5,2,3,10
320190,"2023",7,1,6,14
320200,"2015",1,0,0,1
320200,"2018",1,0,0,1
320200,"2019",0,0,2,2
320200,"2020",1,0,0,1
320200,"2021",0,0,1,1
320200,"2022",1,0,1,2
320200,"2023",1,1,2,4
320210,"2015",1,0,0,1
320210,"2016",0,1,1,2
320210,"2017",2,1,4,7
320210,"2018",0,1,0,1
320210,"2019",1,0,0,1
320210,"2020",4,0,5,9
320210,"2021",7,0,6,13
320210,"2022",3,2,3,8
320210,"2023",1,0,2,3
320220,"2015",2,0,1,3
320220,"2016",1,0,4,5
320220,"2017",5,1,2,8
320220,"2018",1,0,0,1
320220,"2019",1,0,1,2
320220,"2020",1,1,0,2
320220,"2021",2,1,7,10
320220,"2022",1,0,4,5
320220,"2023",2,2,3,7
320225,"2015",1,0,4,5
320225,"2016",1,0,4,5
320225,"2017",1,0,3,4
320225,"2018",4,0,3,7
320225,"2020",1,1,1,3
320225,"2021",1,1,0,2
320225,"2022",3,1,1,5
320225,"2023",1,0,2,3
320230,"2015",4,3,5,12
320230,"2016",8,1,11,20
320230,"2017",2,0,19,21
320230,"2018",1,1,11,13
320230,"2019",4,0,12,16
320230,"2020",3,2,14,19
320230,"2021",9,3,8,20
320230,"2022",1,1,9,11
320230,"2023",3,1,9,13
320240,"2015",23,7,42,72
320240,"2016",33,11,63,107
320240,"2017",28,9,53,90
320240,"2018",31,6,37,74
320240,"2019",38,4,41,83
320240,"2020",20,3,49,72
320240,"2021",27,7,42,76
320240,"2022",27,12,32,71
320240,"2023",17,11,27,55
320245,"2015",4,0,11,15
320245,"2016",4,0,6,10
320245,"2017",8,1,10,19
320245,"2018",10,4,13,27
320245,"2019",5,3,14,22
320245,"2020",8,2,13,23
320245,"2021",7,1,5,13
320245,"2022",2,0,5,7
320245,"2023",3,1,6,10
320250,"2016",1,2,4,7
320250,"2017",4,2,4,10
320250,"2018",3,1,1,5
320250,"2019",1,0,2,3
320250,"2020",1,0,2,3
320250,"2021",1,1,1,3
320250,"2022",2,0,2,4
320255,"2015",1,0,0,1
320255,"2016",3,0,0,3
320255,"2017",0,0,1,1
320255,"2018",2,1,4,7
320255,"2019",0,0,5,5
320255,"2021",3,0,1,4
320255,"2022",1,1,4,6
320255,"2023",1,0,2,3
320260,"2015",0,0,3,3
320260,"2016",2,0,0,2
320260,"2017",5,0,1,6
320260,"2018",3,1,0,4
320260,"2019",2,0,2,4
320260,"2020",0,0,1,1
320260,"2021",2,1,3,6
320260,"2022",1,0,3,4
320260,"2023",1,0,1,2
320265,"2015",0,0,2,2
320265,"2017",0,1,0,1
320265,"2018",0,0,2,2
320265,"2020",2,1,2,5
320265,"2021",3,0,1,4
320265,"2023",0,0,2,2
320270,"2015",0,0,3,3
320270,"2016",0,0,2,2
320270,"2017",2,0,2,4
320270,"2018",0,0,1,1
320270,"2019",0,1,5,6
320270,"2020",0,1,3,4
320270,"2021",2,0,0,2
320270,"2022",0,0,4,4
320270,"2023",3,1,3,7
320280,"2015",11,3,19,33
320280,"2016",9,2,22,33
320280,"2017",13,1,26,40
320280,"2018",6,4,17,27
320280,"2019",10,2,17,29
320280,"2020",19,2,20,41
320280,"2021",11,4,16,31
320280,"2022",17,3,18,38
320280,"2023",14,2,9,25
320290,"2015",1,2,3,6
320290,"2016",0,1,1,2
320290,"2017",0,0,2,2
320290,"2018",3,0,1,4
320290,"2019",2,0,1,3
320290,"2020",3,0,1,4
320290,"2021",1,0,3,4
320290,"2022",3,1,0,4
320300,"2015",2,0,0,2
320300,"2016",1,0,0,1
320300,"2017",2,0,1,3
320300,"2018",1,1,4,6
320300,"2019",1,1,5,7
320300,"2020",2,0,6,8
320300,"2021",0,1,0,1
320300,"2022",2,0,1,3
320300,"2023",2,1,6,9
320305,"2015",0,0,4,4
320305,"2016",1,0,3,4
320305,"2017",0,0,3,3
320305,"2018",2,0,6,8
320305,"2019",0,0,3,3
320305,"2020",1,0,2,3
320305,"2021",1,0,4,5
320305,"2022",0,0,3,3
320305,"2023",0,0,2,2
320310,"2015",0,1,1,2
320310,"2016",2,0,0,2
320310,"2018",4,1,4,9
320310,"2019",0,0,1,1
320310,"2020",2,1,2,5
320310,"2021",1,0,2,3
320310,"2022",1,0,3,4
320310,"2023",1,1,1,3
320313,"2015",0,0,4,4
320313,"2016",1,0,2,3
320313,"2017",1,0,1,2
320313,"2018",4,0,0,4
320313,"2019",0,0,1,1
320313,"2020",0,1,1,2
320313,"2021",0,0,1,1
320316,"2015",1,0,0,1
320316,"2016",3,1,2,6
320316,"2017",2,0,2,4
320316,"2018",2,1,0,3
320316,"2019",1,0,4,5
320316,"2020",2,1,0,3
320316,"2021",1,0,0,1
320316,"2022",1,0,1,2
320316,"2023",1,0,2,3
320320,"2015",34,6,69,109
320320,"2016",50,9,93,152
320320,"2017",34,8,73,115
320320,"2018",38,7,52,97
320320,"2019",40,2,53,95
320320,"2020",31,9,58,98
320320,"2021",39,6,64,109
320320,"2022",35,8,57,100
320320,"2023",18,5,22,45
320330,"2015",0,3,2,5
320330,"2016",0,0,2,2
320330,"2017",0,1,5,6
320330,"2018",2,1,4,7
320330,"2019",4,0,5,9
320330,"2020",1,1,6,8
320330,"2021",4,0,1,5
320330,"2022",3,0,1,4
320330,"2023",0,0,2,2
320332,"2015",9,1,18,28
320332,"2016",13,3,19,35
320332,"2017",12,1,19,32
320332,"2018",9,3,9,21
320332,"2019",10,2,15,27
320332,"2020",12,2,21,35
320332,"2021",9,3,9,21
320332,"2022",7,4,10,21
320332,"2023",4,3,10,17
320334,"2015",1,2,1,4
320334,"2016",4,0,1,5
320334,"2017",0,0,4,4
320334,"2018",2,0,1,3
320334,"2019",3,2,2,7
320334,"2020",1,1,3,5
320334,"2021",2,0,2,4
320334,"2022",1,0,4,5
320334,"2023",1,0,4,5
320335,"2015",1,0,3,4
320335,"2016",2,1,4,7
320335,"2017",0,1,1,2
320335,"2018",3,0,1,4
320335,"2019",2,0,2,4
320335,"2020",3,1,4,8
320335,"2021",0,0,2,2
320335,"2022",0,1,2,3
320335,"2023",2,1,2,5
320340,"2015",7,4,11,22
320340,"2016",3,1,8,12
320340,"2017",9,2,15,26
320340,"2018",10,0,15,25
320340,"2019",9,1,11,21
320340,"2020",6,1,11,18
320340,"2021",8,4,9,21
320340,"2022",5,8,9,22
320340,"2023",3,0,4,7
320350,"2015",4,2,9,15
320350,"2016",1,0,2,3
320350,"2017",1,0,7,8
320350,"2018",1,2,5,8
320350,"2019",4,1,12,17
320350,"2020",6,1,12,19
320350,"2021",1,0,3,4
320350,"2022",0,2,2,4
320350,"2023",1,2,2,5
320360,"2015",3,0,4,7
320360,"2016",2,2,2,6
320360,"2017",0,1,2,3
320360,"2018",1,0,2,3
320360,"2019",3,0,5,8
320360,"2020",0,0,3,3
320360,"2021",0,1,4,5
320360,"2022",0,0,1,1
320360,"2023",1,0,1,2
320370,"2015",5,1,9,15
320370,"2016",1,0,8,9
320370,"2017",0,0,3,3
320370,"2018",3,0,6,9
320370,"2019",3,0,6,9
320370,"2020",1,0,2,3
320370,"2021",2,0,5,7
320370,"2022",0,0,3,3
320370,"2023",0,0,2,2
320380,"2015",1,3,6,10
320380,"2016",2,1,1,4
320380,"2017",1,1,0,2
320380,"2018",2,8,2,12
320380,"2019",0,0,2,2
320380,"2020",2,2,3,7
320380,"2021",0,0,1,1
320380,"2022",6,0,3,9
320380,"2023",1,1,0,2
320390,"2015",0,0,2,2
320390,"2016",0,0,2,2
320390,"2017",3,0,1,4
320390,"2018",0,1,6,7
320390,"2019",1,0,5,6
320390,"2020",0,0,2,2
320390,"2021",2,0,2,4
320390,"2022",3,0,1,4
320390,"2023",0,0,4,4
320400,"2015",0,0,2,2
320400,"2016",1,1,5,7
320400,"2017",2,0,3,5
320400,"2018",1,0,3,4
320400,"2019",0,1,4,5
320400,"2020",0,0,3,3
320400,"2021",1,0,2,3
320400,"2022",3,0,3,6
320400,"2023",3,0,2,5
320405,"2015",3,1,13,17
320405,"2016",2,1,12,15
320405,"2017",11,1,10,22
320405,"2018",7,1,7,15
320405,"2019",3,1,9,13
320405,"2020",0,1,10,11
320405,"2021",5,1,7,13
320405,"2022",2,1,11,14
320405,"2023",6,0,3,9
320410,"2015",6,3,16,25
320410,"2016",10,0,16,26
320410,"2017",6,4,17,27
320410,"2018",8,1,22,31
320410,"2019",5,3,17,25
320410,"2020",5,3,8,16
320410,"2021",1,0,5,6
320410,"2022",3,0,3,6
320410,"2023",0,0,7,7
320420,"2015",6,4,6,16
320420,"2016",6,2,9,17
320420,"2017",5,0,7,12
320420,"2018",4,0,4,8
320420,"2019",8,1,11,20
320420,"2020",6,1,12,19
320420,"2021",4,0,10,14
320420,"2022",5,1,17,23
320420,"2023",1,2,3,6
320425,"2015",1,1,0,2
320425,"2016",6,0,0,6
320425,"2017",0,2,1,3
320425,"2018",0,0,2,2
320425,"2019",1,0,1,2
320425,"2020",2,0,6,8
320425,"2022",0,0,1,1
320425,"2023",1,0,0,1
320430,"2015",1,0,2,3
320430,"2016",2,0,3,5
320430,"2017",0,1,3,4
320430,"2018",1,0,5,6
320430,"2019",0,2,7,9
320430,"2020",3,0,5,8
320430,"2021",1,0,5,6
320430,"2022",2,3,3,8
320430,"2023",3,1,2,6
320435,"2015",1,0,5,6
320435,"2016",2,0,5,7
320435,"2017",3,0,2,5
320435,"2018",1,0,4,5
320435,"2019",3,1,4,8
320435,"2020",3,2,3,8
320435,"2021",2,1,2,5
320435,"2022",2,2,5,9
320435,"2023",1,0,3,4
320440,"2015",1,1,1,3
320440,"2016",2,0,0,2
320440,"2017",3,0,4,7
320440,"2018",2,0,3,5
320440,"2019",1,0,1,2
320440,"2020",5,0,2,7
320440,"2021",0,0,1,1
320440,"2022",2,0,1,3
320440,"2023",0,0,1,1
320450,"2015",2,1,3,6
320450,"2016",10,0,1,11
320450,"2017",2,1,2,5
320450,"2018",0,1,2,3
320450,"2019",1,0,3,4
320450,"2020",0,2,5,7
320450,"2022",3,0,0,3
320450,"2023",2,0,0,2
320455,"2015",20,5,34,59
320455,"2016",21,8,34,63
320455,"2017",21,6,27,54
320455,"2018",18,3,32,53
320455,"2019",9,6,14,29
320455,"2020",13,3,14,30
320455,"2021",17,3,23,43
320455,"2022",15,5,14,34
320455,"2023",16,7,16,39
320460,"2015",1,0,8,9
320460,"2016",2,0,0,2
320460,"2017",1,0,2,3
320460,"2018",1,0,1,2
320460,"2019",3,1,5,9
320460,"2020",6,1,7,14
320460,"2021",5,2,2,9
320460,"2022",6,3,2,11
320460,"2023",1,2,1,4
320465,"2015",0,2,2,4
320465,"2016",1,0,2,3
320465,"2017",0,0,1,1
320465,"2018",1,0,1,2
320465,"2019",2,0,2,4
320465,"2021",0,1,1,2
320465,"2022",0,0,6,6
320465,"2023",1,1,1,3
320470,"2015",4,1,6,11
320470,"2016",5,0,5,10
320470,"2017",3,1,7,11
320470,"2018",1,1,3,5
320470,"2019",1,0,10,11
320470,"2020",2,0,6,8
320470,"2021",5,1,3,9
320470,"2022",2,0,2,4
320470,"2023",5,3,2,10
320480,"2015",0,0,1,1
320480,"2016",2,0,1,3
320480,"2017",0,0,5,5
320480,"2018",0,0,5,5
320480,"2019",0,0,5,5
320480,"2020",1,0,1,2
320480,"2021",2,0,0,2
320480,"2022",1,1,1,3
320480,"2023",1,0,1,2
320490,"2015",40,4,61,105
320490,"2016",29,4,51,84
320490,"2017",32,10,65,107
320490,"2018",24,6,51,81
320490,"2019",45,9,54,108
320490,"2020",31,13,56,100
320490,"2021",46,14,63,123
320490,"2022",20,8,43,71
320490,"2023",26,4,34,64
320495,"2015",1,0,2,3
320495,"2016",1,1,1,3
320495,"2017",0,0,3,3
320495,"2018",0,0,1,1
320495,"2019",3,0,0,3
320495,"2020",1,0,1,2
320495,"2021",0,0,1,1
320495,"2022",1,0,0,1
320495,"2023",2,0,0,2
320500,"2015",139,24,223,386
320500,"2016",133,26,205,364
320500,"2017",86,23,151,260
320500,"2018",109,21,144,274
320500,"2019",94,25,134,253
320500,"2020",87,19,142,248
320500,"2021",73,26,123,222
320500,"2022",88,31,133,252
320500,"2023",83,16,123,222
320501,"2015",3,2,11,16
320501,"2016",5,4,9,18
320501,"2017",3,1,10,14
320501,"2018",4,1,7,12
320501,"2019",2,2,8,12
320501,"2020",5,2,11,18
320501,"2021",3,1,7,11
320501,"2022",4,3,13,20
320501,"2023",2,0,2,4
320503,"2015",0,0,3,3
320503,"2016",2,0,0,2
320503,"2017",0,0,2,2
320503,"2018",2,0,1,3
320503,"2019",2,0,7,9
320503,"2020",3,2,0,5
320503,"2021",4,1,1,6
320503,"2022",4,0,7,11
320503,"2023",3,0,2,5
320506,"2015",4,1,11,16
320506,"2016",4,0,8,12
320506,"2017",12,1,6,19
320506,"2018",8,2,8,18
320506,"2019",5,1,2,8
320506,"2020",5,2,13,20
320506,"2021",1,1,11,13
320506,"2022",7,1,7,15
320506,"2023",3,0,2,5
320510,"2015",11,6,43,60
320510,"2016",17,2,15,34
320510,"2017",10,3,23,36
320510,"2018",13,0,21,34
320510,"2019",15,5,25,45
320510,"2020",14,6,17,37
320510,"2021",9,5,18,32
320510,"2022",5,3,14,22
320510,"2023",12,2,6,20
320515,"2016",1,0,0,1
320515,"2017",1,0,1,2
320515,"2018",0,0,1,1
320515,"2021",0,0,1,1
320515,"2022",1,0,1,2
320515,"2023",1,0,0,1
320517,"2015",0,0,4,4
320517,"2016",3,0,3,6
320517,"2017",3,0,6,9
320517,"2018",3,0,2,5
320517,"2019",0,0,2,2
320517,"2020",1,1,3,5
320517,"2021",4,0,4,8
320517,"2022",1,1,1,3
320517,"2023",1,0,3,4
320520,"2015",99,24,156,279
320520,"2016",61,13,156,230
320520,"2017",63,25,141,229
320520,"2018",82,26,131,239
320520,"2019",71,10,118,199
320520,"2020",57,11,110,178
320520,"2021",78,20,118,216
320520,"2022",72,23,108,203
320520,"2023",55,9,75,139
320530,"2015",63,13,128,204
320530,"2016",51,17,98,166
320530,"2017",69,8,95,172
320530,"2018",47,15,93,155
320530,"2019",69,16,105,190
320530,"2020",48,7,65,120
320530,"2021",55,13,71,139
320530,"2022",28,6,59,93
320530,"2023",29,8,44,81
330010,"2015",43,14,89,146
330010,"2016",34,11,95,140
330010,"2017",37,15,91,143
330010,"2018",45,19,84,148
330010,"2019",48,12,76,136
330010,"2020",49,13,78,140
330010,"2021",31,6,50,87
330010,"2022",26,14,39,79
330010,"2023",9,5,13,27
330015,"2015",0,0,3,3
330015,"2017",2,0,1,3
330015,"2018",0,0,2,2
330015,"2020",1,0,0,1
330015,"2021",1,0,2,3
330015,"2022",0,1,0,1
330015,"2023",0,0,1,1
330020,"2015",3,0,8,11
330020,"2016",9,0,14,23
330020,"2017",10,0,16,26
330020,"2018",13,3,14,30
330020,"2019",15,2,19,36
330020,"2020",10,2,14,26
330020,"2021",6,1,9,16
330020,"2022",17,3,23,43
330020,"2023",4,9,21,34
330022,"2015",1,0,3,4
330022,"2016",3,0,2,5
330022,"2017",1,0,6,7
330022,"2018",2,1,4,7
330022,"2019",0,0,3,3
330022,"2020",3,0,3,6
330022,"2021",4,0,3,7
330022,"2022",4,2,4,10
330022,"2023",1,1,4,6
330023,"2016",3,0,4,7
330023,"2017",16,4,36,56
330023,"2018",11,3,19,33
330023,"2019",18,4,46,68
330023,"2020",18,2,26,46
330023,"2021",11,5,27,43
330023,"2022",11,5,21,37
330023,"2023",12,1,18,31
330025,"2015",3,0,15,18
330025,"2016",10,1,25,36
330025,"2017",6,1,13,20
330025,"2018",4,0,10,14
330025,"2019",7,4,18,29
330025,"2020",2,0,12,14
330025,"2021",2,1,6,9
330025,"2022",1,0,3,4
330025,"2023",2,1,4,7
330030,"2015",16,2,24,42
330030,"2016",15,2,30,47
330030,"2017",14,4,31,49
330030,"2018",15,3,31,49
330030,"2019",17,5,20,42
330030,"2020",18,8,31,57
330030,"2021",17,7,40,64
330030,"2022",16,4,38,58
330030,"2023",9,3,20,32
330040,"2015",26,1,47,74
330040,"2016",17,4,39,60
330040,"2017",28,7,53,88
330040,"2018",41,14,60,115
330040,"2019",39,7,56,102
330040,"2020",38,9,55,102
330040,"2021",25,11,42,78
330040,"2022",30,14,48,92
330040,"2023",24,2,48,74
330045,"2015",49,12,159,220
330045,"2016",63,15,174,252
330045,"2017",55,15,189,259
330045,"2018",57,14,171,242
330045,"2019",63,20,187,270
330045,"2020",72,18,191,281
330045,"2021",74,16,179,269
330045,"2022",59,12,151,222
330045,"2023",39,4,96,139
330050,"2015",5,1,2,8
330050,"2016",3,0,6,9
330050,"2017",4,1,4,9
330050,"2018",1,1,2,4
330050,"2019",3,0,9,12
330050,"2021",2,0,2,4
330050,"2022",3,0,0,3
330050,"2023",0,0,1,1
330060,"2015",4,0,2,6
330060,"2016",2,0,9,11
330060,"2017",3,0,3,6
330060,"2018",0,0,3,3
330060,"2019",1,2,6,9
330060,"2020",6,0,8,14
330060,"2021",1,0,4,5
330060,"2022",3,2,5,10
330060,"2023",3,0,6,9
330070,"2015",62,11,121,194
330070,"2016",53,14,100,167
330070,"2017",47,14,114,175
330070,"2018",70,10,121,201
330070,"2019",59,18,119,196
330070,"2020",52,5,89,146
330070,"2021",39,15,110,164
330070,"2022",52,14,89,155
330070,"2023",37,17,67,121
330080,"2015",16,1,40,57
330080,"2016",17,5,46,68
330080,"2017",10,2,16,28
330080,"2018",0,1,6,7
330080,"2019",2,3,2,7
330080,"2020",5,1,2,8
330080,"2021",5,0,5,10
330080,"2022",3,0,5,8
330080,"2023",2,0,3,5
330090,"2015",3,0,2,5
330090,"2016",0,0,2,2
330090,"2017",0,0,1,1
330090,"2018",1,0,3,4
330090,"2019",0,0,2,2
330090,"2021",2,0,3,5
330090,"2022",2,0,1,3
330093,"2015",2,0,3,5
330093,"2016",0,0,3,3
330093,"2017",2,1,5,8
330093,"2018",2,0,3,5
330093,"2019",3,1,1,5
330093,"2020",4,0,4,8
330093,"2021",2,0,5,7
330093,"2022",2,1,3,6
330093,"2023",1,0,3,4
330095,"2015",2,2,8,12
330095,"2016",1,0,6,7
330095,"2017",3,0,2,5
330095,"2018",1,1,4,6
330095,"2019",3,0,4,7
330095,"2020",1,0,1,2
330095,"2021",3,0,2,5
330095,"2022",1,2,1,4
330095,"2023",1,0,1,2
330100,"2015",141,25,228,394
330100,"2016",93,20,160,273
330100,"2017",104,32,215,351
330100,"2018",113,20,201,334
330100,"2019",83,23,192,298
330100,"2020",80,35,176,291
330100,"2021",80,26,187,293
330100,"2022",98,34,195,327
330100,"2023",69,28,144,241
330110,"2015",1,0,2,3
330110,"2016",3,0,3,6
330110,"2018",1,0,0,1
330110,"2019",0,0,1,1
330110,"2020",0,0,1,1
330115,"2015",0,0,4,4
330115,"2016",1,0,4,5
330115,"2017",0,0,3,3
330115,"2018",1,0,1,2
330115,"2019",2,0,3,5
330115,"2020",2,0,2,4
330115,"2021",2,0,6,8
330115,"2022",2,0,0,2
330115,"2023",0,0,2,2
330120,"2017",1,0,0,1
330120,"2019",1,0,0,1
330120,"2020",1,0,0,1
330120,"2022",0,0,3,3
330120,"2023",1,0,4,5
330130,"2015",2,0,11,13
330130,"2016",5,1,14,20
330130,"2017",2,2,5,9
330130,"2018",1,0,4,5
330130,"2019",5,1,11,17
330130,"2020",2,0,6,8
330130,"2021",8,0,13,21
330130,"2022",10,2,24,36
330130,"2023",4,0,10,14
330140,"2015",1,2,5,8
330140,"2016",0,2,14,16
330140,"2017",3,1,9,13
330140,"2018",2,0,10,12
330140,"2019",2,1,6,9
330140,"2020",0,0,3,3
330140,"2021",3,2,5,10
330140,"2022",0,0,1,1
330140,"2023",1,0,4,5
330150,"2015",9,1,16,26
330150,"2016",7,2,19,28
330150,"2017",7,2,14,23
330150,"2019",1,0,0,1
330150,"2021",1,0,1,2
330150,"2023",1,0,0,1
330160,"2017",0,0,2,2
330160,"2019",1,0,3,4
330160,"2022",1,0,0,1
330170,"2015",311,67,756,1134
330170,"2016",231,69,589,889
330170,"2017",199,41,452,692
330170,"2018",154,51,375,580
330170,"2019",181,43,370,594
330170,"2020",146,36,384,566
330170,"2021",146,31,307,484
330170,"2022",94,25,209,328
330170,"2023",63,22,152,237
330180,"2015",2,0,3,5
330180,"2016",1,1,2,4
330180,"2017",1,0,8,9
330180,"2018",3,0,5,8
330180,"2019",0,0,2,2
330180,"2020",1,0,3,4
330180,"2021",4,0,2,6
330180,"2022",0,0,4,4
330180,"2023",1,0,0,1
330185,"2015",19,2,30,51
330185,"2016",23,3,27,53
330185,"2017",14,4,33,51
330185,"2018",5,1,16,22
330185,"2019",15,3,20,38
330185,"2020",10,4,13,27
330185,"2021",11,6,24,41
330185,"2022",15,2,9,26
330185,"2023",5,2,10,17
330187,"2015",1,0,1,2
330187,"2016",3,3,9,15
330187,"2017",3,1,2,6
330187,"2018",2,0,4,6
330187,"2019",1,2,8,11
330187,"2020",4,2,5,11
330187,"2021",1,1,4,6
330190,"2015",72,9,142,223
330190,"2016",36,8,70,114
330190,"2017",45,16,90,151
330190,"2018",33,16,77,126
330190,"2019",41,8,74,123
330190,"2020",43,10,89,142
330190,"2021",31,9,76,116
330190,"2022",43,10,63,116
330190,"2023",14,7,49,70
330200,"2015",26,3,51,80
330200,"2016",27,10,75,112
330200,"2017",15,3,40,58
330200,"2018",22,3,43,68
330200,"2019",34,3,42,79
330200,"2020",25,7,55,87
330200,"2021",23,10,49,82
330200,"2022",34,3,61,98
330200,"2023",19,1,35,55
330205,"2016",1,0,0,1
330205,"2017",0,0,2,2
330205,"2018",2,0,1,3
330205,"2019",1,0,1,2
330210,"2015",0,0,4,4
330210,"2016",0,0,1,1
330210,"2017",0,0,1,1
330210,"2022",1,1,0,2
330210,"2023",0,0,1,1
330220,"2015",6,2,43,51
330220,"2016",14,3,32,49
330220,"2017",14,5,34,53
330220,"2018",10,6,24,40
330220,"2019",8,0,18,26
330220,"2020",10,6,26,42
330220,"2021",13,5,28,46
330220,"2022",9,0,17,26
330220,"2023",9,6,24,39
330225,"2015",3,0,7,10
330225,"2016",5,0,11,16
330225,"2017",3,1,5,9
330225,"2018",3,2,7,12
330225,"2019",5,1,7,13
330225,"2020",0,1,6,7
330225,"2021",3,0,6,9
330225,"2022",5,2,8,15
330225,"2023",2,0,2,4
330227,"2015",12,1,37,50
330227,"2016",10,1,25,36
330227,"2017",7,1,38,46
330227,"2018",10,2,31,43
330227,"2019",13,2,29,44
330227,"2020",11,4,30,45
330227,"2021",9,3,17,29
330227,"2022",4,0,21,25
330227,"2023",5,3,20,28
330230,"2015",0,0,2,2
330230,"2016",0,0,3,3
330230,"2018",1,0,0,1
330230,"2019",0,0,2,2
330230,"2020",0,0,2,2
330240,"2015",55,9,138,202
330240,"2016",47,7,119,173
330240,"2017",62,19,107,188
330240,"2018",27,10,63,100
330240,"2019",58,11,123,192
330240,"2020",44,15,74,133
330240,"2021",51,11,94,156
330240,"2022",61,7,102,170
330240,"2023",55,14,63,132
330245,"2015",0,0,1,1
330245,"2020",0,0,1,1
330250,"2015",69,17,170,256
330250,"2016",71,12,168,251
330250,"2017",53,16,145,214
330250,"2018",50,9,130,189
330250,"2019",76,15,123,214
330250,"2020",66,16,122,204
330250,"2021",47,16,114,177
330250,"2022",51,15,96,162
330250,"2023",30,11,67,108
330260,"2015",7,3,20,30
330260,"2016",15,2,18,35
330260,"2017",5,2,17,24
330260,"2018",7,0,9,16
330260,"2019",6,0,4,10
330260,"2020",2,0,4,6
330260,"2021",4,0,1,5
330260,"2022",1,0,1,2
330260,"2023",1,0,2,3
330270,"2015",37,4,85,126
330270,"2016",7,1,12,20
330270,"2017",9,8,23,40
330270,"2018",32,7,47,86
330270,"2019",29,9,44,82
330270,"2020",11,4,27,42
330270,"2021",29,13,56,98
330270,"2022",27,17,58,102
330270,"2023",33,14,56,103
330280,"2015",3,1,2,6
330280,"2016",7,0,12,19
330280,"2017",1,0,6,7
330280,"2018",2,0,4,6
330280,"2019",1,1,3,5
330280,"2020",5,1,3,9
330280,"2021",2,2,2,6
330280,"2022",3,0,2,5
330280,"2023",1,1,3,5
330285,"2015",42,10,75,127
330285,"2016",33,4,63,100
330285,"2017",40,8,74,122
330285,"2018",28,8,67,103
330285,"2019",29,8,71,108
330285,"2020",30,7,50,87
330285,"2021",34,11,50,95
330285,"2022",28,5,48,81
330285,"2023",22,6,34,62
330290,"2015",2,6,17,25
330290,"2016",7,1,9,17
330290,"2017",7,2,13,22
330290,"2018",7,1,8,16
330290,"2019",5,3,5,13
330290,"2020",1,2,11,14
330290,"2021",2,1,5,8
330290,"2022",2,0,6,8
330290,"2023",3,0,1,4
330300,"2015",1,0,1,2
330300,"2016",1,0,1,2
330300,"2017",0,1,0,1
330300,"2018",1,0,0,1
330300,"2019",1,0,0,1
330300,"2021",0,1,0,1
330300,"2022",2,0,1,3
330310,"2015",1,0,3,4
330310,"2016",1,0,2,3
330310,"2017",2,0,6,8
330310,"2018",2,0,2,4
330310,"2019",2,0,1,3
330310,"2020",0,1,8,9
330310,"2021",3,0,3,6
330310,"2022",0,0,5,5
330310,"2023",2,0,2,4
330320,"2015",27,10,65,102
330320,"2016",19,1,49,69
330320,"2017",22,4,46,72
330320,"2018",20,7,47,74
330320,"2019",34,3,35,72
330320,"2020",19,4,47,70
330320,"2021",22,7,48,77
330320,"2022",29,5,35,69
330320,"2023",15,3,30,48
330330,"2015",30,4,30,64
330330,"2016",21,4,33,58
330330,"2017",18,4,33,55
330330,"2018",12,2,30,44
330330,"2019",18,2,26,46
330330,"2020",21,8,41,70
330330,"2021",18,5,40,63
330330,"2022",19,6,35,60
330330,"2023",17,7,22,46
330340,"2015",34,13,54,101
330340,"2016",34,9,48,91
330340,"2017",36,12,65,113
330340,"2018",41,7,51,99
330340,"2019",23,9,44,76
330340,"2020",18,10,31,59
330340,"2021",30,6,29,65
330340,"2022",27,8,44,79
330340,"2023",24,3,35,62
330350,"2015",133,23,316,472
330350,"2016",127,25,338,490
330350,"2017",152,30,362,544
330350,"2018",142,31,328,501
330350,"2019",127,31,305,463
330350,"2020",134,24,315,473
330350,"2021",131,30,262,423
330350,"2022",116,36,262,414
330350,"2023",90,20,177,287
330360,"2015",3,1,0,4
330360,"2016",1,0,5,6
330360,"2017",5,1,5,11
330360,"2018",7,0,6,13
330360,"2019",4,2,12,18
330360,"2020",4,2,8,14
330360,"2021",4,1,14,19
330360,"2022",3,1,11,15
330360,"2023",3,1,14,18
330370,"2015",5,3,17,25
330370,"2016",10,3,16,29
330370,"2017",10,1,22,33
330370,"2018",7,3,11,21
330370,"2019",7,2,17,26
330370,"2020",2,5,14,21
330370,"2021",4,2,14,20
330370,"2022",5,1,8,14
330370,"2023",6,4,11,21
330380,"2015",17,6,26,49
330380,"2016",14,2,37,53
330380,"2017",22,5,23,50
330380,"2018",10,4,13,27
330380,"2019",12,2,22,36
330380,"2020",19,8,28,55
330380,"2021",13,5,18,36
330380,"2022",18,5,20,43
330380,"2023",10,3,15,28
330385,"2015",8,1,12,21
330385,"2016",2,2,15,19
330385,"2017",5,2,13,20
330385,"2018",6,0,9,15
330385,"2019",1,0,17,18
330385,"2020",5,6,7,18
330385,"2021",3,2,9,14
330385,"2022",5,2,6,13
330385,"2023",1,1,1,3
330390,"2015",67,21,119,207
330390,"2016",60,19,110,189
330390,"2017",88,26,127,241
330390,"2018",63,17,97,177
330390,"2019",34,9,68,111
330390,"2020",37,18,72,127
330390,"2021",45,14,57,116
330390,"2022",28,6,50,84
330390,"2023",16,4,39,59
330395,"2015",4,0,7,11
330395,"2016",1,1,3,5
330395,"2017",6,2,9,17
330395,"2018",2,1,3,6
330395,"2019",2,1,2,5
330395,"2020",9,0,8,17
330395,"2021",9,1,5,15
330395,"2022",6,0,2,8
330395,"2023",4,0,2,6
330400,"2015",3,1,6,10
330400,"2016",3,1,6,10
330400,"2017",5,2,5,12
330400,"2018",5,3,9,17
330400,"2019",2,1,14,17
330400,"2020",5,2,13,20
330400,"2021",5,1,5,11
330400,"2022",8,3,12,23
330400,"2023",1,0,3,4
330410,"2015",1,0,3,4
330410,"2016",0,0,2,2
330410,"2018",1,0,0,1
330410,"2019",1,0,0,1
330410,"2020",1,0,0,1
330411,"2015",0,0,5,5
330411,"2016",0,0,10,10
330411,"2017",3,0,6,9
330411,"2018",2,0,2,4
330411,"2019",0,0,3,3
330411,"2020",1,1,4,6
330411,"2021",0,0,3,3
330411,"2022",1,0,8,9
330411,"2023",2,2,3,7
330412,"2015",1,1,4,6
330412,"2016",4,2,5,11
330412,"2017",1,0,3,4
330412,"2018",3,0,1,4
330412,"2019",1,2,4,7
330412,"2020",3,0,1,4
330412,"2021",0,0,4,4
330412,"2022",1,1,0,2
330412,"2023",1,0,1,2
330414,"2015",28,5,61,94
330414,"2016",28,6,62,96
330414,"2017",26,4,60,90
330414,"2018",23,4,53,80
330414,"2019",22,6,54,82
330414,"2020",17,5,32,54
330414,"2021",9,6,16,31
330414,"2022",8,3,28,39
330414,"2023",13,3,33,49
330415,"2015",8,2,16,26
330415,"2016",10,0,10,20
330415,"2017",2,4,8,14
330415,"2018",10,2,8,20
330415,"2019",3,2,9,14
330415,"2020",6,1,4,11
330415,"2021",3,0,4,7
330415,"2022",8,0,7,15
330415,"2023",4,0,6,10
330420,"2015",20,7,32,59
330420,"2016",21,4,42,67
330420,"2017",16,2,30,48
330420,"2018",12,1,19,32
330420,"2019",20,5,39,64
330420,"2020",20,7,24,51
330420,"2021",7,7,25,39
330420,"2022",9,1,23,33
330420,"2023",7,1,16,24
330430,"2015",1,0,2,3
330430,"2016",1,0,10,11
330430,"2017",3,0,0,3
330430,"2019",4,0,6,10
330430,"2020",0,0,3,3
330430,"2021",1,1,6,8
330430,"2022",1,0,3,4
330430,"2023",0,0,4,4
330440,"2015",5,0,2,7
330440,"2016",5,1,1,7
330440,"2017",1,0,6,7
330440,"2018",2,0,1,3
330440,"2019",3,4,5,12
330440,"2020",2,1,4,7
330440,"2021",0,2,7,9
330440,"2022",0,0,2,2
330440,"2023",0,1,1,2
330450,"2015",0,1,1,2
330450,"2016",0,1,4,5
330450,"2017",2,0,3,5
330450,"2018",0,1,3,4
330450,"2019",2,0,0,2
330450,"2020",1,0,1,2
330450,"2021",0,0,4,4
330450,"2022",0,1,0,1
330452,"2015",29,10,94,133
330452,"2016",46,9,78,133
330452,"2017",44,9,71,124
330452,"2018",38,6,57,101
330452,"2019",37,8,66,111
330452,"2020",34,10,66,110
330452,"2021",35,8,59,102
330452,"2022",28,11,60,99
330452,"2023",18,6,50,74
330455,"2015",1614,321,3228,5163
330455,"2016",1223,258,2640,4121
330455,"2017",1241,300,2503,4044
330455,"2018",1068,282,2191,3541
330455,"2019",1079,288,2050,3417
330455,"2020",970,267,1902,3139
330455,"2021",892,232,1771,2895
330455,"2022",982,253,1849,3084
330455,"2023",741,204,1297,2242
330460,"2015",1,0,0,1
330460,"2016",1,0,0,1
330460,"2017",1,1,2,4
330460,"2018",0,0,4,4
330460,"2019",0,0,1,1
330460,"2020",2,0,1,3
330460,"2022",0,0,2,2
330460,"2023",0,0,3,3
330470,"2015",6,0,13,19
330470,"2016",9,3,20,32
330470,"2017",11,7,10,28
330470,"2018",8,1,13,22
330470,"2019",9,1,10,20
330470,"2020",4,0,3,7
330470,"2021",6,0,10,16
330470,"2022",5,0,10,15
330470,"2023",1,0,8,9
330475,"2015",14,0,16,30
330475,"2016",8,1,16,25
330475,"2017",16,2,12,30
330475,"2018",10,4,22,36
330475,"2019",7,1,13,21
330475,"2020",5,0,20,25
330475,"2021",11,5,15,31
330475,"2022",8,3,18,29
330475,"2023",1,2,7,10
330480,"2016",1,0,4,5
330480,"2017",3,0,1,4
330480,"2018",2,2,6,10
330480,"2019",5,1,7,13
330480,"2020",3,0,5,8
330480,"2021",1,0,3,4
330480,"2022",2,0,1,3
330480,"2023",1,0,1,2
330490,"2015",115,20,256,391
330490,"2016",174,36,420,630
330490,"2017",31,1,91,123
330490,"2018",13,1,39,53
330490,"2019",65,7,124,196
330490,"2020",105,30,226,361
330490,"2021",100,22,268,390
330490,"2022",140,30,276,446
330490,"2023",94,21,219,334
330500,"2015",10,5,17,32
330500,"2016",8,3,16,27
330500,"2017",4,4,7,15
330500,"2018",4,3,12,19
330500,"2019",8,2,9,19
330500,"2020",5,0,5,10
330500,"2021",6,2,10,18
330500,"2022",5,1,10,16
330500,"2023",4,1,6,11
330510,"2015",88,17,180,285
330510,"2016",65,9,158,232
330510,"2017",79,18,184,281
330510,"2018",82,15,161,258
330510,"2019",66,14,181,261
330510,"2020",56,12,139,207
330510,"2021",79,14,138,231
330510,"2022",78,13,185,276
330510,"2023",33,10,104,147
330513,"2017",0,0,1,1
330515,"2015",1,0,0,1
330515,"2016",1,0,1,2
330515,"2017",0,0,3,3
330515,"2018",3,0,6,9
330515,"2019",3,0,3,6
330515,"2020",1,1,0,2
330515,"2021",3,0,4,7
330515,"2022",6,3,1,10
330520,"2015",48,3,51,102
330520,"2016",29,4,39,72
330520,"2017",36,10,65,111
330520,"2018",28,4,54,86
330520,"2019",36,17,61,114
330520,"2020",32,11,49,92
330520,"2021",35,5,39,79
330520,"2022",43,11,55,109
330520,"2023",19,15,36,70
330530,"2015",1,1,4,6
330530,"2016",0,0,1,1
330530,"2017",0,0,5,5
330530,"2018",3,2,2,7
330530,"2019",2,0,3,5
330530,"2020",1,1,1,3
330530,"2021",0,0,3,3
330530,"2022",2,0,7,9
330530,"2023",2,0,2,4
330540,"2015",2,1,4,7
330540,"2016",3,0,3,6
330540,"2017",1,1,2,4
330540,"2018",4,2,2,8
330540,"2019",0,0,4,4
330540,"2020",2,0,3,5
330540,"2021",1,0,4,5
330540,"2022",2,1,6,9
330540,"2023",1,2,4,7
330550,"2015",6,0,11,17
330550,"2016",20,6,31,57
330550,"2017",8,3,16,27
330550,"2018",5,0,9,14
330550,"2019",11,3,15,29
330550,"2020",6,0,11,17
330550,"2021",7,3,26,36
330550,"2022",6,0,12,18
330550,"2023",4,1,13,18
330555,"2015",19,4,29,52
330555,"2016",2,1,8,11
330555,"2017",4,2,18,24
330555,"2018",10,1,17,28
330555,"2019",11,1,23,35
330555,"2020",10,1,27,38
330555,"2021",16,4,26,46
330555,"2022",8,6,28,42
330555,"2023",9,5,22,36
330560,"2015",2,0,2,4
330560,"2017",1,0,2,3
330560,"2019",1,1,1,3
330560,"2020",1,0,0,1
330560,"2021",2,0,2,4
330560,"2022",1,1,4,6
330560,"2023",0,0,2,2
330570,"2015",1,1,4,6
330570,"2016",3,0,2,5
330570,"2017",2,1,2,5
330570,"2018",3,0,2,5
330570,"2019",4,0,2,6
330570,"2020",1,0,3,4
330570,"2021",1,1,7,9
330570,"2022",1,0,2,3
330570,"2023",0,0,1,1
330575,"2015",1,0,8,9
330575,"2016",2,0,2,4
330575,"2017",1,1,4,6
330575,"2018",0,1,0,1
330575,"2019",3,1,5,9
330575,"2020",1,0,3,4
330575,"2021",4,0,10,14
330575,"2022",3,0,3,6
330575,"2023",3,0,1,4
330580,"2015",19,6,55,80
330580,"2016",21,4,42,67
330580,"2017",29,7,45,81
330580,"2018",33,4,55,92
330580,"2019",37,6,48,91
330580,"2020",21,5,33,59
330580,"2021",28,7,38,73
330580,"2022",27,2,44,73
330580,"2023",17,9,17,43
330590,"2015",0,0,2,2
330590,"2016",0,0,2,2
330590,"2017",0,0,3,3
330590,"2019",1,0,2,3
330590,"2020",3,0,7,10
330590,"2021",0,0,1,1
330590,"2022",2,1,0,3
330590,"2023",1,0,1,2
330600,"2015",11,4,36,51
330600,"2016",22,8,44,74
330600,"2017",31,5,53,89
330600,"2018",31,7,38,76
330600,"2019",16,4,32,52
330600,"2020",22,3,37,62
330600,"2021",15,4,22,41
330600,"2022",15,4,29,48
330600,"2023",11,9,27,47
330610,"2015",2,1,3,6
330610,"2016",7,4,5,16
330610,"2017",17,5,22,44
330610,"2018",14,5,29,48
330610,"2019",12,3,8,23
330610,"2020",4,0,8,12
330610,"2021",8,3,8,19
330610,"2022",3,1,9,13
330610,"2023",2,0,3,5
330615,"2016",0,0,1,1
330615,"2018",0,0,1,1
330615,"2019",2,0,1,3
330615,"2020",0,0,1,1
330615,"2022",0,1,1,2
330615,"2023",0,0,2,2
330620,"2015",7,0,29,36
330620,"2016",13,1,13,27
330620,"2017",9,2,18,29
330620,"2018",4,2,13,19
330620,"2019",5,1,9,15
330620,"2020",5,1,12,18
330620,"2021",3,1,8,12
330620,"2022",2,2,6,10
330620,"2023",3,2,2,7
330630,"2015",2,0,9,11
330630,"2016",0,0,9,9
330630,"2017",6,0,11,17
330630,"2018",7,3,13,23
330630,"2019",11,4,16,31
330630,"2020",28,16,52,96
330630,"2021",32,8,62,102
330630,"2022",34,11,50,95
330630,"2023",22,8,63,93
350010,"2015",0,0,6,6
350010,"2016",5,1,8,14
350010,"2017",3,0,7,10
350010,"2018",5,1,6,12
350010,"2019",4,0,5,9
350010,"2020",3,2,6,11
350010,"2021",1,0,5,6
350010,"2022",5,1,2,8
350010,"2023",4,1,3,8
350020,"2015",1,0,1,2
350020,"2021",1,0,1,2
350020,"2022",0,0,1,1
350030,"2015",5,1,15,21
350030,"2016",9,1,17,27
350030,"2017",5,2,9,16
350030,"2018",8,3,5,16
350030,"2019",4,0,12,16
350030,"2020",3,2,4,9
350030,"2021",9,1,7,17
350030,"2022",5,2,5,12
350030,"2023",3,1,8,12
350040,"2015",0,0,2,2
350040,"2016",2,0,1,3
350040,"2019",0,1,0,1
350040,"2021",1,1,2,4
350040,"2022",1,0,3,4
350040,"2023",1,0,0,1
350050,"2015",8,1,17,26
350050,"2016",7,1,10,18
350050,"2017",12,4,5,21
350050,"2018",6,1,7,14
350050,"2019",4,0,8,12
350050,"2020",4,1,5,10
350050,"2021",3,0,3,6
350050,"2022",6,1,4,11
350050,"2023",1,1,2,4
350055,"2015",1,0,5,6
350055,"2016",1,1,2,4
350055,"2017",2,0,1,3
350055,"2018",0,0,2,2
350055,"2019",0,0,2,2
350055,"2020",2,1,2,5
350055,"2021",0,0,1,1
350055,"2022",2,0,1,3
350055,"2023",1,1,0,2
350060,"2016",0,0,1,1
350060,"2017",1,0,1,2
350060,"2018",1,0,0,1
350060,"2019",1,0,1,2
350060,"2020",2,1,0,3
350060,"2021",1,0,0,1
350070,"2015",8,1,11,20
350070,"2016",3,1,12,16
350070,"2017",10,1,18,29
350070,"2018",5,1,19,25
350070,"2019",6,0,13,19
350070,"2020",11,6,15,32
350070,"2021",10,7,18,35
350070,"2022",16,4,9,29
350070,"2023",1,0,6,7
350075,"2015",1,0,1,2
350075,"2018",0,1,1,2
350075,"2020",1,0,2,3
350075,"2021",1,0,0,1
350075,"2022",0,1,1,2
350080,"2015",0,0,2,2
350080,"2016",0,0,1,1
350080,"2017",0,0,1,1
350080,"2020",2,0,1,3
350080,"2021",1,0,2,3
350080,"2022",0,1,1,2
350080,"2023",1,0,0,1
350090,"2015",0,0,3,3
350090,"2016",1,0,4,5
350090,"2017",2,0,1,3
350090,"2018",0,0,3,3
350090,"2019",1,0,0,1
350090,"2020",0,1,3,4
350090,"2021",1,1,0,2
350090,"2022",2,0,1,3
350100,"2015",3,0,9,12
350100,"2016",1,1,5,7
350100,"2017",4,0,4,8
350100,"2018",5,3,7,15
350100,"2019",11,6,8,25
350100,"2020",3,2,3,8
350100,"2021",6,2,11,19
350100,"2022",0,1,6,7
350100,"2023",1,0,4,5
350110,"2016",0,0,1,1
350110,"2022",0,0,1,1
350110,"2023",1,0,0,1
350115,"2015",4,0,2,6
350115,"2016",2,0,4,6
350115,"2017",2,0,5,7
350115,"2018",2,0,7,9
350115,"2019",1,1,2,4
350115,"2020",0,0,6,6
350115,"2021",4,1,1,6
350115,"2022",2,0,3,5
350115,"2023",1,0,3,4
350120,"2016",0,0,1,1
350120,"2018",0,0,1,1
350120,"2019",1,0,0,1
350120,"2022",0,0,1,1
350130,"2015",5,1,9,15
350130,"2016",4,1,4,9
350130,"2017",4,1,6,11
350130,"2018",7,0,13,20
350130,"2019",4,3,8,15
350130,"2020",5,3,10,18
350130,"2021",3,2,6,11
350130,"2022",4,0,3,7
350130,"2023",2,1,5,8
350140,"2015",1,1,3,5
350140,"2016",1,0,1,2
350140,"2017",2,0,1,3
350140,"2018",1,0,0,1
350140,"2019",1,0,0,1
350140,"2020",0,0,1,1
350140,"2022",0,1,2,3
350150,"2016",0,0,2,2
350150,"2020",2,0,0,2
350150,"2022",1,0,0,1
350150,"2023",0,0,1,1
350160,"2015",24,7,40,71
350160,"2016",35,11,34,80
350160,"2017",18,7,35,60
350160,"2018",25,5,33,63
350160,"2019",6,3,12,21
350160,"2020",24,4,29,57
350160,"2021",23,5,25,53
350160,"2022",22,10,23,55
350160,"2023",15,7,24,46
350170,"2015",11,4,16,31
350170,"2016",12,4,19,35
350170,"2017",5,1,15,21
350170,"2018",8,6,11,25
350170,"2019",6,2,15,23
350170,"2020",9,3,7,19
350170,"2021",3,2,8,13
350170,"2022",4,2,15,21
350170,"2023",6,0,10,16
350180,"2015",1,0,0,1
350180,"2016",0,0,1,1
350180,"2017",0,0,1,1
350180,"2019",1,0,1,2
350180,"2021",1,0,0,1
350180,"2023",0,0,1,1
350190,"2017",1,0,2,3
350190,"2018",1,0,0,1
350190,"2019",1,0,0,1
350190,"2020",0,0,1,1
350190,"2021",8,2,2,12
350190,"2022",0,0,2,2
350190,"2023",1,0,0,1
350200,"2015",0,0,3,3
350200,"2016",0,0,3,3
350200,"2017",1,1,2,4
350200,"2018",2,0,1,3
350200,"2019",1,0,2,3
350200,"2020",0,0,1,1
350210,"2015",10,3,19,32
350210,"2016",8,1,16,25
350210,"2017",11,3,15,29
350210,"2018",12,2,22,36
350210,"2019",8,5,17,30
350210,"2020",2,0,15,17
350210,"2021",3,1,5,9
350210,"2022",9,3,10,22
350210,"2023",5,1,10,16
350220,"2015",2,1,6,9
350220,"2016",1,1,10,12
350220,"2017",4,1,6,11
350220,"2018",5,1,18,24
350220,"2019",10,3,5,18
350220,"2020",5,1,9,15
350220,"2021",1,2,8,11
350220,"2022",5,0,7,12
350220,"2023",3,2,6,11
350230,"2016",2,0,4,6
350230,"2017",0,0,1,1
350230,"2018",2,0,3,5
350230,"2019",0,0,5,5
350230,"2020",3,0,2,5
350230,"2021",4,0,3,7
350230,"2022",0,0,1,1
350230,"2023",0,1,0,1
350240,"2015",1,0,4,5
350240,"2016",1,0,0,1
350240,"2017",2,1,1,4
350240,"2018",3,0,0,3
350240,"2019",1,1,4,6
350240,"2020",3,0,0,3
350240,"2021",0,0,2,2
350240,"2022",0,0,1,1
350240,"2023",1,0,0,1
350250,"2015",5,2,19,26
350250,"2016",15,0,9,24
350250,"2017",0,0,3,3
350250,"2018",0,2,3,5
350250,"2019",1,2,3,6
350250,"2020",2,0,4,6
350250,"2021",6,0,4,10
350250,"2022",3,0,4,7
350250,"2023",2,0,0,2
350260,"2015",4,0,2,6
350260,"2016",2,0,1,3
350260,"2018",1,0,0,1
350260,"2020",0,0,1,1
350260,"2021",1,0,1,2
350260,"2022",1,0,0,1
350260,"2023",0,0,1,1
350270,"2015",5,2,12,19
350270,"2016",1,1,8,10
350270,"2017",0,2,8,10
350270,"2018",9,2,10,21
350270,"2019",5,3,4,12
350270,"2020",2,2,10,14
350270,"2021",5,0,3,8
350270,"2022",1,0,2,3
350270,"2023",0,1,0,1
350275,"2015",8,1,8,17
350275,"2016",3,1,5,9
350275,"2017",7,3,8,18
350275,"2018",8,2,8,18
350275,"2019",5,1,13,19
350275,"2020",4,0,7,11
350275,"2021",7,1,10,18
350275,"2022",4,0,3,7
350275,"2023",5,0,6,11
350280,"2015",24,3,50,77
350280,"2016",37,5,46,88
350280,"2017",26,3,36,65
350280,"2018",1,0,4,5
350280,"2019",1,1,4,6
350280,"2020",0,0,3,3
350280,"2021",3,3,5,11
350280,"2022",4,1,5,10
350280,"2023",3,3,3,9
350290,"2015",1,0,8,9
350290,"2016",3,1,2,6
350290,"2017",1,1,6,8
350290,"2018",1,0,1,2
350290,"2019",3,1,6,10
350290,"2020",3,0,5,8
350290,"2021",4,1,1,6
350290,"2022",3,0,4,7
350290,"2023",1,0,1,2
350300,"2015",1,0,2,3
350300,"2016",0,2,1,3
350300,"2017",1,0,0,1
350300,"2018",1,0,1,2
350300,"2019",0,0,1,1
350300,"2020",0,0,1,1
350300,"2021",0,0,1,1
350300,"2022",0,0,1,1
350310,"2015",1,0,1,2
350310,"2016",0,0,2,2
350310,"2017",1,0,2,3
350310,"2018",1,0,0,1
350310,"2019",1,0,0,1
350310,"2020",1,0,0,1
350310,"2021",0,1,1,2
350310,"2022",0,0,1,1
350310,"2023",0,0,2,2
350315,"2015",0,0,1,1
350315,"2017",1,0,1,2
350315,"2022",1,0,0,1
350320,"2015",51,9,63,123
350320,"2016",42,14,72,128
350320,"2017",52,11,73,136
350320,"2018",40,14,74,128
350320,"2019",27,15,70,112
350320,"2020",42,17,62,121
350320,"2021",36,9,70,115
350320,"2022",39,9,58,106
350320,"2023",26,8,46,80
350330,"2015",13,1,25,39
350330,"2016",16,5,41,62
350330,"2017",23,1,33,57
350330,"2018",19,0,32,51
350330,"2019",23,5,28,56
350330,"2020",8,2,18,28
350330,"2021",12,0,12,24
350330,"2022",12,0,19,31
350330,"2023",9,6,15,30
350335,"2016",0,0,1,1
350335,"2020",1,0,2,3
350335,"2021",0,0,1,1
350340,"2015",1,0,2,3
350340,"2016",2,0,2,4
350340,"2017",1,0,1,2
350340,"2018",1,0,0,1
350340,"2019",1,1,1,3
350340,"2020",2,0,3,5
350340,"2021",0,0,1,1
350340,"2022",0,0,1,1
350340,"2023",0,0,2,2
350350,"2015",1,0,0,1
350350,"2016",2,0,1,3
350350,"2022",0,0,1,1
350360,"2015",2,0,3,5
350360,"2016",2,0,4,6
350360,"2017",2,0,2,4
350360,"2018",3,1,1,5
350360,"2019",1,1,2,4
350360,"2020",1,0,0,1
350360,"2022",0,1,0,1
350360,"2023",0,2,0,2
350370,"2015",0,0,1,1
350370,"2016",1,0,1,2
350370,"2017",0,0,3,3
350370,"2018",0,0,2,2
350370,"2019",1,0,0,1
350370,"2020",1,0,0,1
350370,"2021",0,0,1,1
350370,"2023",1,0,0,1
350380,"2015",3,0,6,9
350380,"2016",0,0,1,1
350380,"2017",0,0,2,2
350380,"2018",1,0,3,4
350380,"2019",1,0,4,5
350380,"2020",2,1,3,6
350380,"2021",0,0,1,1
350380,"2022",1,0,2,3
350380,"2023",1,0,1,2
350390,"2015",14,2,18,34
350390,"2016",21,5,29,55
350390,"2017",11,7,32,50
350390,"2018",21,5,36,62
350390,"2019",19,1,36,56
350390,"2020",16,3,26,45
350390,"2021",13,1,9,23
350390,"2022",13,4,12,29
350390,"2023",6,3,10,19
350395,"2015",0,0,1,1
350395,"2017",1,0,0,1
350395,"2021",0,0,2,2
350395,"2023",1,0,0,1
350400,"2015",21,4,40,65
350400,"2016",13,3,37,53
350400,"2017",26,5,26,57
350400,"2018",20,5,34,59
350400,"2019",20,8,34,62
350400,"2020",16,7,38,61
350400,"2021",16,4,29,49
350400,"2022",13,3,21,37
350400,"2023",8,3,14,25
350410,"2015",29,6,47,82
350410,"2016",22,10,34,66
350410,"2017",27,8,43,78
350410,"2018",32,7,67,106
350410,"2019",46,8,55,109
350410,"2020",29,8,41,78
350410,"2021",41,15,48,104
350410,"2022",34,8,45,87
350410,"2023",19,5,35,59
350420,"2019",0,0,1,1
350420,"2020",0,0,1,1
350420,"2021",1,0,1,2
350420,"2022",1,0,1,2
350420,"2023",0,0,2,2
350430,"2015",1,0,0,1
350430,"2016",0,0,2,2
350430,"2017",1,0,3,4
350430,"2018",3,0,0,3
350430,"2019",0,0,2,2
350430,"2020",0,0,4,4
350430,"2021",0,0,2,2
350430,"2022",1,1,0,2
350440,"2021",1,0,0,1
350450,"2015",9,3,22,34
350450,"2016",16,3,39,58
350450,"2017",20,3,29,52
350450,"2018",18,5,25,48
350450,"2019",16,4,17,37
350450,"2020",9,8,25,42
350450,"2021",21,6,44,71
350450,"2022",24,4,39,67
350450,"2023",9,3,14,26
350460,"2015",1,0,5,6
350460,"2016",1,0,4,5
350460,"2017",1,0,2,3
350460,"2018",3,0,1,4
350460,"2019",1,0,2,3
350460,"2020",1,0,4,5
350460,"2021",1,0,4,5
350460,"2022",3,0,1,4
350460,"2023",2,2,2,6
350470,"2015",0,0,1,1
350470,"2016",0,0,1,1
350470,"2020",0,0,1,1
350480,"2017",0,0,1,1
350480,"2019",1,0,0,1
350480,"2021",0,0,2,2
350480,"2022",0,0,3,3
350480,"2023",0,0,1,1
350490,"2015",0,0,2,2
350490,"2016",0,0,1,1
350490,"2017",4,0,1,5
350490,"2020",0,0,2,2
350490,"2023",1,0,0,1
350500,"2016",1,0,3,4
350500,"2017",2,1,0,3
350500,"2020",0,0,1,1
350500,"2021",0,0,1,1
350500,"2022",1,0,1,2
350500,"2023",0,0,1,1
350520,"2015",3,1,5,9
350520,"2016",3,1,1,5
350520,"2017",1,0,4,5
350520,"2018",2,1,4,7
350520,"2019",2,0,2,4
350520,"2020",4,1,4,9
350520,"2021",5,3,7,15
350520,"2022",1,1,3,5
350520,"2023",3,1,3,7
350530,"2015",7,4,4,15
350530,"2016",2,1,3,6
350530,"2017",4,3,8,15
350530,"2018",5,1,4,10
350530,"2019",1,0,3,4
350530,"2020",3,2,2,7
350530,"2021",2,0,4,6
350530,"2022",0,1,4,5
350530,"2023",3,3,4,10
350535,"2015",1,1,1,3
350535,"2016",0,1,2,3
350535,"2017",1,2,2,5
350535,"2018",2,0,0,2
350535,"2020",1,0,2,3
350535,"2021",0,0,1,1
350535,"2022",1,0,2,3
350540,"2015",2,1,4,7
350540,"2016",2,1,2,5
350540,"2017",3,0,7,10
350540,"2018",2,2,1,5
350540,"2019",2,0,2,4
350540,"2020",1,0,3,4
350540,"2021",1,0,3,4
350540,"2022",1,0,4,5
350540,"2023",1,1,1,3
350550,"2015",11,1,33,45
350550,"2016",6,2,12,20
350550,"2017",3,4,19,26
350550,"2018",10,3,12,25
350550,"2019",10,1,4,15
350550,"2020",12,1,8,21
350550,"2021",6,2,17,25
350550,"2022",2,1,5,8
350550,"2023",3,3,3,9
350560,"2015",4,1,7,12
350560,"2016",5,1,10,16
350560,"2017",5,1,3,9
350560,"2018",6,1,9,16
350560,"2019",3,0,7,10
350560,"2020",3,0,5,8
350560,"2021",3,0,7,10
350560,"2022",2,0,5,7
350560,"2023",2,0,6,8
350570,"2015",161,45,196,402
350570,"2016",139,44,200,383
350570,"2017",156,42,221,419
350570,"2018",125,42,160,327
350570,"2019",110,30,138,278
350570,"2020",88,25,133,246
350570,"2021",91,26,107,224
350570,"2022",71,26,90,187
350570,"2023",59,23,86,168
350580,"2015",7,1,3,11
350580,"2016",5,2,10,17
350580,"2017",1,0,6,7
350580,"2018",1,2,3,6
350580,"2019",1,2,5,8
350580,"2020",6,2,7,15
350580,"2021",4,1,9,14
350580,"2022",4,1,3,8
350580,"2023",2,0,2,4
350590,"2015",7,0,15,22
350590,"2016",14,3,19,36
350590,"2017",15,4,21,40
350590,"2018",12,4,25,41
350590,"2019",9,3,27,39
350590,"2020",7,6,19,32
350590,"2021",13,3,20,36
350590,"2022",9,3,16,28
350590,"2023",7,2,18,27
350600,"2015",30,9,55,94
350600,"2016",49,11,104,164
350600,"2017",49,9,77,135
350600,"2018",39,15,87,141
350600,"2019",51,14,83,148
350600,"2020",44,21,99,164
350600,"2021",60,10,100,170
350600,"2022",55,15,84,154
350600,"2023",47,12,70,129
350610,"2015",12,3,20,35
350610,"2016",15,3,30,48
350610,"2017",13,4,25,42
350610,"2018",13,6,23,42
350610,"2019",15,1,30,46
350610,"2020",9,7,14,30
350610,"2021",11,2,18,31
350610,"2022",11,1,9,21
350610,"2023",7,4,4,15
350620,"2015",0,0,2,2
350620,"2016",2,1,1,4
350620,"2017",1,0,3,4
350620,"2018",1,1,1,3
350620,"2020",0,0,2,2
350620,"2021",0,0,1,1
350620,"2022",0,1,0,1
350630,"2015",0,0,3,3
350630,"2016",3,0,8,11
350630,"2017",1,1,7,9
350630,"2018",4,0,6,10
350630,"2019",3,0,2,5
350630,"2020",1,1,0,2
350630,"2021",3,0,1,4
350630,"2022",3,0,1,4
350630,"2023",2,0,2,4
350635,"2015",15,7,36,58
350635,"2016",11,8,25,44
350635,"2017",15,2,16,33
350635,"2018",17,4,32,53
350635,"2019",12,4,17,33
350635,"2020",7,4,15,26
350635,"2021",7,3,7,17
350635,"2022",16,2,13,31
350635,"2023",4,1,10,15
350640,"2015",1,0,1,2
350640,"2016",0,0,2,2
350640,"2019",0,0,2,2
350640,"2020",2,0,0,2
350640,"2021",1,0,1,2
350640,"2022",0,0,1,1
350650,"2015",14,3,25,42
350650,"2016",11,3,19,33
350650,"2017",7,2,15,24
350650,"2018",7,1,3,11
350650,"2019",10,4,11,25
350650,"2020",10,1,9,20
350650,"2021",5,4,16,25
350650,"2022",9,2,18,29
350650,"2023",9,4,9,22
350660,"2015",2,2,14,18
350660,"2016",7,2,13,22
350660,"2017",2,1,6,9
350660,"2018",0,1,6,7
350660,"2019",3,1,4,8
350660,"2020",2,0,4,6
350660,"2021",6,0,6,12
350660,"2022",5,1,4,10
350660,"2023",0,0,2,2
350670,"2015",1,0,2,3
350670,"2016",1,0,3,4
350670,"2017",4,0,3,7
350670,"2018",2,1,9,12
350670,"2019",1,1,11,13
350670,"2020",1,1,3,5
350670,"2021",1,0,3,4
350670,"2022",4,2,7,13
350670,"2023",2,0,1,3
350680,"2015",1,0,0,1
350680,"2018",1,0,1,2
350680,"2019",0,1,3,4
350680,"2020",1,1,1,3
350680,"2022",1,1,0,2
350690,"2015",1,0,7,8
350690,"2016",2,2,3,7
350690,"2017",3,1,1,5
350690,"2018",4,0,1,5
350690,"2019",1,1,6,8
350690,"2020",1,0,4,5
350690,"2021",1,1,3,5
350690,"2022",2,0,8,10
350690,"2023",1,0,0,1
350700,"2015",13,4,22,39
350700,"2016",15,2,17,34
350700,"2017",10,7,20,37
350700,"2018",19,10,27,56
350700,"2019",18,4,29,51
350700,"2020",21,4,23,48
350700,"2021",10,7,21,38
350700,"2022",20,2,16,38
350700,"2023",6,1,8,15
350710,"2015",0,0,1,1
350710,"2016",2,4,2,8
350710,"2017",0,0,4,4
350710,"2018",2,0,4,6
350710,"2019",4,1,2,7
350710,"2020",3,0,1,4
350710,"2021",3,5,4,12
350710,"2022",3,1,4,8
350710,"2023",0,0,4,4
350715,"2015",0,0,1,1
350715,"2016",1,1,1,3
350715,"2018",1,0,0,1
350715,"2020",1,0,0,1
350715,"2021",0,0,1,1
350720,"2020",1,0,0,1
350720,"2021",0,0,2,2
350730,"2015",4,0,1,5
350730,"2016",1,0,0,1
350730,"2017",1,0,0,1
350730,"2019",0,0,1,1
350730,"2020",2,0,3,5
350730,"2021",0,0,1,1
350730,"2022",0,0,1,1
350730,"2023",0,1,0,1
350740,"2016",0,1,0,1
350740,"2017",1,0,0,1
350740,"2018",1,0,1,2
350740,"2019",1,0,1,2
350740,"2020",2,0,0,2
350740,"2021",0,0,1,1
350740,"2022",0,0,1,1
350740,"2023",1,1,1,3
350745,"2015",1,0,1,2
350745,"2017",1,0,1,2
350745,"2018",0,1,0,1
350745,"2019",3,0,0,3
350745,"2020",1,0,0,1
350745,"2021",0,0,1,1
350745,"2023",0,0,2,2
350750,"2015",34,4,52,90
350750,"2016",35,8,55,98
350750,"2017",31,6,34,71
350750,"2018",32,5,34,71
350750,"2019",24,15,38,77
350750,"2020",30,10,36,76
350750,"2021",47,4,54,105
350750,"2022",43,6,56,105
350750,"2023",17,9,35,61
350760,"2015",32,4,40,76
350760,"2016",39,6,46,91
350760,"2017",34,9,50,93
350760,"2018",35,11,57,103
350760,"2019",41,10,48,99
350760,"2020",46,10,59,115
350760,"2021",40,21,47,108
350760,"2022",38,16,54,108
350760,"2023",36,18,52,106
350770,"2016",2,0,0,2
350775,"2017",1,0,0,1
350780,"2015",3,0,10,13
350780,"2016",3,0,9,12
350780,"2017",3,0,14,17
350780,"2018",2,4,5,11
350780,"2019",3,1,2,6
350780,"2020",4,0,4,8
350780,"2021",3,2,7,12
350780,"2022",5,1,3,9
350780,"2023",0,0,3,3
350790,"2015",5,3,11,19
350790,"2016",1,0,2,3
350790,"2017",5,0,8,13
350790,"2018",7,3,8,18
350790,"2019",7,3,9,19
350790,"2020",4,3,11,18
350790,"2021",4,2,6,12
350790,"2022",1,0,5,6
350790,"2023",2,1,3,6
350800,"2015",1,1,6,8
350800,"2016",1,0,5,6
350800,"2017",5,1,2,8
350800,"2018",5,2,1,8
350800,"2019",2,0,0,2
350800,"2020",1,0,1,2
350800,"2021",0,0,3,3
350800,"2022",1,1,3,5
350800,"2023",0,0,2,2
350810,"2015",0,0,3,3
350810,"2016",2,0,1,3
350810,"2018",0,0,4,4
350810,"2019",3,1,2,6
350810,"2020",2,0,2,4
350810,"2021",0,0,1,1
350810,"2022",0,0,1,1
350810,"2023",0,0,1,1
350820,"2015",0,0,2,2
350820,"2018",0,0,1,1
350820,"2020",1,0,1,2
350820,"2021",0,1,0,1
350820,"2022",0,0,2,2
350830,"2017",0,0,2,2
350830,"2018",0,1,3,4
350830,"2019",1,1,2,4
350830,"2020",0,0,1,1
350830,"2021",0,1,2,3
350830,"2022",1,0,0,1
350830,"2023",2,0,3,5
350840,"2015",2,0,8,10
350840,"2016",2,4,12,18
350840,"2017",9,3,23,35
350840,"2018",5,1,12,18
350840,"2019",5,1,9,15
350840,"2020",7,3,9,19
350840,"2021",10,3,21,34
350840,"2022",6,0,11,17
350840,"2023",6,4,9,19
350850,"2015",9,0,15,24
350850,"2016",13,3,28,44
350850,"2017",15,4,21,40
350850,"2018",16,2,26,44
350850,"2019",7,7,15,29
350850,"2020",11,2,24,37
350850,"2021",12,5,20,37
350850,"2022",17,4,10,31
350850,"2023",7,4,19,30
350860,"2015",1,0,1,2
350860,"2016",0,0,1,1
350860,"2017",1,0,1,2
350860,"2018",2,0,3,5
350860,"2019",4,1,3,8
350860,"2020",2,1,6,9
350860,"2021",4,0,2,6
350860,"2022",2,1,2,5
350860,"2023",2,0,2,4
350870,"2015",3,1,4,8
350870,"2016",4,1,6,11
350870,"2017",2,1,6,9
350870,"2018",3,1,2,6
350870,"2019",5,4,7,16
350870,"2020",2,1,3,6
350870,"2021",1,0,6,7
350870,"2022",2,0,2,4
350870,"2023",3,1,6,10
350880,"2015",4,0,2,6
350880,"2016",4,0,3,7
350880,"2017",7,0,3,10
350880,"2018",1,0,3,4
350880,"2019",3,0,6,9
350880,"2020",1,0,3,4
350880,"2021",2,2,3,7
350880,"2022",4,0,2,6
350880,"2023",1,0,3,4
350890,"2016",0,0,1,1
350890,"2017",0,0,1,1
350890,"2019",0,0,2,2
350890,"2020",0,0,2,2
350890,"2021",1,0,0,1
350890,"2023",0,1,0,1
350900,"2015",18,9,49,76
350900,"2016",30,8,54,92
350900,"2017",23,7,42,72
350900,"2018",25,11,57,93
350900,"2019",38,5,39,82
350900,"2020",21,6,35,62
350900,"2021",21,6,36,63
350900,"2022",14,13,30,57
350900,"2023",13,7,22,42
350910,"2015",0,2,1,3
350910,"2016",2,1,0,3
350910,"2017",1,0,0,1
350910,"2018",1,0,1,2
350910,"2019",1,0,0,1
350910,"2021",0,0,1,1
350910,"2022",0,0,1,1
350910,"2023",3,0,0,3
350920,"2015",4,0,3,7
350920,"2016",2,1,2,5
350920,"2017",4,0,6,10
350920,"2018",3,1,4,8
350920,"2019",6,5,11,22
350920,"2020",13,6,27,46
350920,"2021",8,4,15,27
350920,"2022",16,6,25,47
350920,"2023",7,7,25,39
350925,"2015",12,3,13,28
350925,"2016",5,2,17,24
350925,"2017",10,2,19,31
350925,"2018",8,1,11,20
350925,"2019",19,4,16,39
350925,"2020",10,2,14,26
350925,"2021",9,3,10,22
350925,"2022",2,2,11,15
350925,"2023",1,4,11,16
350930,"2015",2,0,1,3
350930,"2016",0,0,6,6
350930,"2017",1,3,1,5
350930,"2018",1,0,3,4
350930,"2019",1,1,1,3
350930,"2020",1,0,1,2
350930,"2021",3,0,1,4
350930,"2022",1,0,2,3
350930,"2023",0,0,1,1
350940,"2015",4,2,19,25
350940,"2016",6,2,19,27
350940,"2017",7,1,21,29
350940,"2018",10,2,14,26
350940,"2019",15,1,19,35
350940,"2020",5,3,12,20
350940,"2021",10,1,20,31
350940,"2022",12,2,12,26
350940,"2023",10,1,15,26
350945,"2015",2,0,2,4
350945,"2016",0,0,4,4
350945,"2017",0,0,1,1
350945,"2018",2,2,2,6
350945,"2019",0,0,5,5
350945,"2020",1,0,0,1
350945,"2021",1,0,3,4
350945,"2022",1,0,2,3
350945,"2023",2,0,0,2
350950,"2015",139,26,264,429
350950,"2016",164,37,278,479
350950,"2017",175,57,285,517
350950,"2018",152,29,227,408
350950,"2019",145,40,240,425
350950,"2020",129,36,215,380
350950,"2021",116,48,172,336
350950,"2022",140,32,208,380
350950,"2023",90,31,154,275
350960,"2015",3,1,12,16
350960,"2016",9,2,17,28
350960,"2017",5,1,3,9
350960,"2018",7,1,7,15
350960,"2019",7,4,9,20
350960,"2020",8,3,4,15
350960,"2021",8,4,7,19
350960,"2022",2,2,3,7
350960,"2023",9,3,13,25
350970,"2015",11,6,19,36
350970,"2017",2,1,1,4
350970,"2018",1,0,4,5
350970,"2019",7,0,5,12
350970,"2020",4,2,7,13
350970,"2021",12,4,21,37
350970,"2022",3,2,6,11
350970,"2023",3,0,2,5
350980,"2015",1,0,2,3
350980,"2016",1,0,1,2
350980,"2017",1,0,1,2
350980,"2020",0,1,0,1
350980,"2021",0,0,1,1
350980,"2023",1,0,1,2
350990,"2015",1,1,3,5
350990,"2016",5,3,8,16
350990,"2017",4,1,8,13
350990,"2018",9,1,7,17
350990,"2019",2,3,6,11
350990,"2020",5,3,5,13
350990,"2021",1,0,2,3
350990,"2022",3,0,2,5
350990,"2023",4,2,5,11
350995,"2018",1,0,0,1
350995,"2019",1,0,0,1
350995,"2020",1,0,0,1
350995,"2021",0,1,0,1
350995,"2023",1,0,0,1
351000,"2015",2,1,6,9
351000,"2016",1,0,2,3
351000,"2017",2,0,0,2
351000,"2018",1,0,3,4
351000,"2020",2,1,6,9
351000,"2021",2,0,2,4
351000,"2022",4,0,3,7
351000,"2023",1,0,6,7
351010,"2017",0,0,1,1
351010,"2018",0,0,2,2
351010,"2019",1,0,1,2
351010,"2020",1,0,1,2
351010,"2021",1,0,1,2
351010,"2022",1,0,0,1
351015,"2015",0,1,1,2
351015,"2016",1,0,1,2
351015,"2017",0,0,2,2
351015,"2018",1,0,1,2
351015,"2019",1,0,0,1
351015,"2020",1,1,2,4
351015,"2021",1,0,2,3
351015,"2022",0,0,3,3
351015,"2023",2,0,1,3
351020,"2015",9,4,17,30
351020,"2016",15,4,20,39
351020,"2017",18,1,25,44
351020,"2018",13,7,15,35
351020,"2019",7,1,6,14
351020,"2020",9,1,13,23
351020,"2021",4,2,3,9
351020,"2022",9,3,8,20
351020,"2023",7,2,8,17
351030,"2015",0,1,6,7
351030,"2016",0,1,1,2
351030,"2017",1,1,1,3
351030,"2018",1,0,1,2
351030,"2019",2,0,0,2
351030,"2020",3,2,4,9
351030,"2021",3,1,8,12
351030,"2022",0,1,2,3
351030,"2023",3,2,2,7
351040,"2015",2,2,16,20
351040,"2016",5,1,11,17
351040,"2017",5,3,13,21
351040,"2018",6,1,9,16
351040,"2019",9,0,13,22
351040,"2020",8,1,11,20
351040,"2021",4,1,9,14
351040,"2022",3,2,2,7
351040,"2023",2,0,4,6
351050,"2015",52,15,79,146
351050,"2016",47,10,76,133
351050,"2017",44,6,68,118
351050,"2018",50,14,69,133
351050,"2019",38,7,68,113
351050,"2020",27,17,47,91
351050,"2021",35,16,50,101
351050,"2022",29,4,40,73
351050,"2023",13,3,24,40
351060,"2015",89,18,131,238
351060,"2016",62,7,128,197
351060,"2017",41,17,78,136
351060,"2018",54,20,81,155
351060,"2019",68,14,110,192
351060,"2020",56,22,83,161
351060,"2021",74,23,103,200
351060,"2022",63,18,125,206
351060,"2023",68,13,90,171
351070,"2015",0,0,2,2
351070,"2016",0,0,1,1
351070,"2017",2,0,0,2
351070,"2018",0,0,3,3
351070,"2019",1,0,2,3
351070,"2020",1,0,1,2
351070,"2021",1,0,0,1
351070,"2022",1,1,0,2
351070,"2023",0,0,1,1
351080,"2015",6,1,11,18
351080,"2016",6,1,11,18
351080,"2017",10,0,7,17
351080,"2018",0,1,9,10
351080,"2019",8,2,9,19
351080,"2020",4,3,5,12
351080,"2021",3,2,5,10
351080,"2022",1,3,8,12
351080,"2023",4,2,1,7
351090,"2016",0,0,1,1
351090,"2017",0,0,1,1
351090,"2018",1,0,0,1
351090,"2023",0,0,1,1
351100,"2015",1,1,4,6
351100,"2016",4,0,12,16
351100,"2017",4,2,6,12
351100,"2018",4,2,6,12
351100,"2019",3,1,3,7
351100,"2020",5,1,7,13
351100,"2021",2,1,2,5
351100,"2022",3,1,5,9
351100,"2023",1,1,7,9
351110,"2015",18,4,21,43
351110,"2016",20,2,17,39
351110,"2017",17,4,15,36
351110,"2018",11,2,22,35
351110,"2019",16,2,20,38
351110,"2020",6,2,16,24
351110,"2021",11,4,13,28
351110,"2022",8,1,10,19
351110,"2023",10,1,11,22
351120,"2015",0,0,2,2
351120,"2016",4,0,1,5
351120,"2017",0,3,1,4
351120,"2018",1,0,0,1
351120,"2021",1,0,0,1
351120,"2023",1,0,1,2
351130,"2015",0,0,2,2
351130,"2016",1,0,1,2
351130,"2017",0,0,1,1
351130,"2018",0,0,2,2
351130,"2019",0,1,1,2
351130,"2021",0,0,1,1
351130,"2023",1,0,2,3
351140,"2015",1,0,7,8
351140,"2016",7,3,11,21
351140,"2017",7,0,9,16
351140,"2018",8,0,9,17
351140,"2019",4,0,6,10
351140,"2020",5,1,10,16
351140,"2021",2,0,2,4
351140,"2022",0,1,5,6
351140,"2023",2,1,2,5
351150,"2015",2,0,10,12
351150,"2016",7,2,6,15
351150,"2017",2,0,0,2
351150,"2018",0,0,1,1
351150,"2019",0,0,4,4
351150,"2020",0,0,2,2
351150,"2021",2,1,7,10
351150,"2022",3,2,4,9
351150,"2023",0,1,6,7
351160,"2015",1,0,5,6
351160,"2016",1,1,2,4
351160,"2019",0,0,3,3
351160,"2020",3,1,1,5
351160,"2021",2,0,5,7
351160,"2022",4,0,0,4
351160,"2023",1,0,1,2
351170,"2015",1,0,2,3
351170,"2016",0,1,1,2
351170,"2017",1,0,4,5
351170,"2018",1,0,3,4
351170,"2019",2,2,4,8
351170,"2020",1,1,5,7
351170,"2021",2,0,2,4
351170,"2022",0,0,1,1
351170,"2023",2,0,3,5
351190,"2015",1,0,3,4
351190,"2016",0,0,3,3
351190,"2017",1,0,0,1
351190,"2018",2,0,0,2
351190,"2019",1,0,1,2
351190,"2020",0,1,1,2
351190,"2021",0,0,1,1
351200,"2015",2,0,2,4
351200,"2016",1,0,1,2
351200,"2017",0,0,1,1
351200,"2018",4,0,1,5
351200,"2019",1,0,4,5
351200,"2020",1,0,2,3
351200,"2021",3,0,1,4
351200,"2022",0,0,1,1
351200,"2023",0,0,2,2
351210,"2015",0,0,2,2
351210,"2016",0,0,1,1
351210,"2017",1,1,2,4
351210,"2022",1,0,0,1
351220,"2015",5,2,19,26
351220,"2016",12,2,17,31
351220,"2017",11,0,12,23
351220,"2018",9,1,16,26
351220,"2019",5,3,14,22
351220,"2020",1,1,4,6
351220,"2021",0,1,6,7
351220,"2022",8,0,8,16
351220,"2023",7,1,10,18
351230,"2015",2,0,7,9
351230,"2016",5,1,8,14
351230,"2017",0,0,3,3
351230,"2018",3,0,2,5
351230,"2019",0,0,2,2
351230,"2020",0,0,4,4
351230,"2021",1,2,2,5
351230,"2022",2,0,1,3
351230,"2023",2,0,3,5
351240,"2015",2,0,11,13
351240,"2016",0,2,5,7
351240,"2017",2,1,5,8
351240,"2018",7,3,10,20
351240,"2019",8,2,9,19
351240,"2020",7,1,9,17
351240,"2021",8,3,8,19
351240,"2022",4,3,7,14
351240,"2023",4,2,7,13
351250,"2021",0,0,1,1
351250,"2022",1,0,0,1
351260,"2015",0,1,2,3
351270,"2015",1,0,1,2
351270,"2016",2,1,2,5
351270,"2017",0,0,2,2
351270,"2018",1,0,1,2
351270,"2019",1,0,0,1
351270,"2020",1,1,1,3
351270,"2021",0,0,1,1
351270,"2023",0,0,1,1
351280,"2015",18,3,23,44
351280,"2016",11,3,21,35
351280,"2017",2,0,1,3
351280,"2018",4,1,5,10
351280,"2019",12,2,7,21
351280,"2020",3,3,12,18
351280,"2021",12,3,10,25
351280,"2022",9,2,10,21
351280,"2023",7,5,14,26
351290,"2016",0,1,1,2
351290,"2017",1,0,2,3
351290,"2019",0,1,1,2
351290,"2020",0,0,2,2
351290,"2021",0,0,1,1
351290,"2022",1,0,0,1
351290,"2023",1,0,1,2
351300,"2015",94,36,133,263
351300,"2016",76,23,146,245
351300,"2017",92,31,147,270
351300,"2018",74,21,127,222
351300,"2019",74,32,124,230
351300,"2020",92,18,117,227
351300,"2021",71,27,101,199
351300,"2022",59,28,103,190
351300,"2023",49,13,64,126
351310,"2015",3,0,9,12
351310,"2016",5,2,7,14
351310,"2017",7,2,7,16
351310,"2018",4,3,3,10
351310,"2019",6,2,8,16
351310,"2020",4,1,13,18
351310,"2021",3,0,5,8
351310,"2022",3,2,5,10
351310,"2023",3,0,2,5
351320,"2015",1,0,1,2
351320,"2016",0,1,0,1
351320,"2017",1,1,3,5
351320,"2018",3,0,6,9
351320,"2019",2,1,2,5
351320,"2020",2,0,5,7
351320,"2021",1,0,2,3
351320,"2022",1,1,6,8
351320,"2023",1,0,2,3
351330,"2016",0,0,3,3
351330,"2018",0,1,1,2
351330,"2022",1,0,1,2
351330,"2023",1,0,0,1
351340,"2015",5,2,12,19
351340,"2016",8,5,13,26
351340,"2017",8,6,9,23
351340,"2018",2,0,7,9
351340,"2019",4,0,4,8
351340,"2020",2,0,1,3
351340,"2021",3,0,2,5
351340,"2022",1,1,6,8
351340,"2023",0,1,4,5
351350,"2015",34,8,67,109
351350,"2016",24,3,46,73
351350,"2017",19,2,26,47
351350,"2018",23,6,41,70
351350,"2019",28,6,45,79
351350,"2020",20,8,44,72
351350,"2021",16,4,29,49
351350,"2022",12,9,25,46
351350,"2023",3,2,9,14
351360,"2015",4,2,5,11
351360,"2016",7,0,11,18
351360,"2017",5,1,18,24
351360,"2018",11,4,16,31
351360,"2019",7,1,10,18
351360,"2020",7,1,7,15
351360,"2021",5,1,9,15
351360,"2022",1,0,4,5
351360,"2023",1,0,2,3
351370,"2015",3,0,10,13
351370,"2016",2,1,5,8
351370,"2017",9,3,14,26
351370,"2018",5,0,9,14
351370,"2019",5,1,7,13
351370,"2020",5,0,6,11
351370,"2021",3,2,7,12
351370,"2022",3,1,16,20
351370,"2023",7,1,1,9
351380,"2015",99,28,204,331
351380,"2016",119,30,198,347
351380,"2017",105,31,187,323
351380,"2018",105,35,205,345
351380,"2019",132,30,168,330
351380,"2020",81,28,139,248
351380,"2021",81,31,129,241
351380,"2022",100,31,129,260
351380,"2023",60,22,95,177
351385,"2015",2,0,1,3
351385,"2018",1,0,1,2
351385,"2019",2,0,0,2
351385,"2020",0,0,1,1
351390,"2015",3,1,4,8
351390,"2016",3,1,11,15
351390,"2017",5,0,1,6
351390,"2018",2,0,8,10
351390,"2019",4,1,3,8
351390,"2020",2,1,5,8
351390,"2021",0,0,5,5
351390,"2022",0,1,6,7
351390,"2023",2,1,2,5
351400,"2015",1,0,3,4
351400,"2016",1,0,4,5
351400,"2017",2,0,1,3
351400,"2018",1,0,2,3
351400,"2019",0,0,2,2
351400,"2022",1,0,2,3
351400,"2023",0,0,1,1
351410,"2015",5,0,8,13
351410,"2016",1,1,6,8
351410,"2017",7,0,10,17
351410,"2018",5,0,9,14
351410,"2019",9,3,16,28
351410,"2020",4,2,14,20
351410,"2021",8,1,19,28
351410,"2022",4,2,9,15
351410,"2023",7,0,4,11
351420,"2016",0,0,1,1
351420,"2020",0,0,2,2
351420,"2023",0,0,2,2
351430,"2015",0,0,1,1
351430,"2019",0,0,1,1
351430,"2020",1,0,1,2
351430,"2021",0,0,2,2
351430,"2022",0,0,1,1
351430,"2023",1,0,0,1
351440,"2015",9,1,12,22
351440,"2016",5,4,9,18
351440,"2017",11,0,9,20
351440,"2018",6,4,11,21
351440,"2019",6,1,5,12
351440,"2020",3,3,2,8
351440,"2021",5,0,1,6
351440,"2022",5,0,5,10
351440,"2023",1,2,5,8
351450,"2015",1,0,1,2
351450,"2016",0,0,2,2
351450,"2017",0,0,2,2
351450,"2018",1,0,1,2
351450,"2019",2,1,3,6
351450,"2020",1,1,5,7
351450,"2021",2,0,2,4
351450,"2022",6,0,2,8
351450,"2023",2,1,4,7
351460,"2015",0,0,3,3
351460,"2016",2,0,1,3
351460,"2017",1,0,3,4
351460,"2018",0,1,0,1
351460,"2019",1,0,2,3
351460,"2020",3,1,1,5
351460,"2021",3,0,2,5
351460,"2022",0,0,2,2
351460,"2023",0,0,2,2
351470,"2015",2,0,5,7
351470,"2016",2,0,1,3
351470,"2017",2,1,3,6
351470,"2018",0,0,2,2
351470,"2019",0,0,1,1
351470,"2023",1,0,0,1
351480,"2015",5,0,3,8
351480,"2016",11,1,8,20
351480,"2017",3,0,6,9
351480,"2018",2,2,10,14
351480,"2019",6,0,3,9
351480,"2020",2,1,4,7
351480,"2021",3,1,3,7
351480,"2022",3,2,9,14
351480,"2023",3,0,5,8
351490,"2015",3,1,2,6
351490,"2016",1,0,6,7
351490,"2017",4,1,9,14
351490,"2018",0,0,3,3
351490,"2019",5,2,2,9
351490,"2020",3,2,6,11
351490,"2021",1,0,3,4
351490,"2022",2,0,2,4
351490,"2023",1,2,0,3
351492,"2016",1,0,0,1
351492,"2020",0,1,1,2
351492,"2021",1,0,0,1
351492,"2022",0,0,1,1
351495,"2016",0,1,1,2
351495,"2019",1,0,0,1
351495,"2020",1,0,0,1
351495,"2022",0,1,0,1
351495,"2023",0,0,1,1
351500,"2015",66,17,138,221
351500,"2016",81,17,107,205
351500,"2017",79,27,122,228
351500,"2018",80,27,129,236
351500,"2019",67,29,101,197
351500,"2020",77,15,108,200
351500,"2021",69,23,96,188
351500,"2022",72,15,83,170
351500,"2023",40,17,79,136
351510,"2015",14,2,27,43
351510,"2016",15,3,21,39
351510,"2017",5,4,14,23
351510,"2018",9,5,19,33
351510,"2019",12,4,12,28
351510,"2020",10,3,11,24
351510,"2021",15,3,19,37
351510,"2022",11,2,14,27
351510,"2023",10,3,12,25
351512,"2015",0,0,1,1
351512,"2016",1,0,0,1
351512,"2018",0,1,1,2
351512,"2020",0,0,1,1
351512,"2022",2,1,1,4
351512,"2023",2,0,0,2
351515,"2015",4,0,15,19
351515,"2016",1,0,6,7
351515,"2017",7,0,12,19
351515,"2018",5,1,8,14
351515,"2019",12,1,8,21
351515,"2020",3,2,5,10
351515,"2021",5,0,5,10
351515,"2022",0,1,5,6
351515,"2023",3,1,7,11
351518,"2015",11,1,11,23
351518,"2016",2,1,16,19
351518,"2017",9,1,12,22
351518,"2018",12,2,12,26
351518,"2019",3,6,12,21
351518,"2020",3,4,6,13
351518,"2021",5,2,10,17
351518,"2022",10,1,5,16
351518,"2023",7,0,7,14
351519,"2015",2,0,1,3
351519,"2016",1,1,0,2
351519,"2017",1,0,0,1
351519,"2018",0,0,3,3
351519,"2020",1,0,0,1
351519,"2021",1,0,4,5
351519,"2022",1,0,1,2
351519,"2023",3,0,1,4
351520,"2015",0,1,3,4
351520,"2016",1,0,1,2
351520,"2017",4,0,3,7
351520,"2018",2,1,3,6
351520,"2019",3,0,3,6
351520,"2020",1,1,3,5
351520,"2021",1,1,1,3
351520,"2022",1,0,1,2
351520,"2023",1,0,3,4
351530,"2015",1,0,2,3
351530,"2016",0,0,2,2
351530,"2019",1,0,0,1
351530,"2022",0,0,1,1
351535,"2015",2,1,2,5
351535,"2016",1,0,4,5
351535,"2017",1,0,3,4
351535,"2018",2,0,1,3
351535,"2019",2,1,4,7
351535,"2020",1,1,3,5
351535,"2021",1,1,4,6
351535,"2022",1,0,1,2
351535,"2023",0,0,1,1
351540,"2015",2,0,4,6
351540,"2016",0,0,5,5
351540,"2017",2,0,1,3
351540,"2018",2,0,1,3
351540,"2019",2,0,1,3
351540,"2020",2,0,2,4
351540,"2021",1,1,0,2
351540,"2022",0,2,0,2
351540,"2023",1,0,2,3
351550,"2015",17,3,17,37
351550,"2016",18,2,19,39
351550,"2017",12,1,25,38
351550,"2018",14,3,12,29
351550,"2019",10,0,14,24
351550,"2020",11,1,12,24
351550,"2021",1,0,3,4
351550,"2022",5,5,7,17
351550,"2023",9,2,13,24
351560,"2015",2,0,2,4
351560,"2016",0,0,1,1
351560,"2018",2,0,0,2
351560,"2019",2,0,0,2
351560,"2020",2,1,1,4
351565,"2016",0,0,1,1
351565,"2018",0,0,1,1
351565,"2019",0,0,1,1
351565,"2022",0,1,0,1
351570,"2015",27,6,51,84
351570,"2016",37,11,54,102
351570,"2017",43,15,64,122
351570,"2018",51,10,78,139
351570,"2019",33,10,69,112
351570,"2020",36,11,75,122
351570,"2021",36,8,50,94
351570,"2022",17,11,38,66
351570,"2023",23,2,27,52
351580,"2016",1,0,0,1
351580,"2017",0,0,2,2
351580,"2018",0,0,1,1
351590,"2017",0,0,1,1
351590,"2020",1,0,0,1
351600,"2015",4,1,6,11
351600,"2016",1,0,4,5
351600,"2017",2,0,1,3
351600,"2018",0,1,4,5
351600,"2019",0,0,2,2
351600,"2020",3,0,4,7
351600,"2021",4,0,3,7
351600,"2022",2,1,2,5
351600,"2023",2,0,4,6
351610,"2015",1,0,0,1
351610,"2018",2,0,1,3
351610,"2019",0,0,2,2
351610,"2020",1,0,0,1
351610,"2021",0,0,2,2
351620,"2015",69,34,141,244
351620,"2016",77,19,137,233
351620,"2017",89,32,136,257
351620,"2018",85,34,123,242
351620,"2019",88,26,115,229
351620,"2020",67,30,102,199
351620,"2021",109,27,132,268
351620,"2022",118,46,134,298
351620,"2023",69,31,126,226
351630,"2015",52,15,93,160
351630,"2016",52,10,104,166
351630,"2017",47,11,80,138
351630,"2018",71,15,85,171
351630,"2019",38,7,45,90
351630,"2020",32,10,53,95
351630,"2021",39,9,67,115
351630,"2022",38,9,77,124
351630,"2023",40,8,60,108
351640,"2015",45,12,102,159
351640,"2016",46,9,76,131
351640,"2017",44,10,72,126
351640,"2018",50,14,85,149
351640,"2019",38,11,72,121
351640,"2020",34,10,54,98
351640,"2021",33,6,59,98
351640,"2022",32,9,50,91
351640,"2023",24,8,37,69
351650,"2015",0,0,1,1
351650,"2016",1,1,0,2
351650,"2019",0,0,1,1
351650,"2020",1,0,1,2
351650,"2021",1,0,0,1
351650,"2022",0,0,1,1
351660,"2015",1,0,1,2
351660,"2016",1,0,1,2
351660,"2017",1,0,0,1
351660,"2018",0,0,1,1
351660,"2020",1,1,4,6
351660,"2022",0,1,2,3
351660,"2023",1,0,0,1
351670,"2015",11,1,16,28
351670,"2016",7,0,19,26
351670,"2017",7,3,9,19
351670,"2018",8,1,10,19
351670,"2019",2,1,8,11
351670,"2020",3,1,9,13
351670,"2021",4,0,4,8
351670,"2022",5,1,6,12
351670,"2023",1,1,2,4
351680,"2015",0,0,2,2
351680,"2021",0,0,2,2
351680,"2023",0,0,1,1
351685,"2015",4,2,1,7
351685,"2016",0,0,1,1
351685,"2017",1,0,4,5
351685,"2018",1,0,5,6
351685,"2019",1,0,1,2
351685,"2020",3,0,1,4
351685,"2021",0,0,1,1
351685,"2022",1,0,1,2
351690,"2015",0,0,1,1
351690,"2017",0,0,1,1
351690,"2018",1,0,1,2
351690,"2019",0,0,1,1
351690,"2022",0,0,1,1
351690,"2023",0,0,2,2
351700,"2016",0,0,1,1
351700,"2017",2,0,1,3
351700,"2019",0,2,3,5
351700,"2020",0,1,4,5
351700,"2021",1,0,1,2
351700,"2022",2,0,5,7
351700,"2023",0,0,1,1
351710,"2015",1,0,0,1
351720,"2015",0,0,1,1
351720,"2016",1,0,0,1
351720,"2017",2,0,0,2
351720,"2018",1,1,2,4
351720,"2019",1,0,4,5
351720,"2020",1,0,2,3
351720,"2021",3,1,2,6
351720,"2022",4,1,5,10
351720,"2023",2,0,6,8
351730,"2016",0,0,1,1
351730,"2017",0,0,2,2
351730,"2020",1,0,1,2
351730,"2022",1,0,1,2
351740,"2015",9,4,19,32
351740,"2016",14,2,21,37
351740,"2017",12,4,23,39
351740,"2018",8,2,23,33
351740,"2019",13,3,16,32
351740,"2020",14,1,27,42
351740,"2021",9,3,20,32
351740,"2022",8,5,25,38
351740,"2023",5,1,10,16
351750,"2015",0,0,3,3
351750,"2016",2,1,5,8
351750,"2017",1,0,2,3
351750,"2018",0,0,4,4
351750,"2019",2,0,2,4
351750,"2020",0,0,3,3
351750,"2021",0,0,3,3
351750,"2022",1,1,4,6
351750,"2023",2,0,3,5
351760,"2015",5,1,11,17
351760,"2016",5,1,10,16
351760,"2017",11,1,16,28
351760,"2018",7,3,11,21
351760,"2019",4,1,5,10
351760,"2020",3,0,0,3
351760,"2021",2,0,9,11
351760,"2022",3,0,1,4
351760,"2023",0,1,3,4
351770,"2015",3,1,3,7
351770,"2016",0,0,5,5
351770,"2017",0,1,3,4
351770,"2018",2,0,2,4
351770,"2019",3,0,1,4
351770,"2020",2,0,3,5
351770,"2021",4,1,8,13
351770,"2022",6,2,7,15
351770,"2023",1,1,3,5
351780,"2015",3,0,5,8
351780,"2016",1,0,5,6
351780,"2017",2,1,2,5
351780,"2018",2,0,4,6
351780,"2019",4,0,4,8
351780,"2020",1,0,1,2
351780,"2021",0,0,1,1
351780,"2022",1,0,1,2
351780,"2023",1,0,1,2
351790,"2015",3,0,5,8
351790,"2016",7,1,0,8
351790,"2017",3,0,9,12
351790,"2018",4,0,4,8
351790,"2019",1,2,1,4
351790,"2020",1,1,0,2
351790,"2021",0,1,2,3
351790,"2022",2,1,2,5
351790,"2023",2,1,1,4
351800,"2017",0,0,2,2
351800,"2019",1,0,1,2
351810,"2015",2,0,0,2
351810,"2016",3,1,4,8
351810,"2017",1,0,3,4
351810,"2021",0,0,2,2
351810,"2022",0,1,0,1
351810,"2023",1,0,0,1
351820,"2015",3,1,7,11
351820,"2016",3,2,6,11
351820,"2017",4,1,4,9
351820,"2018",1,2,3,6
351820,"2019",3,0,2,5
351820,"2020",2,1,3,6
351820,"2021",0,0,3,3
351820,"2022",2,0,2,4
351820,"2023",1,1,1,3
351830,"2015",5,3,9,17
351830,"2016",4,0,2,6
351830,"2017",4,2,8,14
351830,"2018",1,0,2,3
351830,"2020",1,0,1,2
351830,"2021",4,1,2,7
351830,"2022",2,2,7,11
351830,"2023",4,1,7,12
351840,"2015",10,3,29,42
351840,"2016",26,1,41,68
351840,"2017",20,6,42,68
351840,"2018",10,7,30,47
351840,"2019",25,4,32,61
351840,"2020",13,1,23,37
351840,"2021",14,5,21,40
351840,"2022",13,10,23,46
351840,"2023",15,2,20,37
351850,"2015",0,0,4,4
351850,"2016",0,1,2,3
351850,"2017",1,0,0,1
351850,"2018",2,0,3,5
351850,"2019",0,0,2,2
351850,"2020",1,0,1,2
351850,"2021",0,0,4,4
351850,"2022",0,0,1,1
351850,"2023",1,0,6,7
351860,"2015",5,1,10,16
351860,"2016",4,0,7,11
351860,"2017",8,1,12,21
351860,"2018",5,0,6,11
351860,"2019",3,1,6,10
351860,"2020",6,1,8,15
351860,"2021",3,1,7,11
351860,"2022",6,1,9,16
351860,"2023",7,1,8,16
351870,"2015",26,3,46,75
351870,"2016",46,11,110,167
351870,"2017",64,15,155,234
351870,"2018",45,15,109,169
351870,"2019",46,10,71,127
351870,"2020",42,15,59,116
351870,"2021",34,7,41,82
351870,"2022",28,9,41,78
351870,"2023",15,8,44,67
351880,"2015",217,52,433,702
351880,"2016",224,63,379,666
351880,"2017",248,72,386,706
351880,"2018",258,70,425,753
351880,"2019",219,88,383,690
351880,"2020",201,66,355,622
351880,"2021",195,57,303,555
351880,"2022",168,31,294,493
351880,"2023",139,47,231,417
351885,"2015",3,0,1,4
351885,"2016",1,1,0,2
351885,"2017",0,0,4,4
351885,"2018",3,0,0,3
351885,"2019",0,1,2,3
351885,"2020",2,0,0,2
351885,"2021",0,0,1,1
351885,"2022",0,0,1,1
351885,"2023",0,0,2,2
351890,"2022",1,0,0,1
351890,"2023",0,0,1,1
351900,"2015",2,2,3,7
351900,"2016",1,0,3,4
351900,"2017",0,0,7,7
351900,"2018",1,1,2,4
351900,"2019",2,2,2,6
351900,"2020",3,0,2,5
351900,"2021",1,0,2,3
351900,"2022",1,0,5,6
351900,"2023",1,0,1,2
351905,"2015",0,1,3,4
351905,"2016",3,1,2,6
351905,"2017",4,0,3,7
351905,"2018",0,0,3,3
351905,"2019",3,0,6,9
351905,"2020",2,2,3,7
351905,"2021",3,0,0,3
351905,"2022",1,0,1,2
351905,"2023",1,2,1,4
351907,"2015",31,9,63,103
351907,"2016",70,19,92,181
351907,"2017",69,15,103,187
351907,"2018",65,22,121,208
351907,"2019",60,27,88,175
351907,"2020",52,20,65,137
351907,"2021",55,25,79,159
351907,"2022",58,18,69,145
351907,"2023",26,12,35,73
351910,"2015",1,0,2,3
351910,"2016",2,0,5,7
351910,"2017",0,1,1,2
351910,"2018",3,0,3,6
351910,"2019",2,0,2,4
351910,"2020",0,2,6,8
351910,"2021",3,0,2,5
351910,"2022",1,0,3,4
351910,"2023",1,0,1,2
351920,"2015",1,0,2,3
351920,"2016",2,1,3,6
351920,"2017",2,0,4,6
351920,"2018",0,0,2,2
351920,"2019",0,0,3,3
351920,"2020",0,0,2,2
351920,"2021",1,0,3,4
351920,"2022",2,0,1,3
351920,"2023",1,0,0,1
351925,"2015",1,0,1,2
351925,"2016",0,0,1,1
351925,"2017",1,0,4,5
351925,"2018",1,0,0,1
351925,"2019",1,1,0,2
351925,"2020",3,0,0,3
351925,"2021",1,0,1,2
351925,"2022",1,1,2,4
351930,"2015",5,2,12,19
351930,"2016",5,2,12,19
351930,"2017",4,5,2,11
351930,"2018",5,2,7,14
351930,"2019",7,0,11,18
351930,"2020",2,0,6,8
351930,"2021",5,2,8,15
351930,"2022",2,0,6,8
351930,"2023",7,1,0,8
351940,"2015",0,1,3,4
351940,"2016",0,0,2,2
351940,"2017",1,0,3,4
351940,"2018",1,0,2,3
351940,"2019",1,0,2,3
351940,"2020",0,0,3,3
351940,"2021",0,1,2,3
351940,"2022",1,0,0,1
351940,"2023",1,0,0,1
351950,"2017",3,0,1,4
351950,"2019",0,1,1,2
351950,"2020",0,0,1,1
351950,"2021",3,1,2,6
351950,"2022",1,0,3,4
351950,"2023",0,0,1,1
351960,"2015",7,2,27,36
351960,"2016",7,1,22,30
351960,"2017",5,3,19,27
351960,"2018",7,2,19,28
351960,"2019",14,4,27,45
351960,"2020",10,2,26,38
351960,"2021",10,2,16,28
351960,"2022",18,5,15,38
351960,"2023",14,1,26,41
351970,"2015",0,0,5,5
351970,"2016",3,0,4,7
351970,"2017",6,0,7,13
351970,"2018",32,7,38,77
351970,"2019",26,8,57,91
351970,"2020",13,4,17,34
351970,"2021",26,5,54,85
351970,"2022",35,12,75,122
351970,"2023",34,10,52,96
351980,"2015",1,0,0,1
351980,"2017",5,0,1,6
351980,"2018",2,0,0,2
351980,"2019",3,0,1,4
351980,"2020",0,0,1,1
351990,"2015",1,0,1,2
351990,"2016",1,0,0,1
351990,"2017",0,0,3,3
351990,"2018",3,0,1,4
351990,"2019",2,0,1,3
351990,"2021",2,0,2,4
351990,"2022",0,0,1,1
351990,"2023",0,0,1,1
352000,"2015",0,1,5,6
352000,"2016",4,2,3,9
352000,"2017",4,0,7,11
352000,"2018",8,0,9,17
352000,"2019",4,0,4,8
352000,"2020",3,1,2,6
352000,"2021",3,0,7,10
352000,"2022",5,0,1,6
352000,"2023",2,0,3,5
352010,"2015",0,0,4,4
352010,"2016",3,1,5,9
352010,"2017",1,0,5,6
352010,"2018",6,3,6,15
352010,"2019",1,1,2,4
352010,"2020",0,1,2,3
352010,"2021",0,2,1,3
352010,"2022",3,3,6,12
352010,"2023",1,0,0,1
352020,"2015",0,0,3,3
352020,"2016",1,1,1,3
352020,"2017",1,1,0,2
352020,"2018",1,0,1,2
352020,"2019",1,1,3,5
352020,"2020",0,0,1,1
352020,"2021",1,0,4,5
352020,"2022",1,0,3,4
352020,"2023",1,0,0,1
352030,"2015",7,0,15,22
352030,"2016",7,2,20,29
352030,"2017",10,2,15,27
352030,"2018",6,1,13,20
352030,"2019",6,2,12,20
352030,"2020",7,1,3,11
352030,"2021",7,2,9,18
352030,"2022",5,1,8,14
352030,"2023",3,1,11,15
352040,"2015",1,0,3,4
352040,"2016",1,0,1,2
352040,"2018",3,0,0,3
352040,"2019",1,0,1,2
352040,"2020",1,0,2,3
352040,"2021",0,0,1,1
352040,"2022",2,0,7,9
352040,"2023",1,1,4,6
352042,"2015",2,0,4,6
352042,"2016",2,1,2,5
352042,"2017",7,1,6,14
352042,"2018",8,0,1,9
352042,"2019",4,1,4,9
352042,"2020",8,0,8,16
352042,"2021",3,0,3,6
352042,"2022",2,0,3,5
352042,"2023",2,3,3,8
352044,"2015",4,4,4,12
352044,"2016",3,0,2,5
352044,"2017",0,1,3,4
352044,"2018",0,0,2,2
352044,"2019",0,0,3,3
352044,"2020",0,1,1,2
352044,"2021",4,0,9,13
352044,"2022",3,0,1,4
352044,"2023",3,0,2,5
352050,"2015",62,17,90,169
352050,"2016",58,18,110,186
352050,"2017",76,23,114,213
352050,"2018",59,11,69,139
352050,"2019",54,21,84,159
352050,"2020",59,15,77,151
352050,"2021",61,21,69,151
352050,"2022",59,14,79,152
352050,"2023",50,10,52,112
352060,"2015",1,0,2,3
352060,"2016",2,0,2,4
352060,"2017",0,1,0,1
352060,"2018",0,0,1,1
352060,"2019",1,1,0,2
352060,"2020",0,0,1,1
352060,"2021",0,0,2,2
352060,"2022",0,0,1,1
352060,"2023",0,0,1,1
352070,"2015",0,1,1,2
352070,"2016",2,0,0,2
352070,"2017",0,0,1,1
352070,"2018",2,0,2,4
352070,"2020",0,0,1,1
352070,"2021",1,0,0,1
352070,"2022",1,1,1,3
352080,"2015",0,0,2,2
352080,"2018",1,0,2,3
352080,"2019",1,1,0,2
352080,"2020",3,0,1,4
352080,"2022",1,0,2,3
352090,"2017",0,0,1,1
352090,"2018",1,0,1,2
352090,"2019",3,0,3,6
352090,"2020",2,0,2,4
352090,"2021",0,1,0,1
352090,"2022",1,0,2,3
352090,"2023",2,0,3,5
352100,"2015",6,2,9,17
352100,"2016",3,1,3,7
352100,"2017",6,2,8,16
352100,"2018",3,1,7,11
352100,"2019",5,2,5,12
352100,"2020",5,1,9,15
352100,"2021",5,1,9,15
352100,"2022",7,1,16,24
352100,"2023",3,2,9,14
352110,"2015",0,1,5,6
352110,"2016",1,0,1,2
352110,"2017",4,0,4,8
352110,"2018",2,1,3,6
352110,"2019",1,0,0,1
352110,"2020",1,0,5,6
352110,"2021",0,1,2,3
352110,"2022",0,0,3,3
352115,"2016",0,0,1,1
352115,"2017",1,0,2,3
352115,"2018",1,0,3,4
352115,"2019",0,0,2,2
352115,"2021",0,0,1,1
352120,"2015",0,0,1,1
352120,"2016",0,0,4,4
352120,"2017",1,0,2,3
352120,"2018",0,0,1,1
352120,"2019",2,0,2,4
352120,"2020",5,0,0,5
352120,"2021",0,1,2,3
352120,"2022",1,0,0,1
352120,"2023",1,0,0,1
352130,"2015",6,2,7,15
352130,"2016",4,0,4,8
352130,"2017",5,0,9,14
352130,"2018",3,0,3,6
352130,"2019",2,0,2,4
352130,"2020",0,0,4,4
352130,"2021",0,0,1,1
352130,"2022",1,0,0,1
352130,"2023",0,0,1,1
352140,"2015",1,1,7,9
352140,"2016",1,0,1,2
352140,"2017",4,0,10,14
352140,"2018",2,0,7,9
352140,"2019",5,1,8,14
352140,"2020",6,1,4,11
352140,"2021",3,0,8,11
352140,"2022",4,1,4,9
352140,"2023",1,0,4,5
352150,"2015",0,0,1,1
352150,"2016",0,0,1,1
352150,"2017",0,0,1,1
352150,"2018",1,0,1,2
352150,"2019",1,0,1,2
352150,"2020",0,0,1,1
352150,"2021",1,0,1,2
352150,"2022",3,0,3,6
352150,"2023",0,1,1,2
352160,"2015",1,1,4,6
352160,"2016",3,0,2,5
352160,"2017",1,1,2,4
352160,"2018",1,0,1,2
352160,"2019",0,0,1,1
352160,"2020",1,0,2,3
352160,"2021",0,0,1,1
352160,"2022",1,0,0,1
352160,"2023",1,0,0,1
352170,"2015",0,0,1,1
352170,"2016",2,0,2,4
352170,"2017",0,0,5,5
352170,"2018",2,3,1,6
352170,"2019",0,0,8,8
352170,"2020",1,1,2,4
352170,"2021",4,0,13,17
352170,"2022",4,2,11,17
352170,"2023",3,0,1,4
352180,"2015",3,0,3,6
352180,"2016",2,0,0,2
352180,"2017",3,0,4,7
352180,"2018",1,0,1,2
352180,"2019",1,0,4,5
352180,"2020",1,0,1,2
352180,"2021",1,0,0,1
352180,"2023",0,0,1,1
352190,"2015",1,0,4,5
352190,"2016",0,1,5,6
352190,"2017",1,2,1,4
352190,"2018",2,1,4,7
352190,"2019",0,0,2,2
352190,"2020",1,0,2,3
352190,"2021",2,0,3,5
352190,"2022",2,0,1,3
352190,"2023",1,0,0,1
352200,"2018",0,0,1,1
352200,"2019",1,0,1,2
352200,"2020",2,0,0,2
352200,"2021",0,0,1,1
352200,"2022",1,0,0,1
352200,"2023",0,0,2,2
352210,"2015",49,10,70,129
352210,"2016",47,12,72,131
352210,"2017",40,9,55,104
352210,"2018",39,13,57,109
352210,"2019",39,14,63,116
352210,"2020",33,11,44,88
352210,"2021",42,17,49,108
352210,"2022",37,21,41,99
352210,"2023",17,10,42,69
352215,"2015",1,0,1,2
352215,"2016",1,0,1,2
352215,"2017",0,0,1,1
352215,"2018",1,1,1,3
352215,"2019",2,0,2,4
352215,"2020",0,1,0,1
352215,"2021",1,0,0,1
352220,"2015",55,17,92,164
352220,"2016",32,10,67,109
352220,"2017",41,13,69,123
352220,"2018",32,10,56,98
352220,"2019",29,14,47,90
352220,"2020",31,6,35,72
352220,"2021",37,12,66,115
352220,"2022",48,15,61,124
352220,"2023",34,6,48,88
352230,"2015",17,6,38,61
352230,"2016",16,13,20,49
352230,"2017",8,1,16,25
352230,"2018",22,8,25,55
352230,"2019",12,5,12,29
352230,"2020",18,3,16,37
352230,"2021",19,3,21,43
352230,"2022",18,4,14,36
352230,"2023",3,4,17,24
352240,"2015",12,2,24,38
352240,"2016",12,4,26,42
352240,"2017",8,4,15,27
352240,"2018",11,1,11,23
352240,"2019",11,2,10,23
352240,"2020",7,1,9,17
352240,"2021",9,2,13,24
352240,"2022",7,4,20,31
352240,"2023",6,3,11,20
352250,"2015",61,16,126,203
352250,"2016",67,21,119,207
352250,"2017",64,18,116,198
352250,"2018",77,28,79,184
352250,"2019",53,18,79,150
352250,"2020",40,13,62,115
352250,"2021",50,11,79,140
352250,"2022",38,10,72,120
352250,"2023",40,14,58,112
352260,"2015",1,0,1,2
352260,"2016",4,0,4,8
352260,"2017",9,1,6,16
352260,"2018",1,0,5,6
352260,"2019",3,0,5,8
352260,"2020",1,1,3,5
352260,"2021",0,1,1,2
352260,"2022",1,0,0,1
352260,"2023",0,1,1,2
352265,"2015",1,0,1,2
352265,"2017",1,0,2,3
352265,"2018",0,0,1,1
352265,"2019",1,0,1,2
352265,"2020",0,0,1,1
352265,"2021",1,1,0,2
352265,"2022",1,1,0,2
352265,"2023",0,0,1,1
352270,"2015",4,1,6,11
352270,"2016",6,1,6,13
352270,"2017",12,1,4,17
352270,"2018",4,0,11,15
352270,"2019",2,0,8,10
352270,"2020",8,1,4,13
352270,"2021",3,3,9,15
352270,"2022",12,1,15,28
352270,"2023",3,3,4,10
352280,"2015",5,0,3,8
352280,"2016",2,0,4,6
352280,"2017",2,2,4,8
352280,"2018",1,1,4,6
352280,"2019",5,0,2,7
352280,"2020",1,0,2,3
352280,"2021",1,1,4,6
352280,"2022",1,1,2,4
352280,"2023",3,0,1,4
352290,"2015",2,0,2,4
352290,"2016",0,0,1,1
352290,"2020",1,0,0,1
352290,"2022",0,0,1,1
352300,"2015",1,0,2,3
352300,"2016",0,0,1,1
352300,"2017",1,0,2,3
352300,"2018",0,0,1,1
352300,"2020",0,0,1,1
352300,"2021",1,0,1,2
352300,"2022",0,0,1,1
352310,"2015",79,13,155,247
352310,"2016",77,22,176,275
352310,"2017",77,14,167,258
352310,"2018",87,22,162,271
352310,"2019",74,22,136,232
352310,"2020",61,13,106,180
352310,"2021",69,17,97,183
352310,"2022",62,17,107,186
352310,"2023",52,20,84,156
352320,"2015",3,2,27,32
352320,"2016",9,1,17,27
352320,"2017",11,2,17,30
352320,"2018",2,1,6,9
352320,"2019",9,0,11,20
352320,"2020",8,3,9,20
352320,"2021",9,2,7,18
352320,"2022",8,1,7,16
352320,"2023",3,1,9,13
352330,"2015",3,1,11,15
352330,"2016",2,2,4,8
352330,"2017",4,3,5,12
352330,"2018",4,1,5,10
352330,"2019",2,0,7,9
352330,"2020",4,3,4,11
352330,"2021",3,1,0,4
352330,"2022",2,1,1,4
352330,"2023",3,0,3,6
352340,"2015",35,4,34,73
352340,"2016",26,9,33,68
352340,"2017",26,10,33,69
352340,"2018",22,5,44,71
352340,"2019",21,12,44,77
352340,"2020",29,15,30,74
352340,"2021",17,7,37,61
352340,"2022",25,12,24,61
352340,"2023",21,5,38,64
352350,"2015",4,1,8,13
352350,"2016",3,0,12,15
352350,"2017",1,1,3,5
352350,"2018",7,1,5,13
352350,"2019",7,2,6,15
352350,"2020",4,1,5,10
352350,"2021",9,2,5,16
352350,"2022",2,1,11,14
352350,"2023",3,1,4,8
352360,"2015",2,0,7,9
352360,"2016",1,0,5,6
352360,"2017",2,0,6,8
352360,"2018",2,0,3,5
352360,"2019",5,0,4,9
352360,"2020",3,1,6,10
352360,"2022",0,0,1,1
352360,"2023",0,0,2,2
352370,"2015",1,0,1,2
352370,"2016",1,1,2,4
352370,"2017",2,0,3,5
352370,"2019",1,1,3,5
352370,"2020",0,0,5,5
352370,"2021",1,0,0,1
352370,"2022",0,1,1,2
352370,"2023",1,0,0,1
352380,"2015",1,2,3,6
352380,"2016",2,0,3,5
352380,"2017",2,0,2,4
352380,"2018",1,0,6,7
352380,"2019",1,0,3,4
352380,"2020",0,0,1,1
352380,"2021",3,0,2,5
352380,"2022",1,0,3,4
352380,"2023",0,0,2,2
352390,"2015",24,3,25,52
352390,"2016",17,5,25,47
352390,"2017",21,8,35,64
352390,"2018",13,6,15,34
352390,"2019",21,7,35,63
352390,"2020",27,10,41,78
352390,"2021",28,11,43,82
352390,"2022",28,12,39,79
352390,"2023",24,18,44,86
352400,"2015",3,1,1,5
352400,"2016",0,0,2,2
352400,"2017",2,1,11,14
352400,"2018",12,1,15,28
352400,"2019",5,3,13,21
352400,"2020",10,6,8,24
352400,"2021",16,3,17,36
352400,"2022",13,2,22,37
352400,"2023",10,4,13,27
352410,"2015",3,1,2,6
352410,"2016",2,2,4,8
352410,"2017",0,3,4,7
352410,"2018",1,2,11,14
352410,"2019",5,0,5,10
352410,"2020",8,1,9,18
352410,"2021",3,1,5,9
352410,"2022",3,2,5,10
352410,"2023",1,0,3,4
352420,"2016",0,0,2,2
352420,"2017",1,0,0,1
352420,"2018",1,0,1,2
352420,"2020",1,0,0,1
352420,"2021",1,0,0,1
352420,"2022",0,0,1,1
352430,"2015",6,2,20,28
352430,"2016",13,3,13,29
352430,"2017",12,5,22,39
352430,"2018",7,4,21,32
352430,"2019",11,6,28,45
352430,"2020",11,3,21,35
352430,"2021",10,3,12,25
352430,"2022",7,8,16,31
352430,"2023",9,4,13,26
352440,"2015",19,5,27,51
352440,"2016",32,5,41,78
352440,"2017",9,4,13,26
352440,"2018",11,5,32,48
352440,"2019",8,2,21,31
352440,"2020",6,1,13,20
352440,"2021",25,7,36,68
352440,"2022",16,7,19,42
352440,"2023",6,2,18,26
352450,"2015",1,0,2,3
352450,"2016",1,1,1,3
352450,"2017",1,0,3,4
352450,"2018",2,0,2,4
352450,"2019",1,1,2,4
352450,"2020",1,0,4,5
352450,"2021",0,1,2,3
352450,"2022",2,0,2,4
352450,"2023",0,1,2,3
352460,"2015",7,1,6,14
352460,"2016",9,2,9,20
352460,"2017",6,2,12,20
352460,"2018",6,2,10,18
352460,"2019",5,0,10,15
352460,"2020",9,2,8,19
352460,"2021",6,5,7,18
352460,"2022",7,1,7,15
352460,"2023",4,1,6,11
352470,"2015",13,7,10,30
352470,"2016",20,2,16,38
352470,"2017",18,4,21,43
352470,"2018",8,2,21,31
352470,"2019",7,1,10,18
352470,"2020",8,5,9,22
352470,"2021",8,3,11,22
352470,"2022",3,3,10,16
352470,"2023",11,3,9,23
352480,"2015",9,6,23,38
352480,"2016",17,2,15,34
352480,"2017",8,0,5,13
352480,"2018",3,2,11,16
352480,"2019",10,0,2,12
352480,"2020",12,4,19,35
352480,"2021",8,4,16,28
352480,"2022",2,3,5,10
352480,"2023",4,0,6,10
352490,"2016",0,1,1,2
352490,"2019",1,0,1,2
352490,"2020",1,0,0,1
352490,"2021",1,0,1,2
352490,"2022",1,0,2,3
352490,"2023",1,1,0,2
352500,"2015",35,6,37,78
352500,"2016",23,11,40,74
352500,"2017",31,6,53,90
352500,"2018",21,13,44,78
352500,"2019",22,6,35,63
352500,"2020",18,11,33,62
352500,"2021",13,9,23,45
352500,"2022",15,7,31,53
352500,"2023",15,9,22,46
352510,"2015",8,3,9,20
352510,"2016",11,1,18,30
352510,"2017",11,1,7,19
352510,"2018",3,1,15,19
352510,"2019",8,2,18,28
352510,"2020",4,1,13,18
352510,"2021",4,1,14,19
352510,"2022",4,1,2,7
352510,"2023",5,1,3,9
352520,"2015",2,0,5,7
352520,"2016",10,2,6,18
352520,"2017",4,3,5,12
352520,"2018",1,0,3,4
352520,"2019",4,2,3,9
352520,"2020",1,3,0,4
352520,"2021",4,0,6,10
352520,"2022",1,1,5,7
352520,"2023",4,0,5,9
352530,"2015",0,0,2,2
352530,"2016",1,1,0,2
352530,"2017",0,0,4,4
352530,"2018",1,1,2,4
352530,"2019",25,13,36,74
352530,"2020",30,16,39,85
352530,"2021",27,4,35,66
352530,"2022",25,6,45,76
352530,"2023",23,1,31,55
352540,"2016",2,0,1,3
352540,"2017",1,0,0,1
352540,"2018",0,0,1,1
352540,"2019",0,0,1,1
352540,"2020",0,0,4,4
352540,"2021",4,1,3,8
352550,"2016",1,0,4,5
352550,"2017",3,0,3,6
352550,"2018",2,1,3,6
352550,"2019",2,0,0,2
352550,"2020",5,0,6,11
352550,"2021",1,2,2,5
352550,"2022",1,2,5,8
352550,"2023",1,0,1,2
352560,"2015",0,0,2,2
352560,"2022",1,0,0,1
352560,"2023",0,1,1,2
352570,"2015",1,0,7,8
352570,"2016",0,0,1,1
352570,"2017",3,1,0,4
352570,"2018",5,0,5,10
352570,"2019",1,0,3,4
352570,"2020",2,0,3,5
352570,"2021",1,0,3,4
352570,"2022",1,0,10,11
352570,"2023",0,0,3,3
352580,"2015",1,0,3,4
352580,"2016",0,0,2,2
352580,"2017",0,1,0,1
352580,"2018",0,0,1,1
352580,"2019",1,0,0,1
352580,"2020",0,0,1,1
352580,"2022",1,0,0,1
352585,"2015",0,0,1,1
352585,"2016",1,0,0,1
352585,"2017",0,1,0,1
352585,"2021",1,0,0,1
352585,"2022",0,0,1,1
352585,"2023",1,0,1,2
352590,"2015",29,13,65,107
352590,"2016",73,17,88,178
352590,"2017",77,10,91,178
352590,"2018",74,23,119,216
352590,"2019",99,30,154,283
352590,"2020",90,27,117,234
352590,"2021",82,21,115,218
352590,"2022",71,27,103,201
352590,"2023",61,25,83,169
352600,"2015",3,1,9,13
352600,"2016",3,2,8,13
352600,"2017",3,2,6,11
352600,"2018",8,3,10,21
352600,"2019",2,1,6,9
352600,"2020",4,1,2,7
352600,"2021",0,0,1,1
352600,"2022",0,0,3,3
352600,"2023",0,2,0,2
352610,"2015",3,2,6,11
352610,"2016",10,0,11,21
352610,"2017",7,0,12,19
352610,"2018",6,1,18,25
352610,"2019",4,3,12,19
352610,"2020",7,2,9,18
352610,"2021",8,2,13,23
352610,"2022",5,2,5,12
352610,"2023",5,0,6,11
352620,"2015",4,1,9,14
352620,"2016",4,1,7,12
352620,"2017",9,2,9,20
352620,"2018",4,0,9,13
352620,"2019",9,0,8,17
352620,"2020",3,0,4,7
352620,"2021",3,0,12,15
352620,"2022",4,1,11,16
352620,"2023",3,0,9,12
352630,"2015",1,0,2,3
352630,"2017",0,0,1,1
352630,"2018",2,0,1,3
352630,"2019",0,0,1,1
352630,"2020",0,0,2,2
352630,"2021",1,1,0,2
352630,"2022",0,1,1,2
352640,"2015",1,0,7,8
352640,"2016",5,1,7,13
352640,"2017",4,1,14,19
352640,"2018",6,0,5,11
352640,"2019",1,1,12,14
352640,"2020",4,0,1,5
352640,"2021",2,0,2,4
352640,"2022",1,0,3,4
352640,"2023",2,1,7,10
352650,"2015",1,0,1,2
352650,"2016",2,0,1,3
352650,"2017",1,0,1,2
352650,"2018",3,1,3,7
352650,"2019",1,0,3,4
352650,"2020",1,0,1,2
352650,"2021",1,0,2,3
352650,"2022",0,1,1,2
352650,"2023",0,0,2,2
352660,"2015",1,1,2,4
352660,"2016",1,0,1,2
352660,"2017",1,0,2,3
352660,"2019",3,0,0,3
352660,"2020",0,0,1,1
352670,"2015",20,1,29,50
352670,"2016",18,6,39,63
352670,"2017",16,4,32,52
352670,"2018",13,7,32,52
352670,"2019",11,2,34,47
352670,"2020",2,2,9,13
352670,"2021",7,0,8,15
352670,"2022",10,2,9,21
352670,"2023",1,0,3,4
352680,"2015",18,5,18,41
352680,"2016",23,5,27,55
352680,"2017",17,3,19,39
352680,"2018",19,4,11,34
352680,"2019",13,9,19,41
352680,"2020",12,3,31,46
352680,"2021",15,3,11,29
352680,"2022",11,2,24,37
352680,"2023",5,4,11,20
352690,"2015",67,17,98,182
352690,"2016",48,6,70,124
352690,"2017",55,18,64,137
352690,"2018",50,17,70,137
352690,"2019",62,19,72,153
352690,"2020",65,18,72,155
352690,"2021",53,22,119,194
352690,"2022",41,10,62,113
352690,"2023",40,12,66,118
352700,"2015",6,0,2,8
352700,"2016",1,0,1,2
352700,"2017",1,1,3,5
352700,"2018",2,1,3,6
352700,"2019",0,0,2,2
352700,"2020",0,0,1,1
352700,"2022",1,0,0,1
352710,"2015",2,0,3,5
352710,"2016",9,4,16,29
352710,"2017",9,4,16,29
352710,"2018",5,3,11,19
352710,"2019",11,0,9,20
352710,"2020",16,2,12,30
352710,"2021",12,5,18,35
352710,"2022",16,6,17,39
352710,"2023",17,5,18,40
352720,"2015",0,0,1,1
352720,"2016",1,1,3,5
352720,"2017",8,3,6,17
352720,"2018",8,1,16,25
352720,"2019",11,0,16,27
352720,"2020",2,5,17,24
352720,"2021",18,0,17,35
352720,"2022",14,4,24,42
352720,"2023",10,3,12,25
352725,"2015",1,0,0,1
352725,"2018",2,0,0,2
352730,"2015",11,4,17,32
352730,"2016",17,1,18,36
352730,"2017",5,4,27,36
352730,"2018",16,4,20,40
352730,"2019",14,4,20,38
352730,"2020",17,2,25,44
352730,"2021",16,5,22,43
352730,"2022",14,7,34,55
352730,"2023",10,2,20,32
352740,"2015",5,0,2,7
352740,"2016",2,0,3,5
352740,"2017",0,0,6,6
352740,"2018",1,1,9,11
352740,"2019",2,1,1,4
352740,"2020",3,0,2,5
352740,"2021",2,0,1,3
352740,"2022",4,0,2,6
352740,"2023",0,0,1,1
352750,"2022",0,1,0,1
352750,"2023",0,0,1,1
352760,"2015",3,0,2,5
352760,"2016",1,0,2,3
352760,"2017",1,0,0,1
352760,"2018",1,0,5,6
352760,"2019",0,0,4,4
352760,"2020",3,0,2,5
352760,"2021",0,1,3,4
352760,"2022",0,0,1,1
352760,"2023",0,0,1,1
352770,"2015",0,1,1,2
352780,"2015",1,2,1,4
352780,"2016",0,0,4,4
352780,"2017",1,0,1,2
352780,"2018",0,0,2,2
352780,"2019",2,0,1,3
352780,"2020",2,0,0,2
352780,"2023",0,0,1,1
352790,"2020",1,0,0,1
352800,"2015",4,1,4,9
352800,"2016",3,1,16,20
352800,"2017",4,1,12,17
352800,"2018",2,0,5,7
352800,"2019",2,0,11,13
352800,"2020",3,2,5,10
352800,"2021",3,2,5,10
352800,"2022",3,4,3,10
352800,"2023",2,1,0,3
352810,"2015",2,0,0,2
352820,"2016",0,0,1,1
352820,"2017",0,0,1,1
352820,"2019",0,0,1,1
352820,"2020",2,0,1,3
352820,"2022",0,1,0,1
352820,"2023",0,2,2,4
352830,"2015",0,1,1,2
352840,"2015",12,5,13,30
352840,"2016",5,1,6,12
352840,"2017",7,4,12,23
352840,"2018",9,2,14,25
352840,"2019",16,4,10,30
352840,"2020",2,1,12,15
352840,"2021",7,0,7,14
352840,"2022",8,2,8,18
352840,"2023",5,1,9,15
352850,"2015",28,6,30,64
352850,"2016",16,12,25,53
352850,"2017",25,7,33,65
352850,"2018",19,10,40,69
352850,"2019",27,11,29,67
352850,"2020",20,7,23,50
352850,"2021",15,7,24,46
352850,"2022",12,6,27,45
352850,"2023",8,1,15,24
352860,"2015",2,1,5,8
352860,"2016",2,0,3,5
352860,"2017",0,0,8,8
352860,"2018",3,1,3,7
352860,"2019",2,0,2,4
352860,"2020",1,0,5,6
352860,"2021",0,1,1,2
352860,"2022",4,0,1,5
352860,"2023",1,0,4,5
352870,"2015",0,0,1,1
352870,"2016",0,0,1,1
352870,"2017",1,0,3,4
352870,"2018",2,0,1,3
352870,"2019",1,0,3,4
352870,"2020",0,0,2,2
352870,"2021",0,0,4,4
352870,"2022",0,1,3,4
352870,"2023",1,1,1,3
352880,"2015",0,1,2,3
352880,"2016",0,0,1,1
352880,"2020",0,0,1,1
352880,"2021",1,0,0,1
352880,"2022",1,0,2,3
352880,"2023",0,0,1,1
352885,"2017",1,0,1,2
352885,"2022",0,0,1,1
352885,"2023",0,1,0,1
352890,"2015",0,0,1,1
352890,"2016",0,0,2,2
352890,"2017",1,0,0,1
352890,"2020",0,0,2,2
352900,"2015",35,8,59,102
352900,"2016",34,10,69,113
352900,"2017",33,7,46,86
352900,"2018",15,5,21,41
352900,"2019",15,2,26,43
352900,"2020",16,9,25,50
352900,"2021",11,6,13,30
352900,"2022",20,4,30,54
352900,"2023",12,7,26,45
352910,"2015",1,0,0,1
352910,"2016",2,0,0,2
352910,"2020",0,0,2,2
352910,"2021",0,0,1,1
352910,"2023",1,0,0,1
352920,"2015",0,1,3,4
352920,"2016",1,1,1,3
352920,"2017",2,0,3,5
352920,"2018",1,0,3,4
352920,"2019",2,0,1,3
352920,"2020",5,1,1,7
352920,"2021",5,1,6,12
352920,"2022",1,1,6,8
352920,"2023",1,0,4,5
352930,"2015",7,1,9,17
352930,"2016",7,3,15,25
352930,"2017",11,2,19,32
352930,"2018",6,4,11,21
352930,"2019",13,1,16,30
352930,"2020",10,2,9,21
352930,"2021",2,2,9,13
352930,"2022",4,1,10,15
352930,"2023",6,0,7,13
352940,"2015",79,18,173,270
352940,"2016",66,17,135,218
352940,"2017",62,12,118,192
352940,"2018",68,17,125,210
352940,"2019",77,14,154,245
352940,"2020",75,20,121,216
352940,"2021",66,20,109,195
352940,"2022",54,20,95,169
352940,"2023",32,9,55,96
352950,"2015",0,0,3,3
352950,"2017",1,0,0,1
352950,"2018",1,0,1,2
352950,"2019",1,0,0,1
352950,"2021",1,0,0,1
352960,"2016",0,0,1,1
352960,"2019",0,0,1,1
352960,"2020",0,0,1,1
352960,"2022",0,0,1,1
352960,"2023",0,0,2,2
352965,"2015",0,0,1,1
352965,"2017",1,1,0,2
352965,"2018",1,0,0,1
352965,"2019",0,0,1,1
352965,"2020",0,1,0,1
352965,"2021",1,1,0,2
352965,"2022",1,0,0,1
352965,"2023",0,1,0,1
352970,"2015",4,1,10,15
352970,"2016",3,3,10,16
352970,"2017",4,1,5,10
352970,"2018",2,0,8,10
352970,"2019",1,1,4,6
352970,"2020",0,0,1,1
352970,"2021",5,1,8,14
352970,"2022",3,0,2,5
352980,"2015",1,0,0,1
352980,"2018",1,0,1,2
352980,"2019",4,0,1,5
352980,"2020",1,1,3,5
352980,"2021",2,0,2,4
352980,"2022",0,0,3,3
352980,"2023",2,0,3,5
352990,"2015",9,3,10,22
352990,"2016",4,1,19,24
352990,"2017",8,0,10,18
352990,"2018",6,4,13,23
352990,"2019",4,3,17,24
352990,"2020",8,2,13,23
352990,"2021",1,2,8,11
352990,"2022",5,5,7,17
352990,"2023",4,5,4,13
353000,"2015",1,0,0,1
353000,"2016",0,0,2,2
353000,"2018",0,1,0,1
353000,"2019",1,0,1,2
353000,"2022",1,0,0,1
353010,"2015",12,3,13,28
353010,"2016",9,3,7,19
353010,"2017",10,4,6,20
353010,"2018",11,1,11,23
353010,"2019",12,3,11,26
353010,"2020",11,0,6,17
353010,"2021",5,2,6,13
353010,"2022",6,2,4,12
353010,"2023",4,1,8,13
353020,"2015",3,1,7,11
353020,"2016",0,0,7,7
353020,"2017",2,0,4,6
353020,"2018",3,1,4,8
353020,"2019",4,3,9,16
353020,"2020",3,0,4,7
353020,"2021",3,1,2,6
353020,"2022",1,0,5,6
353020,"2023",2,0,4,6
353030,"2015",13,4,14,31
353030,"2016",9,1,28,38
353030,"2017",14,0,18,32
353030,"2018",14,3,15,32
353030,"2019",20,1,13,34
353030,"2020",7,1,18,26
353030,"2021",12,3,12,27
353030,"2022",7,3,16,26
353030,"2023",10,1,14,25
353040,"2015",0,0,2,2
353040,"2016",2,0,0,2
353040,"2017",0,0,1,1
353040,"2018",0,0,1,1
353040,"2020",0,1,0,1
353040,"2023",1,0,0,1
353050,"2015",13,0,27,40
353050,"2016",16,5,28,49
353050,"2017",18,13,27,58
353050,"2018",19,4,23,46
353050,"2019",18,9,24,51
353050,"2020",14,4,22,40
353050,"2021",12,2,10,24
353050,"2022",10,2,18,30
353050,"2023",5,2,13,20
353060,"2015",106,26,165,297
353060,"2016",68,16,124,208
353060,"2017",66,26,123,215
353060,"2018",57,15,70,142
353060,"2019",46,4,64,114
353060,"2020",62,24,92,178
353060,"2021",51,22,106,179
353060,"2022",42,21,96,159
353060,"2023",17,6,27,50
353070,"2015",21,6,47,74
353070,"2016",16,4,31,51
353070,"2017",23,3,25,51
353070,"2018",9,4,23,36
353070,"2019",14,3,12,29
353070,"2020",21,8,27,56
353070,"2021",13,1,26,40
353070,"2022",10,5,19,34
353070,"2023",7,3,19,29
353080,"2015",17,4,27,48
353080,"2016",7,4,26,37
353080,"2017",18,4,35,57
353080,"2018",7,3,20,30
353080,"2019",7,5,22,34
353080,"2020",18,7,23,48
353080,"2021",22,9,22,53
353080,"2022",7,2,11,20
353080,"2023",6,4,13,23
353090,"2015",2,0,2,4
353090,"2016",2,0,2,4
353090,"2017",1,0,1,2
353090,"2018",0,0,1,1
353090,"2019",2,0,1,3
353090,"2020",1,0,1,2
353090,"2022",1,0,1,2
353090,"2023",0,0,2,2
353100,"2015",0,0,1,1
353110,"2015",8,1,14,23
353110,"2016",7,4,13,24
353110,"2017",9,4,12,25
353110,"2018",13,10,12,35
353110,"2019",17,6,27,50
353110,"2020",15,5,29,49
353110,"2021",11,3,28,42
353110,"2022",12,4,28,44
353110,"2023",7,2,17,26
353120,"2019",1,0,1,2
353130,"2015",4,3,4,11
353130,"2016",7,4,15,26
353130,"2017",15,1,16,32
353130,"2018",8,0,7,15
353130,"2019",4,0,3,7
353130,"2020",6,1,2,9
353130,"2021",5,1,4,10
353130,"2022",4,1,7,12
353130,"2023",4,1,6,11
353140,"2015",1,1,2,4
353140,"2016",2,1,2,5
353140,"2018",1,0,5,6
353140,"2019",2,0,0,2
353140,"2020",3,0,1,4
353140,"2021",0,0,2,2
353140,"2022",3,0,1,4
353140,"2023",1,1,0,2
353150,"2015",2,5,15,22
353150,"2016",10,1,16,27
353150,"2017",7,2,15,24
353150,"2018",8,2,10,20
353150,"2019",10,2,10,22
353150,"2020",2,3,13,18
353150,"2021",7,3,9,19
353150,"2022",4,0,13,17
353150,"2023",1,2,12,15
353160,"2018",0,0,1,1
353160,"2019",1,0,0,1
353160,"2020",0,0,1,1
353160,"2021",1,0,0,1
353170,"2015",0,0,1,1
353170,"2018",1,1,0,2
353170,"2019",0,0,1,1
353170,"2021",0,0,1,1
353170,"2022",0,0,3,3
353170,"2023",0,2,0,2
353180,"2015",1,0,8,9
353180,"2016",1,0,3,4
353180,"2017",2,2,9,13
353180,"2018",0,1,1,2
353180,"2019",3,1,3,7
353180,"2020",4,0,6,10
353180,"2021",1,0,2,3
353180,"2022",7,2,3,12
353180,"2023",4,4,8,16
353190,"2015",7,1,14,22
353190,"2016",2,2,13,17
353190,"2017",4,1,7,12
353190,"2018",2,0,8,10
353190,"2019",5,1,8,14
353190,"2020",4,0,5,9
353190,"2021",3,2,13,18
353190,"2022",6,0,8,14
353190,"2023",7,0,10,17
353200,"2015",6,0,2,8
353200,"2016",1,1,5,7
353200,"2017",1,0,2,3
353200,"2018",2,0,3,5
353200,"2019",4,1,5,10
353200,"2020",4,0,3,7
353200,"2021",2,1,3,6
353200,"2022",7,1,2,10
353200,"2023",2,1,0,3
353205,"2015",0,0,1,1
353205,"2016",1,0,2,3
353205,"2017",1,0,1,2
353205,"2018",1,0,1,2
353205,"2019",1,0,1,2
353205,"2020",0,1,1,2
353205,"2021",3,0,1,4
353205,"2022",0,1,0,1
353210,"2015",0,0,2,2
353210,"2016",0,0,2,2
353210,"2017",1,0,0,1
353210,"2018",1,0,1,2
353210,"2019",1,0,0,1
353210,"2020",0,0,2,2
353210,"2022",1,0,0,1
353215,"2017",0,0,2,2
353215,"2018",0,0,2,2
353215,"2022",0,0,1,1
353220,"2015",5,0,3,8
353220,"2016",0,0,5,5
353220,"2017",1,0,2,3
353220,"2018",2,0,2,4
353220,"2019",1,0,4,5
353220,"2020",1,0,3,4
353220,"2022",0,0,1,1
353230,"2015",1,0,2,3
353230,"2016",2,0,2,4
353230,"2017",2,1,1,4
353230,"2018",1,0,4,5
353230,"2019",1,0,1,2
353230,"2020",0,0,3,3
353230,"2021",1,0,1,2
353230,"2022",0,0,2,2
353230,"2023",0,0,1,1
353240,"2015",0,0,1,1
353240,"2016",1,1,1,3
353240,"2017",1,1,1,3
353240,"2018",2,0,1,3
353240,"2019",1,1,1,3
353240,"2020",4,2,4,10
353240,"2021",3,0,3,6
353240,"2022",1,0,5,6
353240,"2023",0,0,4,4
353250,"2015",0,1,0,1
353250,"2016",0,0,1,1
353250,"2017",0,0,1,1
353250,"2019",0,0,3,3
353250,"2020",2,0,0,2
353250,"2021",1,0,0,1
353250,"2023",1,0,1,2
353260,"2015",1,0,0,1
353260,"2016",1,0,1,2
353260,"2017",1,0,4,5
353260,"2019",0,0,1,1
353260,"2021",1,0,0,1
353260,"2022",0,0,1,1
353270,"2015",0,0,1,1
353270,"2018",1,0,3,4
353270,"2019",1,0,1,2
353270,"2021",1,0,0,1
353280,"2015",1,0,0,1
353280,"2017",2,0,1,3
353280,"2018",1,0,1,2
353280,"2019",2,0,0,2
353280,"2021",1,0,1,2
353280,"2023",1,0,1,2
353282,"2015",1,0,2,3
353282,"2016",1,0,4,5
353282,"2017",0,0,1,1
353282,"2018",1,0,1,2
353282,"2019",0,0,1,1
353282,"2020",1,1,0,2
353282,"2021",1,0,1,2
353282,"2022",2,1,0,3
353284,"2015",0,0,1,1
353284,"2018",1,0,1,2
353284,"2019",1,0,0,1
353284,"2021",0,0,1,1
353286,"2015",1,0,0,1
353290,"2015",3,0,3,6
353290,"2016",3,0,1,4
353290,"2017",2,1,1,4
353290,"2018",1,0,4,5
353290,"2019",2,0,3,5
353290,"2020",0,0,2,2
353290,"2021",2,2,4,8
353290,"2022",1,0,3,4
353290,"2023",1,0,2,3
353300,"2015",4,0,3,7
353300,"2016",1,1,2,4
353300,"2017",2,2,6,10
353300,"2018",1,0,5,6
353300,"2019",3,0,5,8
353300,"2020",2,0,5,7
353300,"2021",2,0,2,4
353300,"2022",1,1,0,2
353300,"2023",2,1,2,5
353310,"2019",1,0,0,1
353310,"2020",0,0,1,1
353320,"2015",2,0,2,4
353320,"2016",1,0,3,4
353320,"2017",0,0,1,1
353320,"2018",3,1,2,6
353320,"2019",0,0,1,1
353320,"2021",1,0,0,1
353320,"2022",1,0,0,1
353320,"2023",2,0,1,3
353325,"2015",0,0,2,2
353325,"2016",1,0,1,2
353325,"2017",0,0,1,1
353325,"2019",1,0,1,2
353325,"2020",1,0,1,2
353325,"2021",1,0,3,4
353325,"2023",2,0,0,2
353330,"2015",1,0,0,1
353330,"2023",0,0,1,1
353340,"2015",5,0,10,15
353340,"2016",6,1,8,15
353340,"2017",10,1,12,23
353340,"2018",9,0,10,19
353340,"2019",11,3,16,30
353340,"2020",8,6,10,24
353340,"2021",16,2,9,27
353340,"2022",17,3,12,32
353340,"2023",3,3,5,11
353350,"2015",4,0,5,9
353350,"2016",5,2,10,17
353350,"2017",3,0,7,10
353350,"2018",4,3,11,18
353350,"2019",4,0,9,13
353350,"2020",2,0,5,7
353350,"2021",4,1,7,12
353350,"2022",5,2,7,14
353350,"2023",2,0,5,7
353360,"2015",1,0,0,1
353360,"2016",0,0,3,3
353360,"2017",4,1,1,6
353360,"2018",3,1,1,5
353360,"2019",2,0,5,7
353360,"2020",1,1,1,3
353360,"2021",7,1,4,12
353360,"2022",2,2,4,8
353360,"2023",1,0,0,1
353370,"2015",0,0,2,2
353370,"2016",0,1,0,1
353370,"2017",4,0,0,4
353370,"2018",0,0,3,3
353370,"2022",0,0,1,1
353380,"2016",0,0,4,4
353380,"2017",0,0,1,1
353380,"2018",0,0,1,1
353380,"2019",0,0,2,2
353380,"2020",0,0,3,3
353380,"2023",1,0,0,1
353390,"2015",8,2,19,29
353390,"2016",11,0,25,36
353390,"2017",17,2,32,51
353390,"2018",7,0,20,27
353390,"2019",9,2,21,32
353390,"2020",11,2,16,29
353390,"2021",14,4,24,42
353390,"2022",5,3,12,20
353390,"2023",7,1,8,16
353400,"2015",0,0,1,1
353400,"2016",1,0,1,2
353400,"2020",1,0,1,2
353400,"2021",1,0,2,3
353400,"2022",2,0,0,2
353410,"2015",0,0,1,1
353410,"2016",1,0,2,3
353410,"2017",0,0,3,3
353410,"2018",0,0,1,1
353410,"2021",0,0,3,3
353410,"2022",2,0,0,2
353410,"2023",0,0,2,2
353420,"2016",1,0,0,1
353420,"2017",0,0,1,1
353420,"2022",0,0,1,1
353430,"2015",4,0,17,21
353430,"2016",9,2,15,26
353430,"2017",8,6,16,30
353430,"2018",10,4,10,24
353430,"2019",11,5,13,29
353430,"2020",7,3,13,23
353430,"2021",12,1,16,29
353430,"2022",10,1,19,30
353430,"2023",2,3,5,10
353440,"2015",119,33,214,366
353440,"2016",123,28,204,355
353440,"2017",130,36,228,394
353440,"2018",111,37,187,335
353440,"2019",115,37,184,336
353440,"2020",102,28,152,282
353440,"2021",95,25,153,273
353440,"2022",71,22,130,223
353440,"2023",61,19,100,180
353450,"2016",2,0,0,2
353450,"2017",0,0,1,1
353450,"2019",0,0,2,2
353450,"2022",1,0,0,1
353460,"2015",5,2,6,13
353460,"2016",6,1,12,19
353460,"2017",5,1,10,16
353460,"2018",9,2,12,23
353460,"2019",10,3,4,17
353460,"2020",7,2,9,18
353460,"2021",7,2,6,15
353460,"2022",4,2,8,14
353460,"2023",3,0,2,5
353470,"2015",9,3,19,31
353470,"2016",16,1,19,36
353470,"2017",15,3,21,39
353470,"2018",10,3,21,34
353470,"2019",22,5,26,53
353470,"2020",21,5,26,52
353470,"2021",13,7,31,51
353470,"2022",26,4,33,63
353470,"2023",20,6,20,46
353475,"2015",0,0,3,3
353475,"2016",0,3,1,4
353475,"2017",3,0,4,7
353475,"2018",3,0,1,4
353475,"2019",0,0,2,2
353475,"2020",0,1,2,3
353475,"2021",2,0,0,2
353475,"2023",0,2,2,4
353480,"2015",1,0,3,4
353480,"2016",2,0,7,9
353480,"2017",1,0,3,4
353480,"2018",1,0,2,3
353480,"2019",0,0,4,4
353480,"2021",1,0,1,2
353480,"2022",3,0,1,4
353480,"2023",1,1,1,3
353490,"2015",0,0,4,4
353490,"2017",0,0,2,2
353490,"2019",1,0,0,1
353490,"2020",1,0,0,1
353490,"2021",1,0,1,2
353500,"2016",1,0,0,1
353500,"2017",1,0,1,2
353500,"2018",0,0,2,2
353500,"2019",0,0,3,3
353500,"2020",0,0,2,2
353500,"2021",1,0,0,1
353500,"2022",0,0,1,1
353510,"2015",2,0,2,4
353510,"2016",2,0,4,6
353510,"2017",2,0,2,4
353510,"2018",3,0,1,4
353510,"2019",0,0,2,2
353510,"2020",3,3,3,9
353510,"2021",1,0,1,2
353510,"2022",1,0,5,6
353510,"2023",0,1,1,2
353520,"2015",5,0,2,7
353520,"2016",0,1,5,6
353520,"2018",2,0,2,4
353520,"2019",0,0,1,1
353520,"2020",2,1,1,4
353520,"2021",1,2,0,3
353520,"2022",0,1,2,3
353520,"2023",1,0,3,4
353530,"2015",1,0,0,1
353530,"2021",1,0,2,3
353530,"2022",0,1,0,1
353540,"2015",5,0,4,9
353540,"2016",4,0,6,10
353540,"2017",4,1,18,23
353540,"2018",4,0,6,10
353540,"2019",2,1,4,7
353540,"2020",2,0,3,5
353540,"2021",3,0,4,7
353540,"2022",0,1,1,2
353540,"2023",2,0,3,5
353550,"2015",0,0,1,1
353550,"2016",2,0,6,8
353550,"2017",0,0,5,5
353550,"2018",2,0,4,6
353550,"2019",6,0,9,15
353550,"2020",2,0,9,11
353550,"2021",2,0,7,9
353550,"2022",4,1,9,14
353550,"2023",5,1,8,14
353560,"2015",1,1,4,6
353560,"2016",3,0,7,10
353560,"2017",2,1,2,5
353560,"2018",0,0,4,4
353560,"2019",0,0,1,1
353560,"2020",6,0,4,10
353560,"2021",3,1,2,6
353560,"2022",1,2,2,5
353560,"2023",4,0,3,7
353570,"2015",1,0,1,2
353570,"2016",1,0,0,1
353570,"2019",0,0,2,2
353570,"2022",1,1,0,2
353580,"2016",1,0,0,1
353580,"2017",2,0,2,4
353580,"2018",2,0,2,4
353580,"2019",1,0,3,4
353580,"2020",1,1,2,4
353580,"2021",1,1,2,4
353580,"2022",0,1,1,2
353580,"2023",3,1,3,7
353590,"2015",0,0,1,1
353590,"2017",1,0,0,1
353590,"2018",0,0,1,1
353590,"2020",2,0,1,3
353590,"2021",1,0,2,3
353590,"2022",1,1,1,3
353590,"2023",0,0,1,1
353600,"2015",0,0,1,1
353600,"2017",0,0,1,1
353600,"2018",1,0,1,2
353600,"2019",2,0,3,5
353600,"2020",1,0,0,1
353600,"2021",0,0,3,3
353600,"2022",1,1,3,5
353600,"2023",1,0,3,4
353610,"2015",1,0,3,4
353610,"2016",3,0,4,7
353610,"2017",0,0,2,2
353610,"2018",0,0,2,2
353610,"2019",2,0,1,3
353610,"2020",1,1,5,7
353610,"2021",1,0,1,2
353610,"2022",1,0,3,4
353620,"2015",10,2,9,21
353620,"2016",5,1,15,21
353620,"2017",10,4,5,19
353620,"2018",10,1,9,20
353620,"2019",9,3,16,28
353620,"2020",4,5,10,19
353620,"2021",4,4,11,19
353620,"2022",5,3,5,13
353620,"2023",8,5,9,22
353630,"2015",2,0,5,7
353630,"2016",1,1,1,3
353630,"2017",2,0,5,7
353630,"2018",2,1,2,5
353630,"2019",2,3,7,12
353630,"2020",2,2,3,7
353630,"2021",2,0,7,9
353630,"2022",3,1,7,11
353630,"2023",3,1,2,6
353640,"2015",0,0,3,3
353640,"2016",3,0,6,9
353640,"2017",2,1,2,5
353640,"2018",0,0,4,4
353640,"2019",1,1,1,3
353640,"2020",2,0,1,3
353640,"2021",0,0,3,3
353640,"2022",3,0,1,4
353640,"2023",1,1,2,4
353650,"2015",8,2,9,19
353650,"2016",3,0,3,6
353650,"2017",2,2,2,6
353650,"2018",6,2,3,11
353650,"2019",3,1,1,5
353650,"2020",4,0,3,7
353650,"2021",0,0,1,1
353650,"2022",3,0,3,6
353657,"2015",2,0,0,2
353657,"2019",1,0,0,1
353657,"2020",1,0,0,1
353657,"2021",1,0,0,1
353657,"2022",1,0,2,3
353657,"2023",1,1,0,2
353660,"2016",2,0,0,2
353660,"2017",1,0,0,1
353660,"2018",0,1,0,1
353660,"2019",1,0,0,1
353660,"2021",0,0,1,1
353660,"2022",1,0,0,1
353660,"2023",1,0,0,1
353670,"2015",10,0,16,26
353670,"2016",5,6,11,22
353670,"2017",8,0,11,19
353670,"2018",7,3,16,26
353670,"2019",12,2,12,26
353670,"2020",10,0,15,25
353670,"2021",9,0,6,15
353670,"2022",8,3,17,28
353670,"2023",8,5,8,21
353680,"2015",1,0,0,1
353680,"2016",0,1,2,3
353680,"2017",0,0,2,2
353680,"2018",0,0,2,2
353680,"2019",1,0,1,2
353680,"2021",2,1,3,6
353680,"2022",1,0,1,2
353680,"2023",1,1,2,4
353690,"2016",0,0,1,1
353690,"2019",1,0,0,1
353700,"2015",3,0,6,9
353700,"2016",2,0,6,8
353700,"2017",3,0,7,10
353700,"2018",4,0,0,4
353700,"2019",0,1,3,4
353700,"2020",0,0,7,7
353700,"2021",3,1,8,12
353700,"2022",1,1,3,5
353700,"2023",0,0,2,2
353710,"2015",10,2,14,26
353710,"2016",7,2,17,26
353710,"2017",9,1,12,22
353710,"2018",3,4,7,14
353710,"2019",5,1,8,14
353710,"2020",8,1,6,15
353710,"2021",6,1,7,14
353710,"2022",4,1,2,7
353710,"2023",5,0,5,10
353715,"2015",0,0,1,1
353715,"2017",0,0,1,1
353715,"2018",2,0,0,2
353715,"2019",0,0,1,1
353715,"2020",1,0,0,1
353715,"2021",0,0,1,1
353715,"2022",1,0,1,2
353720,"2015",6,1,1,8
353720,"2016",4,2,4,10
353720,"2017",1,1,2,4
353720,"2018",2,2,7,11
353720,"2019",1,2,10,13
353720,"2020",0,2,5,7
353720,"2021",1,0,0,1
353720,"2022",3,1,5,9
353720,"2023",1,0,1,2
353730,"2015",4,2,5,11
353730,"2016",2,1,2,5
353730,"2018",0,0,1,1
353730,"2019",1,0,0,1
353730,"2020",1,0,1,2
353730,"2021",2,0,2,4
353730,"2022",1,0,1,2
353730,"2023",0,0,1,1
353740,"2015",0,0,1,1
353740,"2016",0,1,2,3
353740,"2017",2,0,1,3
353740,"2020",1,0,1,2
353740,"2021",0,0,1,1
353740,"2022",2,0,3,5
353740,"2023",2,2,0,4
353750,"2015",1,0,4,5
353750,"2016",1,1,1,3
353750,"2017",2,1,2,5
353750,"2018",3,0,0,3
353750,"2019",0,0,1,1
353750,"2020",0,1,0,1
353750,"2021",3,0,1,4
353750,"2022",1,1,3,5
353750,"2023",0,0,1,1
353760,"2015",26,9,42,77
353760,"2016",29,10,50,89
353760,"2017",22,3,34,59
353760,"2018",19,5,33,57
353760,"2019",26,9,44,79
353760,"2020",17,5,20,42
353760,"2021",2,0,6,8
353760,"2022",19,3,21,43
353760,"2023",8,3,10,21
353770,"2017",0,0,1,1
353770,"2019",0,0,1,1
353770,"2021",0,0,2,2
353770,"2023",0,1,0,1
353780,"2015",1,0,1,2
353780,"2016",0,1,1,2
353780,"2017",3,0,1,4
353780,"2018",1,0,3,4
353780,"2019",4,0,7,11
353780,"2020",1,1,3,5
353780,"2021",1,0,4,5
353780,"2022",1,0,2,3
353780,"2023",2,1,3,6
353790,"2015",15,1,7,23
353790,"2016",3,0,11,14
353790,"2017",3,5,21,29
353790,"2018",7,3,9,19
353790,"2019",1,1,7,9
353790,"2020",4,0,5,9
353790,"2021",4,1,7,12
353790,"2022",7,0,8,15
353790,"2023",5,1,14,20
353800,"2015",36,7,59,102
353800,"2016",36,9,43,88
353800,"2017",54,13,78,145
353800,"2018",31,14,65,110
353800,"2019",33,5,39,77
353800,"2020",13,3,24,40
353800,"2021",7,3,12,22
353800,"2022",15,5,20,40
353800,"2023",13,3,18,34
353810,"2015",1,0,5,6
353810,"2016",0,0,2,2
353810,"2017",1,1,4,6
353810,"2018",0,0,3,3
353810,"2019",1,1,1,3
353810,"2020",4,0,3,7
353810,"2021",1,0,4,5
353810,"2022",1,0,2,3
353810,"2023",0,0,2,2
353820,"2016",1,0,1,2
353820,"2017",3,0,0,3
353820,"2018",0,1,3,4
353820,"2019",1,2,3,6
353820,"2020",5,1,3,9
353820,"2021",1,1,0,2
353820,"2022",0,0,2,2
353820,"2023",1,0,2,3
353830,"2015",0,0,1,1
353830,"2016",1,0,0,1
353830,"2019",1,0,3,4
353830,"2021",1,0,0,1
353830,"2022",0,0,1,1
353830,"2023",2,0,0,2
353850,"2016",1,0,0,1
353850,"2017",1,0,4,5
353850,"2018",2,2,3,7
353850,"2019",1,1,2,4
353850,"2020",1,0,1,2
353850,"2021",1,0,1,2
353850,"2022",1,1,1,3
353850,"2023",0,0,2,2
353860,"2015",3,2,11,16
353860,"2016",4,0,7,11
353860,"2017",10,6,6,22
353860,"2018",4,1,8,13
353860,"2019",2,1,12,15
353860,"2020",9,0,8,17
353860,"2021",6,4,6,16
353860,"2022",5,4,6,15
353860,"2023",2,2,2,6
353870,"2015",38,10,70,118
353870,"2016",53,12,75,140
353870,"2017",65,14,95,174
353870,"2018",68,11,70,149
353870,"2019",63,17,89,169
353870,"2020",43,19,65,127
353870,"2021",65,22,68,155
353870,"2022",64,18,90,172
353870,"2023",40,15,67,122
353880,"2015",4,7,13,24
353880,"2016",7,3,8,18
353880,"2017",5,2,11,18
353880,"2018",6,3,11,20
353880,"2019",6,3,6,15
353880,"2020",4,1,8,13
353880,"2021",4,1,8,13
353880,"2022",9,2,9,20
353880,"2023",4,2,8,14
353890,"2015",2,0,5,7
353890,"2016",3,0,5,8
353890,"2017",2,0,1,3
353890,"2018",2,1,4,7
353890,"2019",1,1,4,6
353890,"2020",3,0,3,6
353890,"2021",1,0,5,6
353890,"2022",1,0,1,2
353890,"2023",3,0,4,7
353900,"2015",0,0,2,2
353900,"2016",1,1,3,5
353900,"2017",2,1,3,6
353900,"2018",1,0,0,1
353900,"2019",1,0,1,2
353900,"2020",0,0,3,3
353900,"2021",1,0,1,2
353900,"2022",1,0,3,4
353900,"2023",0,0,1,1
353910,"2015",0,1,4,5
353910,"2016",4,1,11,16
353910,"2017",2,1,8,11
353910,"2018",3,2,7,12
353910,"2019",6,2,5,13
353910,"2020",1,1,3,5
353910,"2021",2,1,1,4
353910,"2022",1,0,3,4
353910,"2023",4,1,1,6
353920,"2015",2,1,9,12
353920,"2016",6,1,6,13
353920,"2017",9,4,6,19
353920,"2018",3,2,5,10
353920,"2019",6,3,5,14
353920,"2020",3,2,8,13
353920,"2021",4,2,3,9
353920,"2022",2,1,4,7
353920,"2023",1,2,1,4
353930,"2015",7,4,15,26
353930,"2016",8,1,11,20
353930,"2017",13,6,17,36
353930,"2018",15,7,32,54
353930,"2019",13,5,24,42
353930,"2020",7,2,17,26
353930,"2021",7,3,16,26
353930,"2022",7,1,20,28
353930,"2023",3,2,9,14
353940,"2015",3,0,3,6
353940,"2016",0,0,1,1
353940,"2017",1,0,2,3
353940,"2018",3,1,1,5
353940,"2019",0,0,2,2
353940,"2020",6,0,2,8
353940,"2021",0,0,3,3
353940,"2022",0,0,1,1
353940,"2023",1,0,3,4
353950,"2015",3,2,5,10
353950,"2016",1,0,4,5
353950,"2017",3,0,5,8
353950,"2018",4,0,6,10
353950,"2019",6,2,2,10
353950,"2020",4,2,6,12
353950,"2021",5,3,4,12
353950,"2022",3,1,10,14
353950,"2023",3,0,6,9
353960,"2015",0,0,2,2
353960,"2016",1,0,1,2
353960,"2018",0,0,1,1
353960,"2019",0,1,0,1
353960,"2020",0,0,1,1
353960,"2021",0,0,1,1
353970,"2015",0,0,1,1
353970,"2016",1,0,1,2
353970,"2017",0,0,3,3
353970,"2018",1,0,1,2
353970,"2020",0,1,1,2
353970,"2021",0,0,1,1
353970,"2022",0,2,0,2
353970,"2023",1,1,1,3
353980,"2015",17,1,33,51
353980,"2016",18,3,32,53
353980,"2017",21,5,30,56
353980,"2018",23,8,36,67
353980,"2019",14,5,39,58
353980,"2020",13,6,25,44
353980,"2021",28,3,26,57
353980,"2022",13,5,18,36
353980,"2023",11,2,22,35
353990,"2015",0,0,2,2
353990,"2017",1,0,0,1
353990,"2018",1,0,2,3
353990,"2019",1,0,0,1
354000,"2015",0,0,2,2
354000,"2017",0,0,2,2
354000,"2018",0,0,2,2
354000,"2019",1,0,3,4
354000,"2020",1,0,1,2
354000,"2021",1,0,2,3
354000,"2022",2,1,1,4
354000,"2023",1,0,0,1
354010,"2019",0,1,1,2
354010,"2022",1,1,0,2
354020,"2015",2,3,18,23
354020,"2016",9,1,16,26
354020,"2017",4,1,11,16
354020,"2018",4,0,7,11
354020,"2019",3,0,4,7
354020,"2020",4,2,8,14
354020,"2021",5,0,9,14
354020,"2022",5,4,7,16
354020,"2023",5,2,9,16
354025,"2015",1,0,3,4
354025,"2016",0,0,2,2
354025,"2018",0,0,1,1
354025,"2019",0,1,1,2
354025,"2020",0,1,4,5
354025,"2021",3,1,1,5
354025,"2022",1,0,0,1
354025,"2023",0,1,3,4
354030,"2018",0,0,1,1
354030,"2019",0,0,1,1
354040,"2015",1,0,0,1
354040,"2017",0,0,3,3
354040,"2018",0,1,1,2
354040,"2019",0,0,1,1
354040,"2020",0,0,4,4
354050,"2015",3,0,2,5
354050,"2016",3,2,6,11
354050,"2017",1,1,4,6
354050,"2018",1,0,3,4
354050,"2019",1,0,2,3
354050,"2021",5,0,2,7
354050,"2022",2,0,5,7
354050,"2023",0,0,2,2
354060,"2015",11,4,29,44
354060,"2016",5,0,13,18
354060,"2017",4,3,17,24
354060,"2018",9,1,7,17
354060,"2019",2,0,6,8
354060,"2020",9,2,13,24
354060,"2021",6,1,9,16
354060,"2022",2,0,8,10
354060,"2023",2,1,4,7
354070,"2015",12,4,21,37
354070,"2016",7,4,21,32
354070,"2017",11,1,25,37
354070,"2018",8,5,20,33
354070,"2019",15,6,17,38
354070,"2020",8,1,23,32
354070,"2021",6,5,9,20
354070,"2022",12,2,14,28
354070,"2023",4,6,9,19
354075,"2015",3,1,5,9
354075,"2016",5,1,9,15
354075,"2017",1,1,2,4
354075,"2018",2,0,6,8
354075,"2019",3,1,3,7
354075,"2020",1,1,5,7
354075,"2021",2,1,2,5
354075,"2022",1,1,4,6
354075,"2023",0,1,1,2
354080,"2015",1,0,0,1
354080,"2016",0,0,2,2
354080,"2017",2,0,5,7
354080,"2018",1,0,0,1
354080,"2019",1,0,3,4
354080,"2021",0,0,2,2
354080,"2022",2,0,1,3
354080,"2023",0,2,2,4
354085,"2018",1,2,1,4
354085,"2019",1,0,0,1
354085,"2020",1,0,0,1
354085,"2021",1,0,0,1
354090,"2015",0,0,10,10
354090,"2016",2,1,4,7
354090,"2017",6,2,3,11
354090,"2018",0,0,3,3
354090,"2019",0,0,1,1
354090,"2020",1,0,2,3
354090,"2021",0,1,4,5
354090,"2022",1,0,2,3
354090,"2023",0,0,3,3
354100,"2015",76,17,99,192
354100,"2016",68,10,74,152
354100,"2017",70,11,85,166
354100,"2018",77,17,103,197
354100,"2019",57,25,77,159
354100,"2020",51,15,71,137
354100,"2021",48,20,118,186
354100,"2022",46,20,98,164
354100,"2023",48,18,73,139
354105,"2015",0,2,2,4
354105,"2016",0,1,2,3
354105,"2017",1,0,1,2
354105,"2018",2,0,1,3
354105,"2019",0,1,1,2
354105,"2020",1,0,0,1
354105,"2021",0,0,1,1
354105,"2022",2,1,0,3
354105,"2023",0,0,1,1
354110,"2015",1,0,0,1
354110,"2016",1,0,0,1
354110,"2017",0,0,1,1
354110,"2020",1,0,1,2
354110,"2021",1,0,0,1
354110,"2022",0,0,1,1
354110,"2023",0,0,2,2
354120,"2015",1,1,1,3
354120,"2016",2,0,1,3
354120,"2017",1,0,3,4
354120,"2018",0,0,5,5
354120,"2019",2,2,4,8
354120,"2020",2,0,1,3
354120,"2021",2,0,1,3
354120,"2022",0,1,2,3
354120,"2023",0,0,1,1
354130,"2015",5,0,12,17
354130,"2016",4,1,7,12
354130,"2017",9,0,9,18
354130,"2018",6,1,17,24
354130,"2019",11,0,12,23
354130,"2020",3,2,4,9
354130,"2021",7,1,8,16
354130,"2022",2,0,8,10
354130,"2023",1,0,5,6
354140,"2015",49,11,91,151
354140,"2016",40,15,64,119
354140,"2017",48,13,67,128
354140,"2018",39,11,61,111
354140,"2019",52,20,60,132
354140,"2020",33,12,63,108
354140,"2021",32,10,52,94
354140,"2022",26,9,36,71
354140,"2023",22,8,39,69
354150,"2015",13,0,21,34
354150,"2016",9,1,20,30
354150,"2017",6,6,18,30
354150,"2018",14,4,7,25
354150,"2019",7,2,7,16
354150,"2020",6,3,4,13
354150,"2021",4,2,7,13
354150,"2022",11,4,15,30
354150,"2023",10,0,9,19
354160,"2015",3,0,2,5
354160,"2016",1,1,9,11
354160,"2017",5,0,7,12
354160,"2018",3,1,4,8
354160,"2019",4,2,5,11
354160,"2020",5,3,13,21
354160,"2021",6,2,9,17
354160,"2022",7,0,4,11
354160,"2023",4,1,10,15
354165,"2015",1,0,2,3
354165,"2020",0,0,1,1
354165,"2021",2,0,1,3
354165,"2022",0,0,1,1
354165,"2023",1,0,1,2
354170,"2015",0,1,3,4
354170,"2016",1,0,0,1
354170,"2017",0,1,2,3
354170,"2018",0,0,1,1
354170,"2019",0,0,3,3
354170,"2020",0,1,0,1
354170,"2022",2,0,1,3
354180,"2015",0,0,1,1
354180,"2017",1,0,0,1
354180,"2018",0,0,2,2
354180,"2019",1,0,2,3
354180,"2020",0,0,1,1
354180,"2022",0,0,1,1
354190,"2015",0,3,3,6
354190,"2016",2,1,3,6
354190,"2017",1,0,3,4
354190,"2019",0,1,0,1
354200,"2015",1,0,2,3
354200,"2016",0,0,1,1
354200,"2018",0,0,1,1
354200,"2021",0,0,1,1
354200,"2022",0,0,2,2
354200,"2023",1,0,0,1
354210,"2015",1,0,3,4
354210,"2016",1,0,0,1
354210,"2017",1,0,2,3
354210,"2018",1,0,1,2
354210,"2019",0,1,0,1
354210,"2020",0,0,2,2
354210,"2022",1,0,2,3
354220,"2015",1,0,9,10
354220,"2016",0,0,3,3
354220,"2017",2,0,0,2
354220,"2018",1,0,4,5
354220,"2019",2,0,3,5
354220,"2020",2,0,1,3
354220,"2021",1,0,1,2
354220,"2022",2,1,4,7
354220,"2023",2,1,2,5
354230,"2015",0,1,2,3
354230,"2016",2,0,0,2
354230,"2017",0,0,2,2
354230,"2019",0,0,1,1
354230,"2020",1,0,1,2
354230,"2021",0,0,1,1
354230,"2023",0,0,1,1
354240,"2015",3,1,5,9
354240,"2016",3,0,4,7
354240,"2017",3,1,5,9
354240,"2018",3,2,3,8
354240,"2019",2,0,5,7
354240,"2020",2,2,2,6
354240,"2021",0,2,2,4
354240,"2022",0,0,4,4
354240,"2023",0,1,6,7
354250,"2015",1,0,1,2
354250,"2016",2,0,1,3
354250,"2018",1,0,2,3
354250,"2019",0,0,2,2
354250,"2020",2,0,1,3
354250,"2021",2,0,0,2
354250,"2022",0,0,2,2
354250,"2023",1,1,0,2
354260,"2015",15,6,23,44
354260,"2016",13,8,37,58
354260,"2017",21,7,40,68
354260,"2018",18,8,42,68
354260,"2019",19,9,26,54
354260,"2020",15,6,29,50
354260,"2021",12,4,20,36
354260,"2022",20,6,19,45
354260,"2023",11,6,21,38
354270,"2015",1,0,1,2
354270,"2016",0,0,3,3
354270,"2017",1,2,2,5
354270,"2018",2,0,2,4
354270,"2019",3,0,2,5
354270,"2020",0,0,2,2
354270,"2021",3,2,3,8
354270,"2022",1,2,4,7
354270,"2023",0,1,0,1
354280,"2015",0,1,3,4
354280,"2016",1,0,0,1
354280,"2017",0,0,3,3
354280,"2019",0,1,2,3
354280,"2020",1,0,0,1
354280,"2021",0,1,1,2
354280,"2022",0,0,1,1
354290,"2015",1,0,11,12
354290,"2016",3,1,3,7
354290,"2017",2,1,2,5
354290,"2018",0,0,3,3
354290,"2020",1,0,2,3
354290,"2022",1,0,2,3
354290,"2023",0,1,3,4
354300,"2015",4,1,4,9
354300,"2016",3,0,5,8
354300,"2017",5,0,2,7
354300,"2018",3,2,2,7
354300,"2019",2,0,6,8
354300,"2020",0,0,2,2
354300,"2021",0,1,0,1
354300,"2022",0,0,1,1
354300,"2023",2,0,1,3
354310,"2015",0,1,2,3
354310,"2016",0,1,2,3
354310,"2017",2,0,5,7
354310,"2018",0,0,3,3
354310,"2019",1,1,2,4
354310,"2020",1,0,1,2
354310,"2021",2,1,0,3
354310,"2022",0,0,1,1
354310,"2023",1,0,1,2
354320,"2020",1,0,1,2
354320,"2022",0,0,1,1
354323,"2017",1,0,0,1
354325,"2015",0,0,8,8
354325,"2016",1,0,4,5
354325,"2017",2,0,2,4
354325,"2018",0,0,1,1
354325,"2019",1,1,0,2
354325,"2023",1,0,0,1
354330,"2015",19,5,25,49
354330,"2016",17,3,18,38
354330,"2017",21,3,30,54
354330,"2018",20,8,27,55
354330,"2019",15,8,30,53
354330,"2020",28,8,27,63
354330,"2021",10,4,18,32
354330,"2022",19,3,27,49
354330,"2023",8,2,22,32
354340,"2015",90,18,153,261
354340,"2016",99,24,163,286
354340,"2017",115,23,166,304
354340,"2018",83,32,132,247
354340,"2019",109,27,161,297
354340,"2020",95,33,134,262
354340,"2021",89,32,112,233
354340,"2022",66,29,109,204
354340,"2023",60,10,84,154
354350,"2015",0,0,3,3
354350,"2019",0,0,1,1
354350,"2021",0,1,0,1
354350,"2022",0,0,2,2
354360,"2015",2,0,3,5
354360,"2016",0,0,2,2
354360,"2019",0,0,1,1
354360,"2020",0,0,1,1
354360,"2022",2,0,0,2
354370,"2015",1,1,1,3
354370,"2016",0,0,6,6
354370,"2017",3,0,2,5
354370,"2018",1,1,6,8
354370,"2019",2,1,5,8
354370,"2020",1,1,3,5
354370,"2021",0,0,4,4
354370,"2022",0,0,1,1
354370,"2023",0,0,1,1
354380,"2015",0,0,3,3
354380,"2016",0,1,1,2
354380,"2017",2,0,1,3
354380,"2018",2,0,0,2
354380,"2019",2,1,0,3
354380,"2020",0,0,1,1
354380,"2021",0,0,4,4
354380,"2022",0,0,1,1
354380,"2023",1,0,2,3
354390,"2015",30,8,62,100
354390,"2016",37,9,68,114
354390,"2017",36,8,69,113
354390,"2018",34,13,46,93
354390,"2019",36,7,54,97
354390,"2020",31,9,46,86
354390,"2021",8,1,11,20
354390,"2022",7,2,11,20
354390,"2023",9,1,17,27
354400,"2015",0,0,2,2
354400,"2016",2,0,3,5
354400,"2017",1,0,4,5
354400,"2018",4,1,7,12
354400,"2019",9,0,16,25
354400,"2020",3,2,7,12
354400,"2021",2,2,2,6
354400,"2022",4,1,6,11
354400,"2023",2,1,5,8
354410,"2015",9,2,21,32
354410,"2016",9,2,14,25
354410,"2017",5,0,10,15
354410,"2018",8,2,15,25
354410,"2019",7,2,12,21
354410,"2020",8,3,12,23
354410,"2021",7,2,10,19
354410,"2022",6,3,9,18
354410,"2023",2,4,7,13
354420,"2017",0,0,2,2
354420,"2018",1,0,1,2
354420,"2021",0,0,1,1
354420,"2023",3,0,3,6
354425,"2015",3,1,3,7
354425,"2016",5,0,7,12
354425,"2017",3,1,9,13
354425,"2018",2,2,2,6
354425,"2019",3,0,5,8
354425,"2020",2,0,2,4
354425,"2021",2,0,2,4
354425,"2022",2,0,5,7
354425,"2023",0,0,1,1
354430,"2015",0,2,3,5
354430,"2016",1,0,1,2
354430,"2018",0,0,1,1
354430,"2019",0,1,0,1
354430,"2020",1,0,2,3
354430,"2021",1,1,1,3
354430,"2022",1,3,0,4
354430,"2023",2,0,3,5
354440,"2016",0,0,1,1
354440,"2017",0,0,1,1
354440,"2020",1,0,0,1
354440,"2023",0,0,1,1
354450,"2015",1,0,3,4
354450,"2017",0,0,1,1
354450,"2018",0,0,2,2
354450,"2019",0,0,1,1
354450,"2020",2,0,0,2
354450,"2023",0,0,1,1
354460,"2015",1,0,0,1
354460,"2017",2,0,0,2
354460,"2019",1,1,0,2
354460,"2020",0,1,0,1
354460,"2021",0,0,1,1
354460,"2022",1,0,3,4
354460,"2023",0,1,0,1
354470,"2016",0,0,2,2
354470,"2017",0,0,2,2
354470,"2018",0,0,1,1
354470,"2019",0,0,1,1
354470,"2020",0,0,1,1
354470,"2021",1,1,0,2
354470,"2022",1,0,1,2
354470,"2023",1,0,2,3
354480,"2015",1,0,1,2
354480,"2016",1,0,0,1
354480,"2017",0,0,1,1
354480,"2019",0,0,1,1
354480,"2020",1,0,1,2
354480,"2021",1,0,0,1
354480,"2023",0,0,1,1
354490,"2015",3,1,1,5
354490,"2016",0,0,1,1
354490,"2017",1,1,1,3
354490,"2018",2,0,2,4
354490,"2021",0,1,1,2
354490,"2022",1,1,0,2
354500,"2015",5,1,8,14
354500,"2016",4,1,6,11
354500,"2017",3,5,3,11
354500,"2018",2,1,2,5
354500,"2019",1,0,2,3
354500,"2020",1,0,2,3
354500,"2021",3,1,5,9
354500,"2022",2,0,1,3
354500,"2023",2,0,4,6
354510,"2015",0,1,1,2
354510,"2016",0,0,2,2
354510,"2018",3,1,1,5
354510,"2019",1,0,1,2
354510,"2020",0,0,3,3
354510,"2021",3,2,1,6
354510,"2022",1,1,2,4
354510,"2023",1,0,1,2
354515,"2015",0,0,2,2
354515,"2017",1,0,3,4
354515,"2018",0,0,1,1
354515,"2019",2,0,2,4
354515,"2020",2,1,2,5
354515,"2021",1,0,1,2
354515,"2022",1,0,2,3
354515,"2023",1,0,2,3
354520,"2015",14,2,34,50
354520,"2016",15,7,35,57
354520,"2017",31,9,31,71
354520,"2018",21,11,36,68
354520,"2019",34,12,49,95
354520,"2020",48,14,47,109
354520,"2021",31,18,35,84
354520,"2022",27,17,52,96
354520,"2023",18,5,30,53
354530,"2015",5,2,9,16
354530,"2016",3,2,7,12
354530,"2017",8,3,10,21
354530,"2018",8,2,14,24
354530,"2019",6,4,5,15
354530,"2020",3,2,9,14
354530,"2021",11,3,21,35
354530,"2022",9,0,11,20
354530,"2023",3,0,3,6
354540,"2015",2,1,6,9
354540,"2016",2,0,2,4
354540,"2017",0,0,1,1
354540,"2018",2,0,6,8
354540,"2019",2,0,6,8
354540,"2020",3,0,4,7
354540,"2021",1,0,1,2
354540,"2022",1,0,3,4
354540,"2023",0,1,0,1
354550,"2015",0,0,1,1
354550,"2016",1,0,3,4
354550,"2017",0,0,1,1
354550,"2019",3,1,0,4
354550,"2020",0,0,1,1
354550,"2022",1,0,1,2
354560,"2015",0,0,4,4
354560,"2016",1,0,4,5
354560,"2017",1,0,2,3
354560,"2018",1,0,4,5
354560,"2019",1,0,1,2
354560,"2020",1,1,2,4
354560,"2021",1,0,0,1
354560,"2022",0,0,1,1
354560,"2023",0,0,2,2
354570,"2015",0,0,4,4
354570,"2016",1,0,5,6
354570,"2017",2,0,2,4
354570,"2018",0,0,2,2
354570,"2019",1,0,0,1
354570,"2020",1,0,2,3
354570,"2021",1,1,2,4
354570,"2023",1,0,4,5
354580,"2015",13,1,22,36
354580,"2016",13,0,11,24
354580,"2017",7,2,20,29
354580,"2018",4,3,12,19
354580,"2019",8,3,15,26
354580,"2020",8,3,9,20
354580,"2021",4,1,6,11
354580,"2022",6,0,10,16
354580,"2023",14,4,21,39
354600,"2015",1,0,2,3
354600,"2016",3,0,4,7
354600,"2017",0,0,2,2
354600,"2018",1,0,5,6
354600,"2019",0,0,2,2
354600,"2021",3,0,4,7
354600,"2022",2,0,0,2
354600,"2023",1,0,0,1
354610,"2015",1,0,1,2
354610,"2017",0,0,1,1
354610,"2018",1,0,0,1
354610,"2019",0,0,1,1
354610,"2021",0,1,0,1
354610,"2022",0,0,1,1
354610,"2023",0,0,1,1
354620,"2016",1,0,0,1
354620,"2018",3,0,1,4
354620,"2019",0,0,1,1
354620,"2021",0,0,1,1
354620,"2023",1,0,0,1
354625,"2015",0,0,1,1
354625,"2018",2,0,0,2
354625,"2019",0,1,0,1
354625,"2021",0,0,1,1
354630,"2015",6,0,11,17
354630,"2016",6,1,4,11
354630,"2017",1,2,11,14
354630,"2018",9,2,14,25
354630,"2019",9,1,5,15
354630,"2020",10,0,6,16
354630,"2021",3,0,10,13
354630,"2022",10,5,10,25
354630,"2023",7,2,4,13
354640,"2015",5,3,16,24
354640,"2016",9,1,17,27
354640,"2017",11,3,19,33
354640,"2018",8,1,19,28
354640,"2019",5,6,11,22
354640,"2020",7,2,8,17
354640,"2021",6,2,7,15
354640,"2022",5,1,10,16
354640,"2023",6,0,10,16
354650,"2015",0,0,1,1
354650,"2016",1,0,0,1
354650,"2017",0,0,2,2
354650,"2018",0,0,1,1
354650,"2019",0,0,2,2
354650,"2020",1,0,1,2
354650,"2021",0,1,3,4
354650,"2022",2,0,2,4
354650,"2023",2,0,0,2
354660,"2015",3,1,9,13
354660,"2016",5,1,10,16
354660,"2017",2,4,3,9
354660,"2018",8,1,7,16
354660,"2019",6,2,4,12
354660,"2020",1,2,7,10
354660,"2021",1,0,8,9
354660,"2022",3,4,8,15
354660,"2023",4,1,4,9
354670,"2015",5,0,6,11
354670,"2016",3,1,10,14
354670,"2017",3,3,10,16
354670,"2018",5,1,6,12
354670,"2019",5,1,9,15
354670,"2020",1,1,8,10
354670,"2021",0,0,3,3
354670,"2022",0,0,2,2
354670,"2023",0,0,3,3
354680,"2015",12,8,41,61
354680,"2016",25,3,49,77
354680,"2017",20,6,29,55
354680,"2018",9,3,18,30
354680,"2019",14,3,34,51
354680,"2020",9,3,25,37
354680,"2021",12,5,26,43
354680,"2022",18,7,37,62
354680,"2023",17,7,25,49
354690,"2015",1,1,3,5
354690,"2016",0,0,5,5
354690,"2017",1,0,4,5
354690,"2018",0,1,2,3
354690,"2019",0,0,2,2
354690,"2020",0,0,1,1
354690,"2021",1,0,3,4
354690,"2022",0,0,2,2
354700,"2015",0,0,3,3
354700,"2016",0,0,4,4
354700,"2017",2,1,3,6
354700,"2018",2,0,2,4
354700,"2019",2,0,3,5
354700,"2020",1,0,2,3
354700,"2021",3,0,3,6
354700,"2022",0,0,2,2
354700,"2023",1,0,0,1
354710,"2017",0,1,1,2
354710,"2018",0,0,1,1
354710,"2022",0,0,1,1
354720,"2015",0,0,1,1
354720,"2016",0,0,1,1
354720,"2021",2,0,2,4
354730,"2015",22,9,40,71
354730,"2016",21,6,38,65
354730,"2017",22,8,42,72
354730,"2018",38,12,40,90
354730,"2019",31,5,43,79
354730,"2020",19,3,34,56
354730,"2021",23,5,25,53
354730,"2022",29,6,30,65
354730,"2023",8,1,16,25
354740,"2015",1,1,0,2
354740,"2016",1,1,1,3
354740,"2017",1,0,0,1
354740,"2018",2,0,0,2
354740,"2021",0,0,1,1
354740,"2023",1,0,0,1
354750,"2015",3,1,5,9
354750,"2016",2,0,1,3
354750,"2017",0,0,2,2
354750,"2018",3,0,1,4
354750,"2019",0,0,2,2
354750,"2020",1,0,0,1
354750,"2021",1,1,0,2
354750,"2022",0,1,0,1
354750,"2023",2,1,2,5
354760,"2015",4,0,6,10
354760,"2016",3,0,8,11
354760,"2017",6,0,1,7
354760,"2018",4,0,7,11
354760,"2019",5,2,6,13
354760,"2020",1,1,7,9
354760,"2021",2,0,4,6
354760,"2022",3,2,7,12
354760,"2023",0,1,1,2
354765,"2015",0,1,1,2
354765,"2016",0,0,1,1
354765,"2017",0,0,1,1
354765,"2020",0,0,2,2
354765,"2021",0,0,1,1
354765,"2022",0,0,2,2
354765,"2023",0,0,2,2
354770,"2015",2,2,5,9
354770,"2016",3,0,3,6
354770,"2017",5,0,3,8
354770,"2018",4,1,5,10
354770,"2019",2,1,4,7
354770,"2020",2,1,3,6
354770,"2021",2,0,6,8
354770,"2022",0,1,5,6
354770,"2023",1,0,5,6
354780,"2015",91,23,157,271
354780,"2016",126,24,203,353
354780,"2017",117,32,169,318
354780,"2018",84,20,154,258
354780,"2019",81,30,127,238
354780,"2020",75,21,120,216
354780,"2021",75,25,107,207
354780,"2022",68,17,103,188
354780,"2023",49,9,89,147
354790,"2015",1,0,0,1
354790,"2016",1,0,1,2
354790,"2017",2,0,2,4
354790,"2018",0,0,1,1
354790,"2019",0,0,1,1
354790,"2020",0,0,2,2
354790,"2021",0,0,2,2
354790,"2022",2,0,1,3
354790,"2023",0,0,2,2
354800,"2015",0,0,3,3
354800,"2016",2,0,4,6
354800,"2017",0,1,1,2
354800,"2018",1,0,2,3
354800,"2019",3,1,0,4
354800,"2020",2,0,4,6
354800,"2021",3,1,4,8
354800,"2022",2,0,5,7
354800,"2023",0,0,2,2
354805,"2015",1,0,3,4
354805,"2017",1,0,1,2
354805,"2020",1,0,1,2
354805,"2021",0,0,1,1
354805,"2022",0,1,2,3
354805,"2023",0,1,0,1
354810,"2017",0,1,2,3
354810,"2019",4,0,1,5
354810,"2020",1,1,2,4
354810,"2021",0,1,2,3
354810,"2022",0,1,0,1
354810,"2023",0,1,1,2
354820,"2015",0,1,4,5
354820,"2019",2,0,0,2
354820,"2020",0,1,0,1
354820,"2021",0,1,0,1
354820,"2022",3,0,0,3
354830,"2015",3,0,1,4
354830,"2017",0,0,1,1
354830,"2018",1,0,1,2
354830,"2019",1,0,0,1
354830,"2020",0,0,1,1
354830,"2022",1,0,0,1
354840,"2015",0,0,1,1
354840,"2016",1,0,1,2
354840,"2019",1,0,1,2
354840,"2020",0,0,1,1
354840,"2021",0,0,1,1
354840,"2022",0,0,1,1
354850,"2015",60,20,79,159
354850,"2016",46,8,61,115
354850,"2017",59,20,70,149
354850,"2018",47,12,85,144
354850,"2019",37,16,60,113
354850,"2020",35,9,46,90
354850,"2021",38,7,53,98
354850,"2022",35,7,70,112
354850,"2023",20,8,28,56
354860,"2015",6,1,7,14
354860,"2016",1,2,6,9
354860,"2017",3,0,2,5
354860,"2018",0,1,1,2
354860,"2019",1,1,3,5
354860,"2020",0,0,1,1
354860,"2021",1,2,3,6
354860,"2022",1,0,1,2
354860,"2023",0,0,1,1
354870,"2015",135,48,261,444
354870,"2016",150,40,232,422
354870,"2017",136,46,228,410
354870,"2018",151,31,229,411
354870,"2019",135,38,209,382
354870,"2020",112,41,191,344
354870,"2021",102,45,200,347
354870,"2022",111,49,179,339
354870,"2023",104,39,150,293
354880,"2015",4,0,3,7
354880,"2016",7,2,12,21
354880,"2017",3,7,8,18
354880,"2018",10,2,4,16
354880,"2019",6,3,21,30
354880,"2020",17,4,14,35
354880,"2021",16,4,16,36
354880,"2022",10,5,14,29
354880,"2023",20,3,10,33
354890,"2015",58,16,105,179
354890,"2016",45,8,94,147
354890,"2017",45,5,97,147
354890,"2018",57,15,91,163
354890,"2019",43,14,79,136
354890,"2020",38,20,51,109
354890,"2021",36,12,61,109
354890,"2022",42,8,64,114
354890,"2023",38,11,63,112
354900,"2015",0,0,2,2
354900,"2016",0,0,2,2
354900,"2018",1,0,0,1
354900,"2019",1,0,0,1
354900,"2021",2,0,0,2
354900,"2022",0,0,1,1
354900,"2023",0,0,1,1
354910,"2015",13,4,24,41
354910,"2016",15,1,15,31
354910,"2017",8,0,12,20
354910,"2018",15,5,22,42
354910,"2019",13,8,13,34
354910,"2020",11,5,13,29
354910,"2021",10,4,13,27
354910,"2022",12,2,19,33
354910,"2023",9,2,4,15
354920,"2015",1,0,0,1
354920,"2016",1,0,0,1
354920,"2018",0,0,1,1
354920,"2023",0,0,1,1
354925,"2017",1,0,1,2
354925,"2018",0,1,0,1
354925,"2019",1,0,2,3
354925,"2021",0,0,1,1
354925,"2022",0,0,1,1
354925,"2023",0,0,1,1
354930,"2015",0,0,1,1
354930,"2020",1,0,0,1
354940,"2015",6,1,8,15
354940,"2016",7,2,11,20
354940,"2017",10,1,9,20
354940,"2018",6,1,12,19
354940,"2019",13,1,8,22
354940,"2020",7,2,15,24
354940,"2021",8,4,19,31
354940,"2022",9,2,15,26
354940,"2023",4,4,9,17
354950,"2015",1,1,3,5
354950,"2016",1,0,3,4
354950,"2017",2,0,2,4
354950,"2018",1,0,3,4
354950,"2019",1,0,3,4
354950,"2020",1,0,0,1
354950,"2021",2,0,6,8
354950,"2022",2,1,4,7
354950,"2023",1,1,2,4
354960,"2016",0,0,1,1
354960,"2017",0,1,4,5
354960,"2020",0,0,1,1
354970,"2015",8,1,14,23
354970,"2016",8,3,14,25
354970,"2017",10,1,21,32
354970,"2018",14,4,21,39
354970,"2019",10,6,22,38
354970,"2020",12,3,13,28
354970,"2021",13,4,11,28
354970,"2022",5,0,11,16
354970,"2023",4,2,6,12
354980,"2015",63,14,106,183
354980,"2016",59,12,111,182
354980,"2017",56,14,98,168
354980,"2018",57,9,81,147
354980,"2019",50,11,79,140
354980,"2020",36,16,85,137
354980,"2021",54,13,62,129
354980,"2022",44,9,78,131
354980,"2023",31,8,66,105
354990,"2015",59,12,94,165
354990,"2016",75,16,135,226
354990,"2017",91,23,118,232
354990,"2018",70,25,104,199
354990,"2019",66,15,87,168
354990,"2020",60,15,71,146
354990,"2021",56,21,96,173
354990,"2022",83,27,115,225
354990,"2023",62,23,83,168
354995,"2015",2,1,4,7
354995,"2016",2,0,6,8
354995,"2017",4,0,2,6
354995,"2018",3,0,4,7
354995,"2019",2,1,3,6
354995,"2020",1,1,4,6
354995,"2021",2,3,4,9
354995,"2022",3,0,2,5
354995,"2023",2,0,1,3
355000,"2015",2,0,5,7
355000,"2016",4,0,1,5
355000,"2017",3,2,2,7
355000,"2018",2,0,1,3
355000,"2019",1,0,5,6
355000,"2020",4,0,4,8
355000,"2021",3,2,5,10
355000,"2022",0,0,1,1
355000,"2023",1,1,0,2
355010,"2015",2,2,9,13
355010,"2016",5,1,12,18
355010,"2017",3,1,10,14
355010,"2018",7,1,5,13
355010,"2019",3,0,1,4
355010,"2020",5,0,4,9
355010,"2021",2,2,4,8
355010,"2022",3,2,7,12
355010,"2023",3,2,6,11
355020,"2015",4,0,1,5
355020,"2016",4,0,4,8
355020,"2017",3,1,3,7
355020,"2018",3,0,3,6
355020,"2019",4,2,4,10
355020,"2020",2,0,2,4
355020,"2021",3,0,1,4
355020,"2022",4,1,4,9
355020,"2023",1,0,0,1
355030,"2015",2521,668,4399,7588
355030,"2016",2413,650,3919,6982
355030,"2017",2440,685,3929,7054
355030,"2018",2339,652,3561,6552
355030,"2019",2076,591,3016,5683
355030,"2020",1902,584,2864,5350
355030,"2021",1678,532,2497,4707
355030,"2022",1553,488,2497,4538
355030,"2023",1177,359,1959,3495
355040,"2015",13,1,17,31
355040,"2016",5,4,15,24
355040,"2017",10,5,9,24
355040,"2018",7,4,16,27
355040,"2019",10,3,15,28
355040,"2020",11,3,13,27
355040,"2021",10,1,16,27
355040,"2022",3,2,14,19
355040,"2023",6,3,6,15
355050,"2015",1,0,1,2
355050,"2016",1,0,0,1
355050,"2018",0,0,1,1
355050,"2019",0,2,3,5
355050,"2020",0,0,3,3
355050,"2022",3,0,3,6
355050,"2023",2,0,1,3
355060,"2015",18,2,26,46
355060,"2016",14,6,28,48
355060,"2017",23,2,26,51
355060,"2018",20,3,23,46
355060,"2019",14,7,20,41
355060,"2020",8,2,13,23
355060,"2021",7,5,8,20
355060,"2022",12,5,17,34
355060,"2023",3,5,8,16
355070,"2015",1,0,1,2
355070,"2016",4,2,3,9
355070,"2017",0,0,2,2
355070,"2018",3,0,3,6
355070,"2019",2,0,5,7
355070,"2020",3,2,2,7
355070,"2021",3,0,2,5
355070,"2022",3,0,2,5
355070,"2023",3,0,1,4
355080,"2015",1,1,6,8
355080,"2016",0,0,6,6
355080,"2017",3,0,5,8
355080,"2018",0,0,5,5
355080,"2019",1,0,3,4
355080,"2020",3,0,2,5
355080,"2021",1,0,3,4
355080,"2022",1,1,1,3
355080,"2023",1,0,0,1
355090,"2015",1,0,4,5
355090,"2016",1,0,3,4
355090,"2017",3,0,3,6
355090,"2018",0,1,4,5
355090,"2019",3,0,2,5
355090,"2020",2,0,2,4
355090,"2021",0,0,1,1
355090,"2022",1,1,1,3
355100,"2015",63,18,125,206
355100,"2016",55,12,110,177
355100,"2017",77,20,116,213
355100,"2018",61,15,79,155
355100,"2019",33,8,79,120
355100,"2020",35,14,73,122
355100,"2021",64,22,72,158
355100,"2022",33,13,64,110
355100,"2023",34,16,41,91
355110,"2015",1,0,3,4
355110,"2016",0,1,0,1
355110,"2017",0,1,1,2
355110,"2018",1,0,1,2
355110,"2019",1,0,4,5
355110,"2020",1,0,1,2
355110,"2021",1,0,3,4
355110,"2022",1,0,0,1
355110,"2023",0,1,0,1
355120,"2015",1,0,2,3
355120,"2016",0,0,1,1
355120,"2017",0,0,2,2
355120,"2018",1,0,0,1
355120,"2019",0,1,2,3
355120,"2020",0,0,1,1
355120,"2021",1,0,3,4
355120,"2022",0,0,1,1
355120,"2023",1,0,2,3
355130,"2021",0,0,1,1
355140,"2015",2,2,4,8
355140,"2016",3,2,3,8
355140,"2017",1,0,0,1
355140,"2018",1,0,4,5
355140,"2019",1,0,3,4
355140,"2020",0,0,2,2
355140,"2021",2,1,7,10
355140,"2022",1,0,0,1
355150,"2015",11,2,23,36
355150,"2016",5,2,8,15
355150,"2017",9,2,21,32
355150,"2018",6,1,18,25
355150,"2019",9,3,9,21
355150,"2020",8,1,13,22
355150,"2021",9,2,10,21
355150,"2022",3,4,7,14
355150,"2023",2,3,5,10
355160,"2015",1,1,8,10
355160,"2016",2,1,2,5
355160,"2017",3,1,7,11
355160,"2018",6,0,12,18
355160,"2019",1,3,2,6
355160,"2020",1,0,1,2
355160,"2021",3,0,5,8
355160,"2022",4,1,1,6
355160,"2023",1,0,0,1
355170,"2015",19,5,39,63
355170,"2016",31,7,43,81
355170,"2017",18,4,39,61
355170,"2018",20,2,28,50
355170,"2019",19,6,17,42
355170,"2020",13,5,17,35
355170,"2021",13,2,17,32
355170,"2022",17,6,21,44
355170,"2023",7,4,12,23
355180,"2015",2,2,5,9
355180,"2016",7,2,7,16
355180,"2017",2,1,9,12
355180,"2018",4,1,12,17
355180,"2019",3,1,18,22
355180,"2020",4,3,7,14
355180,"2021",0,3,4,7
355180,"2022",0,4,8,12
355180,"2023",2,4,4,10
355190,"2015",7,2,7,16
355190,"2016",3,0,9,12
355190,"2017",3,0,11,14
355190,"2018",4,0,2,6
355190,"2019",1,1,0,2
355190,"2020",2,0,1,3
355190,"2021",2,0,6,8
355190,"2022",4,0,7,11
355190,"2023",2,0,2,4
355200,"2015",0,1,0,1
355200,"2016",1,0,0,1
355200,"2017",0,0,2,2
355200,"2018",0,1,0,1
355200,"2019",1,0,0,1
355210,"2015",2,0,1,3
355210,"2016",0,1,1,2
355210,"2017",1,0,0,1
355210,"2018",0,0,1,1
355210,"2019",4,0,3,7
355210,"2020",1,0,1,2
355210,"2022",1,0,0,1
355210,"2023",1,0,3,4
355220,"2015",34,14,60,108
355220,"2016",43,9,83,135
355220,"2017",77,17,102,196
355220,"2018",55,13,93,161
355220,"2019",50,12,70,132
355220,"2020",40,20,70,130
355220,"2021",39,9,41,89
355220,"2022",33,18,50,101
355220,"2023",42,12,59,113
355230,"2015",2,1,1,4
355230,"2016",4,0,2,6
355230,"2017",1,1,3,5
355230,"2019",0,0,1,1
355230,"2021",2,1,0,3
355230,"2022",2,2,3,7
355230,"2023",1,1,0,2
355240,"2015",6,5,21,32
355240,"2016",7,1,25,33
355240,"2017",14,4,15,33
355240,"2018",12,5,26,43
355240,"2019",23,2,26,51
355240,"2020",12,2,15,29
355240,"2021",10,2,9,21
355240,"2022",10,2,12,24
355240,"2023",6,2,14,22
355250,"2015",80,18,138,236
355250,"2016",60,16,138,214
355250,"2017",65,11,82,158
355250,"2018",60,12,91,163
355250,"2019",77,27,84,188
355250,"2020",62,19,101,182
355250,"2021",65,24,77,166
355250,"2022",43,20,71,134
355250,"2023",34,7,61,102
355255,"2015",2,0,0,2
355255,"2016",1,0,0,1
355255,"2018",0,0,1,1
355255,"2019",0,0,1,1
355255,"2020",0,0,1,1
355255,"2021",0,0,1,1
355255,"2023",1,0,0,1
355260,"2015",1,1,1,3
355260,"2016",2,0,0,2
355260,"2017",0,0,2,2
355260,"2018",0,1,3,4
355260,"2019",2,0,0,2
355260,"2021",2,0,3,5
355260,"2022",0,1,1,2
355260,"2023",0,1,0,1
355270,"2015",0,0,2,2
355270,"2016",0,0,2,2
355270,"2017",1,0,2,3
355270,"2018",2,0,0,2
355270,"2019",1,0,1,2
355270,"2020",2,0,1,3
355270,"2021",0,0,1,1
355270,"2022",4,1,5,10
355270,"2023",0,1,0,1
355280,"2015",87,24,156,267
355280,"2016",76,28,121,225
355280,"2017",103,28,133,264
355280,"2018",70,24,134,228
355280,"2019",76,21,120,217
355280,"2020",76,25,102,203
355280,"2021",61,25,83,169
355280,"2022",53,19,62,134
355280,"2023",19,17,62,98
355290,"2015",4,0,1,5
355290,"2016",0,0,3,3
355290,"2017",2,0,3,5
355290,"2018",1,0,1,2
355290,"2019",2,0,3,5
355290,"2020",0,0,2,2
355290,"2021",1,1,3,5
355290,"2022",1,1,1,3
355290,"2023",1,0,0,1
355300,"2015",1,0,0,1
355300,"2016",0,1,5,6
355300,"2017",3,1,11,15
355300,"2018",3,0,5,8
355300,"2019",5,1,7,13
355300,"2020",8,3,11,22
355300,"2021",6,1,5,12
355300,"2022",4,2,3,9
355300,"2023",3,1,3,7
355310,"2015",0,0,1,1
355310,"2016",1,0,2,3
355310,"2017",2,0,1,3
355310,"2018",0,0,2,2
355310,"2020",1,0,3,4
355310,"2021",0,1,0,1
355310,"2022",0,1,0,1
355310,"2023",1,1,1,3
355320,"2016",1,0,0,1
355320,"2017",1,0,2,3
355320,"2018",2,0,1,3
355320,"2019",2,1,1,4
355320,"2020",0,2,0,2
355320,"2022",0,0,1,1
355320,"2023",1,0,0,1
355330,"2015",4,3,16,23
355330,"2016",6,1,18,25
355330,"2017",11,0,17,28
355330,"2018",5,3,15,23
355330,"2019",10,4,21,35
355330,"2020",10,1,12,23
355330,"2021",9,0,13,22
355330,"2022",7,4,9,20
355330,"2023",5,1,10,16
355340,"2015",1,0,5,6
355340,"2016",1,0,5,6
355340,"2017",1,1,6,8
355340,"2018",0,0,1,1
355340,"2019",2,2,4,8
355340,"2020",1,0,4,5
355340,"2021",3,0,2,5
355340,"2022",2,0,1,3
355350,"2015",1,0,4,5
355350,"2016",0,0,3,3
355350,"2017",1,0,0,1
355350,"2019",2,0,3,5
355350,"2020",1,1,0,2
355350,"2021",1,0,1,2
355350,"2023",0,0,1,1
355360,"2015",1,0,4,5
355360,"2016",1,0,5,6
355360,"2017",4,0,4,8
355360,"2018",1,0,5,6
355360,"2019",1,0,0,1
355360,"2020",2,2,1,5
355360,"2021",2,0,2,4
355360,"2022",0,0,3,3
355360,"2023",0,1,1,2
355365,"2015",0,0,1,1
355365,"2016",1,0,0,1
355365,"2017",0,0,1,1
355365,"2018",0,1,1,2
355365,"2019",1,0,0,1
355370,"2015",2,0,9,11
355370,"2016",2,1,13,16
355370,"2017",16,1,25,42
355370,"2018",3,1,14,18
355370,"2019",15,8,17,40
355370,"2020",13,5,24,42
355370,"2021",17,2,17,36
355370,"2022",18,5,27,50
355370,"2023",10,3,22,35
355380,"2015",1,0,0,1
355380,"2016",1,0,2,3
355380,"2017",1,0,1,2
355380,"2018",2,0,0,2
355380,"2019",1,0,2,3
355380,"2021",0,1,0,1
355380,"2022",1,0,3,4
355380,"2023",2,0,2,4
355385,"2015",1,0,3,4
355385,"2016",1,1,3,5
355385,"2017",0,0,1,1
355385,"2018",1,0,1,2
355385,"2019",0,0,1,1
355385,"2020",1,1,2,4
355385,"2021",2,0,0,2
355385,"2022",0,0,1,1
355385,"2023",2,0,0,2
355390,"2015",1,0,2,3
355390,"2016",1,0,3,4
355390,"2017",3,1,2,6
355390,"2018",2,0,2,4
355390,"2019",1,1,5,7
355390,"2020",3,0,2,5
355390,"2021",0,1,0,1
355390,"2022",2,0,0,2
355390,"2023",1,0,1,2
355395,"2015",3,1,2,6
355395,"2016",3,0,7,10
355395,"2017",4,1,4,9
355395,"2018",3,0,6,9
355395,"2019",5,1,7,13
355395,"2020",1,1,1,3
355395,"2021",1,1,2,4
355395,"2022",0,0,5,5
355395,"2023",0,0,2,2
355400,"2015",21,6,49,76
355400,"2016",15,4,22,41
355400,"2017",2,0,3,5
355400,"2018",1,0,1,2
355400,"2019",3,0,5,8
355400,"2020",17,2,20,39
355400,"2021",31,10,45,86
355400,"2022",11,7,18,36
355400,"2023",5,1,6,12
355410,"2015",60,15,99,174
355410,"2016",54,17,93,164
355410,"2017",51,12,79,142
355410,"2018",54,17,84,155
355410,"2019",52,15,62,129
355410,"2020",44,24,75,143
355410,"2021",64,19,69,152
355410,"2022",47,23,81,151
355410,"2023",32,14,36,82
355420,"2015",0,0,1,1
355420,"2016",0,0,3,3
355420,"2017",4,0,3,7
355420,"2018",2,0,4,6
355420,"2019",0,0,3,3
355420,"2020",2,0,0,2
355420,"2021",0,0,2,2
355420,"2022",2,0,2,4
355420,"2023",0,1,0,1
355430,"2015",4,1,14,19
355430,"2016",5,0,7,12
355430,"2017",6,1,4,11
355430,"2018",10,4,9,23
355430,"2019",1,1,8,10
355430,"2020",1,0,5,6
355430,"2021",7,1,3,11
355430,"2022",3,0,3,6
355430,"2023",1,0,5,6
355440,"2015",0,2,3,5
355440,"2016",0,1,2,3
355440,"2017",1,0,2,3
355440,"2018",0,0,1,1
355440,"2019",0,0,4,4
355440,"2020",0,0,2,2
355440,"2022",0,0,1,1
355440,"2023",0,0,1,1
355450,"2015",7,4,16,27
355450,"2016",12,7,12,31
355450,"2017",4,0,4,8
355450,"2019",1,0,0,1
355450,"2021",6,1,2,9
355450,"2022",2,1,1,4
355450,"2023",4,0,1,5
355460,"2016",0,0,2,2
355460,"2017",1,0,0,1
355460,"2019",0,0,1,1
355460,"2023",0,0,2,2
355465,"2015",1,0,1,2
355465,"2017",0,1,2,3
355465,"2018",0,0,1,1
355465,"2019",1,0,0,1
355465,"2020",1,1,0,2
355465,"2021",1,0,0,1
355465,"2023",2,0,1,3
355470,"2018",0,0,1,1
355470,"2020",1,1,2,4
355470,"2021",0,0,3,3
355470,"2022",3,0,1,4
355470,"2023",1,0,1,2
355475,"2016",0,0,1,1
355475,"2017",0,1,0,1
355475,"2018",0,1,2,3
355475,"2019",1,0,2,3
355475,"2021",1,0,2,3
355475,"2023",0,0,2,2
355480,"2015",9,5,18,32
355480,"2016",4,2,10,16
355480,"2017",3,2,9,14
355480,"2018",5,2,8,15
355480,"2019",9,0,10,19
355480,"2020",13,3,3,19
355480,"2021",6,2,8,16
355480,"2022",4,2,11,17
355480,"2023",2,2,2,6
355490,"2015",0,1,2,3
355490,"2016",4,1,2,7
355490,"2017",0,0,2,2
355490,"2018",1,1,3,5
355490,"2019",3,0,4,7
355490,"2020",0,2,2,4
355490,"2021",2,1,1,4
355490,"2022",1,0,3,4
355490,"2023",2,1,1,4
355495,"2015",1,0,1,2
355495,"2016",0,0,1,1
355495,"2017",1,1,0,2
355495,"2020",0,0,2,2
355495,"2021",2,0,1,3
355495,"2022",3,0,0,3
355500,"2015",7,1,14,22
355500,"2016",12,6,19,37
355500,"2017",9,7,25,41
355500,"2018",16,3,22,41
355500,"2019",11,3,5,19
355500,"2020",14,5,19,38
355500,"2021",7,7,13,27
355500,"2022",6,0,14,20
355500,"2023",12,4,9,25
355510,"2018",0,1,2,3
355510,"2019",2,0,0,2
355510,"2020",0,0,1,1
355510,"2022",2,1,3,6
355510,"2023",3,0,0,3
355530,"2021",0,1,0,1
355535,"2015",1,0,3,4
355535,"2019",0,1,0,1
355535,"2021",1,0,1,2
355535,"2023",0,0,1,1
355540,"2015",29,6,52,87
355540,"2016",28,2,46,76
355540,"2017",47,16,73,136
355540,"2018",28,11,47,86
355540,"2019",33,10,37,80
355540,"2020",39,14,43,96
355540,"2021",30,11,26,67
355540,"2022",22,8,32,62
355540,"2023",15,2,20,37
355550,"2015",0,0,3,3
355550,"2016",0,0,1,1
355550,"2017",1,2,0,3
355550,"2018",0,0,1,1
355550,"2020",2,0,4,6
355550,"2022",1,0,0,1
355550,"2023",1,0,0,1
355560,"2016",4,0,1,5
355560,"2018",1,0,1,2
355560,"2019",1,1,1,3
355560,"2020",2,0,1,3
355560,"2021",0,0,1,1
355560,"2022",0,0,1,1
355570,"2018",0,1,1,2
355570,"2020",1,0,0,1
355580,"2015",2,1,2,5
355580,"2016",3,0,5,8
355580,"2017",0,0,3,3
355580,"2018",0,0,1,1
355580,"2020",0,0,4,4
355580,"2021",1,1,1,3
355580,"2022",0,0,1,1
355580,"2023",1,0,1,2
355590,"2016",0,0,1,1
355590,"2017",0,0,1,1
355590,"2021",1,0,0,1
355590,"2022",0,0,1,1
355600,"2015",1,0,1,2
355600,"2016",2,0,5,7
355600,"2017",0,0,4,4
355600,"2018",1,1,1,3
355600,"2019",0,0,2,2
355600,"2020",2,1,1,4
355600,"2021",1,0,1,2
355600,"2023",2,0,0,2
355610,"2016",2,0,1,3
355610,"2017",0,0,1,1
355610,"2018",1,1,3,5
355610,"2021",1,0,1,2
355610,"2022",0,0,3,3
355610,"2023",0,1,1,2
355620,"2015",7,3,7,17
355620,"2016",18,7,41,66
355620,"2017",15,8,17,40
355620,"2018",12,3,3,18
355620,"2019",8,2,5,15
355620,"2020",7,1,9,17
355620,"2021",0,0,4,4
355620,"2022",1,0,7,8
355620,"2023",4,2,3,9
355630,"2015",8,0,19,27
355630,"2016",9,1,16,26
355630,"2017",9,2,7,18
355630,"2018",11,5,19,35
355630,"2019",13,0,18,31
355630,"2020",8,4,15,27
355630,"2021",13,2,25,40
355630,"2022",12,3,12,27
355630,"2023",8,1,13,22
355635,"2015",2,0,2,4
355635,"2016",1,0,3,4
355635,"2017",2,0,2,4
355635,"2018",1,0,1,2
355635,"2019",3,0,1,4
355635,"2020",4,3,3,10
355635,"2021",3,0,6,9
355635,"2022",1,1,4,6
355635,"2023",2,1,3,6
355640,"2015",12,2,15,29
355640,"2016",10,1,18,29
355640,"2017",10,3,8,21
355640,"2018",8,2,14,24
355640,"2019",6,3,14,23
355640,"2020",15,2,10,27
355640,"2021",12,5,19,36
355640,"2022",12,2,14,28
355640,"2023",9,1,6,16
355645,"2015",16,5,32,53
355645,"2016",14,7,28,49
355645,"2017",18,3,23,44
355645,"2018",16,7,26,49
355645,"2019",21,5,23,49
355645,"2020",15,7,16,38
355645,"2021",10,5,13,28
355645,"2022",9,7,13,29
355645,"2023",12,2,5,19
355650,"2015",8,4,18,30
355650,"2016",5,1,20,26
355650,"2017",6,1,12,19
355650,"2018",7,3,14,24
355650,"2019",8,4,17,29
355650,"2020",9,2,12,23
355650,"2021",11,2,19,32
355650,"2022",7,3,11,21
355650,"2023",12,4,8,24
355660,"2015",3,0,1,4
355660,"2016",0,0,5,5
355660,"2017",0,0,1,1
355660,"2018",2,0,1,3
355660,"2019",0,0,3,3
355660,"2021",0,0,1,1
355660,"2023",1,1,0,2
355670,"2015",0,0,1,1
355670,"2016",10,5,21,36
355670,"2017",29,5,32,66
355670,"2018",19,9,18,46
355670,"2019",21,7,22,50
355670,"2020",14,2,17,33
355670,"2021",15,1,24,40
355670,"2022",10,5,21,36
355670,"2023",6,6,14,26
355680,"2015",3,0,5,8
355680,"2016",2,4,5,11
355680,"2017",0,0,6,6
355680,"2018",2,1,4,7
355680,"2019",4,0,3,7
355680,"2020",0,1,4,5
355680,"2021",3,1,4,8
355680,"2022",3,0,1,4
355680,"2023",3,0,2,5
355690,"2015",1,0,3,4
355690,"2016",2,0,4,6
355690,"2017",1,0,3,4
355690,"2018",4,0,1,5
355690,"2019",1,1,0,2
355690,"2020",0,0,6,6
355690,"2021",0,0,1,1
355690,"2022",0,0,1,1
355690,"2023",0,0,1,1
355695,"2015",0,1,2,3
355695,"2016",1,1,2,4
355695,"2017",0,1,0,1
355695,"2020",0,0,2,2
355695,"2021",0,1,2,3
355695,"2022",0,1,0,1
355700,"2015",11,5,21,37
355700,"2016",7,3,24,34
355700,"2017",5,3,11,19
355700,"2018",8,1,22,31
355700,"2019",16,3,33,52
355700,"2020",12,3,24,39
355700,"2021",7,5,18,30
355700,"2022",5,4,17,26
355700,"2023",8,0,15,23
355710,"2015",1,0,6,7
355710,"2016",0,0,3,3
355710,"2017",4,0,4,8
355710,"2018",5,2,8,15
355710,"2019",3,1,7,11
355710,"2020",3,0,4,7
355710,"2021",4,0,7,11
355710,"2022",7,0,12,19
355710,"2023",2,1,12,15
355715,"2018",0,0,1,1
355715,"2020",1,0,0,1
355715,"2023",0,0,1,1
355720,"2015",1,1,9,11
355720,"2016",2,0,6,8
355720,"2017",2,1,8,11
355720,"2018",2,1,3,6
355720,"2019",2,0,4,6
355720,"2020",3,1,6,10
355720,"2021",2,2,3,7
355720,"2022",3,1,5,9
355720,"2023",1,1,6,8
355730,"2015",2,0,3,5
355730,"2016",1,0,1,2
355730,"2017",1,0,1,2
355730,"2018",1,1,0,2
355730,"2019",0,0,1,1
355730,"2020",1,1,1,3
355730,"2021",0,1,1,2
355730,"2022",1,0,1,2
355730,"2023",3,0,0,3
410010,"2015",2,0,0,2
410010,"2016",3,1,4,8
410010,"2017",1,0,0,1
410010,"2018",1,0,0,1
410010,"2021",1,0,0,1
410010,"2022",0,0,2,2
410010,"2023",0,0,2,2
410020,"2015",1,0,1,2
410020,"2016",0,2,1,3
410020,"2017",1,0,1,2
410020,"2019",1,0,1,2
410020,"2020",0,0,3,3
410020,"2021",2,0,1,3
410020,"2022",1,0,1,2
410020,"2023",0,0,1,1
410030,"2015",2,0,0,2
410030,"2016",1,1,2,4
410030,"2017",0,0,3,3
410030,"2018",2,0,1,3
410030,"2019",1,0,2,3
410030,"2020",3,0,1,4
410030,"2021",1,0,3,4
410030,"2022",2,0,4,6
410040,"2015",26,7,52,85
410040,"2016",13,4,56,73
410040,"2017",18,6,39,63
410040,"2018",21,4,50,75
410040,"2019",19,11,55,85
410040,"2020",17,6,36,59
410040,"2021",16,7,37,60
410040,"2022",13,5,33,51
410040,"2023",18,6,41,65
410045,"2015",0,0,1,1
410045,"2019",0,0,2,2
410045,"2020",0,1,1,2
410045,"2021",3,0,1,4
410045,"2022",0,1,0,1
410050,"2015",0,0,4,4
410050,"2016",1,0,0,1
410050,"2017",1,0,0,1
410050,"2018",0,0,1,1
410050,"2019",0,0,1,1
410050,"2020",1,0,1,2
410050,"2021",1,0,1,2
410050,"2022",1,0,0,1
410050,"2023",0,0,2,2
410060,"2015",1,0,5,6
410060,"2016",1,0,4,5
410060,"2017",0,0,1,1
410060,"2021",1,0,2,3
410060,"2022",2,2,4,8
410060,"2023",3,1,2,6
410070,"2015",0,0,2,2
410070,"2016",3,0,4,7
410070,"2017",3,2,3,8
410070,"2018",1,2,6,9
410070,"2019",1,1,5,7
410070,"2020",0,1,5,6
410070,"2021",4,1,1,6
410070,"2022",0,2,4,6
410070,"2023",1,0,1,2
410080,"2015",0,0,1,1
410080,"2016",0,0,2,2
410080,"2017",1,1,3,5
410080,"2020",1,0,0,1
410080,"2021",0,0,1,1
410080,"2022",0,0,1,1
410090,"2018",0,0,1,1
410090,"2022",3,0,0,3
410090,"2023",0,1,1,2
410100,"2015",2,1,6,9
410100,"2016",0,0,1,1
410100,"2017",1,1,1,3
410100,"2018",2,1,0,3
410100,"2021",1,0,0,1
410100,"2022",1,1,4,6
410100,"2023",0,1,3,4
410105,"2017",0,0,1,1
410105,"2018",0,0,1,1
410105,"2019",0,1,0,1
410110,"2015",3,1,2,6
410110,"2016",3,1,5,9
410110,"2017",5,0,3,8
410110,"2018",4,1,8,13
410110,"2019",4,3,3,10
410110,"2020",3,1,3,7
410110,"2021",0,1,1,2
410110,"2022",1,0,0,1
410110,"2023",0,0,2,2
410115,"2017",0,0,2,2
410115,"2019",1,0,0,1
410115,"2021",0,0,1,1
410120,"2015",3,0,5,8
410120,"2016",3,1,4,8
410120,"2017",2,1,3,6
410120,"2018",2,0,2,4
410120,"2019",2,0,3,5
410120,"2020",1,0,3,4
410120,"2021",0,1,5,6
410120,"2022",0,0,2,2
410120,"2023",1,0,0,1
410130,"2016",1,0,2,3
410130,"2017",1,0,3,4
410130,"2018",1,0,3,4
410130,"2019",2,0,1,3
410130,"2020",2,0,2,4
410130,"2023",0,0,1,1
410140,"2015",23,4,28,55
410140,"2016",22,2,32,56
410140,"2017",20,3,15,38
410140,"2018",19,3,26,48
410140,"2019",19,5,31,55
410140,"2020",23,3,39,65
410140,"2021",16,5,25,46
410140,"2022",18,6,22,46
410140,"2023",11,3,7,21
410150,"2016",1,0,0,1
410150,"2017",1,0,1,2
410150,"2018",0,0,1,1
410150,"2019",0,0,2,2
410150,"2021",1,0,0,1
410150,"2022",1,0,1,2
410150,"2023",1,1,1,3
410160,"2015",1,0,2,3
410160,"2016",1,0,4,5
410160,"2017",4,5,10,19
410160,"2018",14,3,19,36
410160,"2019",7,2,13,22
410160,"2020",6,1,11,18
410160,"2021",6,4,7,17
410160,"2022",4,0,5,9
410160,"2023",4,0,2,6
410165,"2016",1,0,0,1
410165,"2018",0,0,1,1
410170,"2015",0,0,1,1
410170,"2016",0,0,1,1
410170,"2018",0,0,1,1
410170,"2019",1,0,1,2
410170,"2020",3,0,1,4
410170,"2021",0,2,0,2
410170,"2023",0,0,3,3
410180,"2015",10,6,18,34
410180,"2016",11,2,26,39
410180,"2017",12,5,23,40
410180,"2018",18,2,33,53
410180,"2019",17,2,21,40
410180,"2020",11,5,25,41
410180,"2021",18,5,28,51
410180,"2022",10,4,33,47
410180,"2023",16,5,11,32
410190,"2015",1,0,1,2
410190,"2016",0,0,1,1
410190,"2017",1,0,1,2
410190,"2018",0,0,3,3
410190,"2019",0,0,3,3
410190,"2020",1,1,0,2
410190,"2021",2,1,1,4
410190,"2022",1,0,0,1
410200,"2015",5,0,3,8
410200,"2016",5,1,6,12
410200,"2017",5,0,12,17
410200,"2018",7,2,7,16
410200,"2019",6,2,4,12
410200,"2020",3,0,5,8
410200,"2021",7,0,10,17
410200,"2022",11,0,4,15
410200,"2023",7,2,11,20
410210,"2015",0,0,1,1
410210,"2016",2,1,8,11
410210,"2017",6,2,6,14
410210,"2018",1,1,3,5
410210,"2019",2,1,6,9
410210,"2020",4,2,2,8
410210,"2021",3,0,4,7
410210,"2022",3,1,1,5
410210,"2023",0,0,3,3
410220,"2015",1,1,0,2
410220,"2016",0,0,1,1
410220,"2019",2,0,0,2
410220,"2022",0,0,2,2
410220,"2023",2,0,0,2
410230,"2015",3,0,3,6
410230,"2016",5,0,9,14
410230,"2017",2,1,9,12
410230,"2018",6,1,5,12
410230,"2019",4,1,5,10
410230,"2020",3,1,8,12
410230,"2021",3,3,4,10
410230,"2022",2,0,4,6
410230,"2023",2,0,4,6
410240,"2015",6,0,9,15
410240,"2016",5,6,9,20
410240,"2017",5,1,9,15
410240,"2018",8,3,10,21
410240,"2019",2,1,3,6
410240,"2020",5,0,5,10
410240,"2021",3,1,8,12
410240,"2022",4,0,6,10
410240,"2023",0,0,2,2
410250,"2016",0,0,1,1
410250,"2017",0,1,1,2
410250,"2018",0,0,1,1
410250,"2019",1,0,0,1
410250,"2020",2,1,0,3
410250,"2021",1,1,1,3
410250,"2022",0,0,1,1
410250,"2023",1,0,0,1
410260,"2016",0,0,1,1
410260,"2018",0,0,2,2
410260,"2019",2,0,1,3
410260,"2020",1,0,2,3
410260,"2021",0,0,1,1
410260,"2022",3,0,1,4
410260,"2023",1,0,3,4
410270,"2015",0,0,3,3
410270,"2016",1,0,4,5
410270,"2018",1,0,2,3
410270,"2019",0,0,2,2
410270,"2021",0,0,2,2
410270,"2022",0,1,0,1
410275,"2019",1,1,0,2
410275,"2022",1,0,0,1
410280,"2015",3,0,7,10
410280,"2016",0,0,3,3
410280,"2017",0,1,4,5
410280,"2018",3,0,0,3
410280,"2019",0,1,1,2
410280,"2021",0,0,1,1
410280,"2022",0,0,1,1
410280,"2023",0,0,1,1
410290,"2015",4,2,4,10
410290,"2016",1,0,3,4
410290,"2017",1,0,2,3
410290,"2018",1,0,2,3
410290,"2019",0,1,0,1
410290,"2020",0,0,1,1
410290,"2021",2,0,6,8
410290,"2022",1,1,3,5
410290,"2023",0,1,1,2
410300,"2015",1,0,0,1
410300,"2016",1,0,0,1
410300,"2017",1,0,1,2
410300,"2018",1,1,2,4
410300,"2019",0,0,4,4
410300,"2020",0,0,2,2
410300,"2021",0,1,1,2
410302,"2015",1,0,2,3
410302,"2016",0,0,1,1
410302,"2022",0,0,1,1
410302,"2023",1,0,1,2
410304,"2015",0,0,1,1
410304,"2017",2,0,0,2
410304,"2018",1,2,3,6
410304,"2019",0,0,4,4
410304,"2020",0,1,1,2
410304,"2021",1,0,0,1
410304,"2022",1,0,1,2
410304,"2023",0,0,1,1
410305,"2015",4,0,1,5
410305,"2016",1,0,1,2
410305,"2017",2,0,4,6
410305,"2018",2,1,4,7
410305,"2019",3,1,3,7
410305,"2020",1,0,1,2
410305,"2021",3,0,2,5
410305,"2022",3,0,0,3
410310,"2015",0,0,2,2
410310,"2016",0,0,1,1
410310,"2017",0,0,1,1
410310,"2018",3,0,5,8
410310,"2019",1,0,0,1
410310,"2021",1,0,1,2
410310,"2022",1,0,0,1
410310,"2023",1,2,1,4
410315,"2017",0,0,2,2
410315,"2018",2,0,1,3
410315,"2021",0,0,1,1
410315,"2022",0,0,1,1
410320,"2017",0,0,2,2
410320,"2018",1,0,1,2
410320,"2019",0,1,3,4
410320,"2020",0,0,1,1
410320,"2021",0,0,2,2
410320,"2022",0,0,1,1
410320,"2023",0,0,1,1
410322,"2016",1,0,1,2
410322,"2017",0,0,1,1
410322,"2018",0,0,3,3
410322,"2019",1,0,0,1
410322,"2020",0,1,1,2
410322,"2022",0,1,1,2
410322,"2023",2,0,0,2
410330,"2017",0,0,2,2
410330,"2018",2,0,0,2
410330,"2019",1,1,0,2
410330,"2020",0,0,1,1
410330,"2021",0,0,2,2
410330,"2022",0,2,1,3
410335,"2015",0,1,0,1
410335,"2017",1,0,3,4
410335,"2018",1,0,0,1
410335,"2019",2,0,3,5
410335,"2020",1,0,1,2
410335,"2021",0,0,1,1
410335,"2022",1,1,1,3
410335,"2023",0,0,1,1
410337,"2015",0,0,3,3
410337,"2016",1,0,2,3
410337,"2017",0,0,2,2
410337,"2018",1,0,0,1
410337,"2019",0,0,1,1
410337,"2020",0,1,2,3
410337,"2021",1,0,2,3
410337,"2022",0,0,1,1
410340,"2016",0,0,1,1
410340,"2018",1,0,1,2
410340,"2022",0,0,1,1
410345,"2015",0,0,1,1
410345,"2016",0,0,3,3
410345,"2017",1,0,0,1
410345,"2018",5,1,4,10
410345,"2019",5,2,2,9
410345,"2020",4,1,4,9
410345,"2021",4,1,5,10
410345,"2022",0,3,7,10
410345,"2023",1,0,4,5
410347,"2015",1,0,2,3
410347,"2016",2,1,2,5
410347,"2017",0,0,1,1
410347,"2018",2,0,2,4
410347,"2019",3,0,0,3
410347,"2020",0,0,2,2
410347,"2021",0,0,1,1
410347,"2022",0,0,2,2
410350,"2015",0,1,2,3
410350,"2016",1,1,2,4
410350,"2017",0,0,1,1
410350,"2018",1,1,2,4
410350,"2019",1,2,5,8
410350,"2020",3,1,3,7
410350,"2021",1,1,2,4
410350,"2022",1,0,6,7
410350,"2023",1,0,0,1
410360,"2015",1,0,5,6
410360,"2016",5,1,7,13
410360,"2017",3,1,7,11
410360,"2018",1,0,8,9
410360,"2019",1,1,1,3
410360,"2020",1,1,1,3
410360,"2021",4,2,1,7
410360,"2022",1,0,3,4
410360,"2023",0,0,3,3
410370,"2015",2,0,2,4
410370,"2016",11,3,30,44
410370,"2017",14,3,12,29
410370,"2018",10,3,16,29
410370,"2019",4,1,6,11
410370,"2020",6,1,7,14
410370,"2021",3,2,10,15
410370,"2022",6,5,9,20
410370,"2023",1,0,3,4
410380,"2015",3,0,2,5
410380,"2016",3,0,2,5
410380,"2017",1,0,2,3
410380,"2018",0,1,4,5
410380,"2019",2,0,1,3
410380,"2020",0,0,3,3
410380,"2021",0,1,4,5
410380,"2022",1,2,1,4
410390,"2015",1,0,0,1
410390,"2019",0,0,4,4
410390,"2020",1,0,1,2
410390,"2021",2,1,1,4
410390,"2022",0,0,1,1
410395,"2015",2,1,4,7
410395,"2016",3,0,2,5
410395,"2017",2,0,3,5
410395,"2018",3,0,4,7
410395,"2019",2,0,0,2
410395,"2020",3,0,3,6
410395,"2021",0,0,2,2
410395,"2022",0,0,2,2
410395,"2023",1,0,1,2
410400,"2015",7,3,19,29
410400,"2016",1,0,7,8
410400,"2017",9,1,23,33
410400,"2018",32,4,24,60
410400,"2019",13,2,15,30
410400,"2020",9,6,11,26
410400,"2021",7,2,13,22
410400,"2022",8,1,7,16
410400,"2023",6,2,7,15
410405,"2015",1,0,1,2
410405,"2016",0,0,1,1
410405,"2017",1,0,3,4
410405,"2020",0,0,1,1
410405,"2022",0,0,2,2
410405,"2023",0,0,1,1
410410,"2015",1,1,2,4
410410,"2016",2,0,4,6
410410,"2017",0,0,1,1
410410,"2018",2,0,1,3
410410,"2019",1,0,0,1
410410,"2020",1,0,1,2
410410,"2021",0,0,1,1
410410,"2022",0,1,0,1
410420,"2015",35,9,66,110
410420,"2016",45,12,68,125
410420,"2017",40,8,71,119
410420,"2018",29,7,48,84
410420,"2019",41,6,45,92
410420,"2020",31,8,43,82
410420,"2021",25,8,51,84
410420,"2022",15,4,27,46
410420,"2023",22,6,24,52
410425,"2015",4,1,5,10
410425,"2016",3,2,4,9
410425,"2017",2,1,8,11
410425,"2018",4,2,9,15
410425,"2019",5,1,11,17
410425,"2020",4,1,9,14
410425,"2021",2,1,7,10
410425,"2022",1,1,7,9
410425,"2023",1,0,6,7
410430,"2015",14,4,24,42
410430,"2016",5,1,11,17
410430,"2017",8,1,19,28
410430,"2018",11,4,27,42
410430,"2019",11,0,25,36
410430,"2020",9,3,14,26
410430,"2021",9,4,24,37
410430,"2022",20,3,23,46
410430,"2023",10,1,19,30
410440,"2015",3,2,0,5
410440,"2016",1,1,2,4
410440,"2017",1,1,1,3
410440,"2019",0,0,1,1
410440,"2021",0,0,2,2
410440,"2022",2,0,2,4
410442,"2017",1,0,0,1
410442,"2018",1,1,3,5
410442,"2019",2,1,0,3
410442,"2020",0,0,1,1
410442,"2021",1,1,1,3
410442,"2022",1,0,0,1
410442,"2023",0,1,0,1
410445,"2015",0,0,1,1
410445,"2016",0,0,1,1
410445,"2017",1,0,0,1
410445,"2018",0,0,1,1
410445,"2019",1,0,0,1
410445,"2020",0,0,1,1
410445,"2022",1,0,0,1
410450,"2015",2,0,3,5
410450,"2016",1,0,2,3
410450,"2017",2,0,2,4
410450,"2018",1,0,1,2
410450,"2019",1,0,3,4
410450,"2020",1,0,0,1
410450,"2021",2,0,1,3
410450,"2022",3,5,1,9
410450,"2023",1,0,1,2
410460,"2015",5,0,3,8
410460,"2016",4,0,1,5
410460,"2017",2,1,4,7
410460,"2018",1,1,0,2
410460,"2019",0,0,2,2
410460,"2021",0,1,0,1
410460,"2022",0,0,1,1
410460,"2023",0,0,1,1
410465,"2015",3,2,9,14
410465,"2016",6,2,13,21
410465,"2017",5,3,10,18
410465,"2018",5,3,11,19
410465,"2019",4,1,10,15
410465,"2020",8,2,5,15
410465,"2021",2,0,5,7
410465,"2022",3,0,7,10
410465,"2023",5,1,4,10
410470,"2015",0,0,2,2
410470,"2016",0,0,2,2
410470,"2017",3,0,7,10
410470,"2018",5,0,2,7
410470,"2019",4,0,1,5
410470,"2020",2,0,7,9
410470,"2021",2,0,2,4
410470,"2022",1,1,4,6
410470,"2023",2,1,1,4
410480,"2015",39,16,82,137
410480,"2016",90,18,151,259
410480,"2017",97,19,158,274
410480,"2018",78,26,138,242
410480,"2019",57,10,113,180
410480,"2020",64,12,110,186
410480,"2021",55,27,96,178
410480,"2022",66,10,79,155
410480,"2023",34,12,73,119
410490,"2015",13,5,42,60
410490,"2016",14,4,47,65
410490,"2017",29,6,57,92
410490,"2018",31,13,48,92
410490,"2019",24,10,56,90
410490,"2020",21,5,54,80
410490,"2021",18,5,58,81
410490,"2022",11,6,35,52
410490,"2023",8,1,14,23
410500,"2015",0,0,1,1
410500,"2016",0,1,5,6
410500,"2017",2,1,4,7
410500,"2018",5,1,3,9
410500,"2019",2,0,1,3
410500,"2020",0,0,1,1
410500,"2021",0,1,2,3
410500,"2022",1,0,1,2
410500,"2023",4,0,0,4
410510,"2015",0,0,2,2
410510,"2016",0,1,1,2
410510,"2017",0,0,1,1
410510,"2020",0,0,3,3
410510,"2021",0,0,1,1
410510,"2022",0,0,1,1
410520,"2015",2,0,4,6
410520,"2016",1,0,6,7
410520,"2017",1,2,3,6
410520,"2018",2,0,6,8
410520,"2019",1,0,1,2
410520,"2020",4,1,1,6
410520,"2021",0,1,2,3
410520,"2022",1,0,3,4
410520,"2023",1,0,0,1
410530,"2015",2,0,3,5
410530,"2016",0,0,3,3
410530,"2017",1,0,3,4
410530,"2019",1,0,1,2
410530,"2020",3,1,0,4
410530,"2021",2,0,1,3
410530,"2022",1,1,4,6
410540,"2016",1,0,0,1
410540,"2017",0,0,1,1
410540,"2019",3,0,3,6
410540,"2020",0,0,1,1
410540,"2021",5,1,2,8
410540,"2022",2,0,3,5
410540,"2023",0,0,2,2
410550,"2015",4,0,4,8
410550,"2016",11,4,21,36
410550,"2017",12,3,13,28
410550,"2018",12,4,18,34
410550,"2019",11,0,11,22
410550,"2020",8,1,5,14
410550,"2021",5,4,10,19
410550,"2022",4,1,13,18
410550,"2023",3,3,16,22
410560,"2016",2,0,3,5
410560,"2017",0,1,3,4
410560,"2018",1,1,2,4
410560,"2019",1,0,1,2
410560,"2020",0,0,2,2
410560,"2021",0,0,1,1
410560,"2022",0,1,0,1
410560,"2023",1,0,2,3
410570,"2016",1,0,0,1
410570,"2017",0,0,1,1
410570,"2019",0,0,4,4
410570,"2020",3,1,6,10
410570,"2021",3,2,4,9
410570,"2022",1,5,11,17
410570,"2023",4,2,7,13
410580,"2015",14,0,13,27
410580,"2016",4,5,10,19
410580,"2017",9,3,18,30
410580,"2018",10,2,21,33
410580,"2019",5,1,9,15
410580,"2020",5,1,8,14
410580,"2021",3,0,5,8
410580,"2022",4,1,6,11
410580,"2023",9,3,24,36
410590,"2015",0,0,1,1
410590,"2016",0,0,3,3
410590,"2017",0,0,1,1
410590,"2019",1,0,3,4
410590,"2020",3,0,2,5
410590,"2021",1,0,2,3
410590,"2022",3,0,4,7
410590,"2023",0,0,2,2
410600,"2017",0,0,1,1
410600,"2018",2,1,0,3
410600,"2019",1,1,0,2
410600,"2020",1,0,2,3
410600,"2023",1,0,0,1
410610,"2015",0,0,2,2
410610,"2016",0,0,1,1
410610,"2018",0,0,1,1
410610,"2020",0,0,1,1
410620,"2015",2,1,2,5
410620,"2016",1,0,2,3
410620,"2017",1,0,4,5
410620,"2018",2,1,4,7
410620,"2019",2,0,2,4
410620,"2020",3,0,2,5
410620,"2021",0,1,4,5
410620,"2022",2,0,0,2
410620,"2023",1,1,5,7
410630,"2015",1,1,3,5
410630,"2016",0,2,4,6
410630,"2017",2,1,5,8
410630,"2018",2,2,3,7
410630,"2019",6,0,7,13
410630,"2020",3,1,3,7
410630,"2021",3,0,3,6
410630,"2022",1,0,6,7
410630,"2023",2,1,3,6
410640,"2015",4,2,7,13
410640,"2016",5,1,4,10
410640,"2017",4,1,4,9
410640,"2018",12,2,4,18
410640,"2019",2,0,3,5
410640,"2020",6,2,6,14
410640,"2021",2,2,3,7
410640,"2022",2,0,3,5
410640,"2023",2,0,2,4
410645,"2015",1,0,1,2
410645,"2016",2,1,2,5
410645,"2019",2,0,0,2
410645,"2021",2,0,3,5
410645,"2022",3,0,1,4
410650,"2015",1,0,3,4
410650,"2016",1,1,2,4
410650,"2017",5,0,7,12
410650,"2018",4,1,9,14
410650,"2019",4,3,6,13
410650,"2020",6,3,6,15
410650,"2021",4,0,0,4
410650,"2022",0,2,3,5
410650,"2023",4,1,3,8
410655,"2015",0,0,1,1
410655,"2016",1,0,0,1
410655,"2017",0,0,1,1
410655,"2019",2,0,0,2
410655,"2020",2,0,0,2
410655,"2021",0,1,0,1
410657,"2019",0,0,2,2
410657,"2023",1,1,0,2
410660,"2015",6,1,6,13
410660,"2016",4,0,16,20
410660,"2017",4,0,12,16
410660,"2018",3,0,6,9
410660,"2019",1,1,4,6
410660,"2020",2,0,1,3
410660,"2021",4,1,3,8
410660,"2022",3,0,4,7
410660,"2023",3,0,1,4
410670,"2021",1,0,1,2
410670,"2023",2,0,1,3
410680,"2015",3,3,5,11
410680,"2016",2,4,5,11
410680,"2017",3,0,6,9
410680,"2018",5,0,5,10
410680,"2019",0,2,1,3
410680,"2020",1,0,1,2
410680,"2021",0,1,1,2
410680,"2022",6,0,5,11
410680,"2023",1,1,4,6
410685,"2015",0,0,2,2
410685,"2021",0,1,0,1
410690,"2015",246,74,495,815
410690,"2016",244,52,396,692
410690,"2017",206,60,370,636
410690,"2018",268,77,433,778
410690,"2019",227,69,395,691
410690,"2020",203,64,365,632
410690,"2021",221,68,333,622
410690,"2022",217,66,338,621
410690,"2023",143,62,259,464
410700,"2016",1,0,1,2
410700,"2017",3,0,3,6
410700,"2018",1,0,5,6
410700,"2019",1,0,2,3
410700,"2020",1,1,4,6
410700,"2021",3,1,3,7
410710,"2015",0,0,1,1
410710,"2018",4,0,2,6
410710,"2022",2,0,3,5
410710,"2023",1,0,0,1
410712,"2015",1,0,0,1
410712,"2021",0,0,1,1
410712,"2022",1,0,0,1
410715,"2015",0,0,2,2
410715,"2016",1,0,0,1
410715,"2017",1,0,1,2
410715,"2018",0,2,0,2
410715,"2021",1,0,0,1
410715,"2023",0,0,2,2
410720,"2015",3,0,2,5
410720,"2016",6,2,3,11
410720,"2017",3,0,3,6
410720,"2018",6,4,7,17
410720,"2019",1,1,3,5
410720,"2020",2,2,3,7
410720,"2021",1,0,2,3
410720,"2022",0,3,3,6
410720,"2023",3,0,6,9
410725,"2015",2,0,3,5
410725,"2016",4,0,5,9
410725,"2017",1,0,3,4
410725,"2018",1,0,1,2
410725,"2019",1,0,2,3
410725,"2020",3,1,3,7
410725,"2021",2,0,4,6
410725,"2022",0,0,2,2
410725,"2023",2,0,1,3
410730,"2015",0,1,4,5
410730,"2016",0,0,3,3
410730,"2017",0,0,3,3
410730,"2018",1,0,1,2
410730,"2019",0,0,1,1
410730,"2020",0,0,1,1
410730,"2022",0,0,1,1
410730,"2023",0,0,1,1
410740,"2016",1,0,0,1
410740,"2017",0,0,1,1
410750,"2015",2,0,2,4
410750,"2017",2,0,2,4
410750,"2018",1,0,5,6
410750,"2019",0,0,3,3
410750,"2020",2,0,3,5
410750,"2021",2,0,1,3
410750,"2023",1,0,2,3
410752,"2015",0,0,1,1
410752,"2019",1,0,0,1
410753,"2015",1,0,0,1
410753,"2016",0,0,1,1
410753,"2017",0,0,1,1
410753,"2019",1,0,1,2
410753,"2020",0,0,1,1
410753,"2021",3,0,1,4
410753,"2022",2,0,1,3
410754,"2017",0,0,1,1
410754,"2020",0,0,1,1
410754,"2021",0,0,1,1
410754,"2022",0,0,3,3
410755,"2015",0,0,1,1
410755,"2017",0,0,2,2
410755,"2020",1,0,1,2
410755,"2021",0,0,1,1
410755,"2022",1,0,0,1
410755,"2023",0,1,1,2
410760,"2017",1,0,3,4
410760,"2018",0,1,0,1
410760,"2019",1,0,5,6
410760,"2020",2,0,2,4
410760,"2021",0,0,2,2
410760,"2022",2,0,1,3
410760,"2023",0,0,1,1
410765,"2015",4,1,10,15
410765,"2016",18,8,23,49
410765,"2017",14,4,23,41
410765,"2018",10,2,20,32
410765,"2019",17,2,22,41
410765,"2020",11,6,27,44
410765,"2021",16,4,27,47
410765,"2022",8,4,25,37
410765,"2023",14,9,30,53
410770,"2015",1,0,1,2
410770,"2016",2,0,0,2
410770,"2017",1,0,3,4
410770,"2019",0,0,1,1
410770,"2020",1,1,3,5
410770,"2021",1,0,0,1
410770,"2022",1,0,3,4
410770,"2023",0,0,1,1
410773,"2015",0,0,3,3
410773,"2016",0,0,1,1
410773,"2017",0,0,1,1
410773,"2018",1,0,0,1
410773,"2019",0,0,1,1
410773,"2021",3,0,2,5
410773,"2022",1,0,0,1
410773,"2023",2,1,3,6
410775,"2015",1,0,0,1
410775,"2017",0,0,1,1
410775,"2019",0,1,0,1
410775,"2022",0,1,1,2
410775,"2023",1,0,1,2
410780,"2015",0,0,1,1
410780,"2016",1,0,2,3
410780,"2018",0,0,1,1
410780,"2020",1,0,0,1
410780,"2022",1,1,0,2
410785,"2016",2,1,0,3
410785,"2018",1,0,1,2
410785,"2019",0,1,2,3
410785,"2020",1,0,1,2
410785,"2021",1,1,3,5
410785,"2022",0,0,1,1
410785,"2023",2,0,0,2
410790,"2015",1,0,3,4
410790,"2016",0,0,1,1
410790,"2017",1,0,4,5
410790,"2018",0,0,1,1
410790,"2019",0,0,1,1
410790,"2020",0,0,2,2
410790,"2021",0,0,1,1
410790,"2022",1,2,0,3
410790,"2023",0,0,2,2
410800,"2016",1,0,2,3
410800,"2017",0,0,1,1
410800,"2018",1,0,1,2
410800,"2020",1,0,0,1
410800,"2021",1,0,0,1
410800,"2022",2,0,0,2
410800,"2023",0,0,1,1
410810,"2015",1,0,1,2
410810,"2016",2,0,0,2
410810,"2020",1,0,0,1
410810,"2021",1,0,0,1
410810,"2022",1,0,0,1
410810,"2023",0,1,0,1
410820,"2016",1,0,1,2
410820,"2017",1,0,1,2
410820,"2018",0,0,1,1
410820,"2019",0,0,1,1
410820,"2020",1,0,0,1
410820,"2022",1,0,2,3
410820,"2023",1,0,0,1
410830,"2015",107,26,171,304
410830,"2016",98,29,167,294
410830,"2017",112,32,194,338
410830,"2018",105,27,158,290
410830,"2019",88,30,120,238
410830,"2020",79,25,97,201
410830,"2021",87,25,113,225
410830,"2022",63,20,81,164
410830,"2023",31,6,60,97
410832,"2015",0,0,3,3
410832,"2016",1,0,2,3
410832,"2017",1,1,4,6
410832,"2018",1,0,1,2
410832,"2019",5,1,5,11
410832,"2020",2,0,3,5
410832,"2021",1,0,4,5
410832,"2022",2,0,3,5
410832,"2023",0,0,1,1
410840,"2015",2,2,6,10
410840,"2016",9,3,17,29
410840,"2017",12,4,7,23
410840,"2018",6,2,6,14
410840,"2019",6,2,11,19
410840,"2020",6,0,0,6
410840,"2021",5,1,5,11
410840,"2022",3,0,7,10
410840,"2023",4,1,4,9
410845,"2015",2,0,0,2
410850,"2016",1,0,3,4
410850,"2017",0,0,2,2
410850,"2018",2,1,6,9
410850,"2019",2,0,6,8
410850,"2020",1,1,5,7
410850,"2021",1,0,5,6
410850,"2022",1,2,5,8
410850,"2023",3,0,2,5
410855,"2015",0,0,1,1
410855,"2020",1,0,0,1
410860,"2015",2,0,3,5
410860,"2016",1,2,12,15
410860,"2017",5,2,7,14
410860,"2018",5,1,6,12
410860,"2019",3,1,5,9
410860,"2020",4,2,5,11
410860,"2021",3,1,6,10
410860,"2022",4,1,14,19
410860,"2023",5,0,4,9
410865,"2015",1,0,4,5
410865,"2016",2,3,6,11
410865,"2017",1,2,8,11
410865,"2018",2,0,3,5
410865,"2019",0,0,2,2
410865,"2020",0,1,1,2
410865,"2021",0,2,1,3
410865,"2022",0,0,3,3
410865,"2023",1,0,1,2
410870,"2018",0,0,1,1
410870,"2020",0,0,1,1
410870,"2021",1,0,0,1
410870,"2022",2,0,0,2
410880,"2015",5,2,6,13
410880,"2016",6,4,9,19
410880,"2017",6,8,14,28
410880,"2018",10,3,14,27
410880,"2019",3,1,6,10
410880,"2020",3,4,2,9
410880,"2021",1,0,5,6
410880,"2022",3,1,3,7
410880,"2023",0,0,2,2
410890,"2015",1,0,0,1
410890,"2020",0,0,1,1
410890,"2021",2,0,1,3
410890,"2022",1,1,2,4
410890,"2023",3,0,2,5
410895,"2015",1,0,0,1
410895,"2016",2,0,0,2
410895,"2017",1,0,3,4
410895,"2018",1,0,2,3
410895,"2019",0,0,2,2
410895,"2020",0,0,1,1
410895,"2021",1,1,6,8
410895,"2022",3,1,3,7
410895,"2023",2,0,1,3
410900,"2015",0,0,5,5
410900,"2016",1,0,0,1
410900,"2017",2,0,3,5
410900,"2018",0,1,1,2
410900,"2019",1,0,2,3
410900,"2020",1,0,2,3
410900,"2021",0,0,1,1
410900,"2022",3,0,2,5
410900,"2023",2,0,1,3
410910,"2016",0,0,1,1
410910,"2018",1,0,1,2
410910,"2023",0,0,1,1
410920,"2016",0,0,1,1
410920,"2018",2,0,0,2
410930,"2015",2,0,2,4
410930,"2016",3,0,5,8
410930,"2017",2,1,3,6
410930,"2018",1,0,6,7
410930,"2019",1,0,2,3
410930,"2020",1,0,3,4
410930,"2021",1,0,4,5
410930,"2022",2,0,4,6
410930,"2023",1,0,2,3
410940,"2015",40,16,111,167
410940,"2016",50,23,102,175
410940,"2017",60,13,105,178
410940,"2018",56,16,89,161
410940,"2019",37,10,66,113
410940,"2020",40,9,44,93
410940,"2021",33,13,47,93
410940,"2022",13,3,53,69
410940,"2023",20,6,35,61
410950,"2015",0,0,2,2
410950,"2016",1,1,3,5
410950,"2017",1,0,2,3
410950,"2018",1,0,2,3
410950,"2019",1,0,1,2
410950,"2020",1,0,1,2
410950,"2021",1,0,0,1
410950,"2022",1,0,0,1
410950,"2023",0,0,1,1
410960,"2015",9,1,26,36
410960,"2016",14,4,32,50
410960,"2017",2,1,9,12
410960,"2018",1,0,4,5
410960,"2019",0,1,2,3
410960,"2020",1,0,0,1
410960,"2021",5,1,5,11
410960,"2022",6,2,8,16
410960,"2023",2,0,9,11
410965,"2015",0,0,1,1
410965,"2016",0,0,1,1
410965,"2017",1,0,0,1
410965,"2018",1,0,1,2
410965,"2019",0,1,2,3
410965,"2020",1,0,1,2
410965,"2023",1,0,0,1
410970,"2015",0,1,0,1
410970,"2016",4,0,2,6
410970,"2017",1,0,1,2
410970,"2018",2,2,5,9
410970,"2019",2,1,4,7
410970,"2020",1,0,5,6
410970,"2021",1,1,2,4
410970,"2022",3,1,6,10
410970,"2023",1,0,6,7
410975,"2016",0,0,1,1
410975,"2017",0,0,3,3
410975,"2018",1,1,1,3
410975,"2020",2,0,2,4
410975,"2021",1,0,0,1
410975,"2022",0,1,0,1
410975,"2023",0,0,1,1
410980,"2015",11,3,18,32
410980,"2016",7,1,7,15
410980,"2017",11,1,11,23
410980,"2018",17,1,15,33
410980,"2019",7,1,8,16
410980,"2020",6,2,14,22
410980,"2021",3,2,19,24
410980,"2022",6,0,6,12
410980,"2023",2,0,4,6
410990,"2015",0,0,8,8
410990,"2016",3,2,4,9
410990,"2017",2,1,4,7
410990,"2018",2,1,3,6
410990,"2019",2,2,7,11
410990,"2020",0,1,6,7
410990,"2021",1,0,6,7
410990,"2022",1,0,6,7
410990,"2023",1,1,0,2
411000,"2017",0,0,1,1
411000,"2021",0,0,1,1
411000,"2022",1,0,1,2
411000,"2023",1,0,1,2
411005,"2016",0,0,1,1
411005,"2017",1,0,0,1
411007,"2016",0,0,1,1
411007,"2017",2,0,2,4
411007,"2018",2,1,11,14
411007,"2019",1,0,3,4
411007,"2020",0,0,3,3
411007,"2021",2,2,8,12
411010,"2015",5,0,13,18
411010,"2016",4,0,6,10
411010,"2017",2,2,0,4
411010,"2018",4,1,5,10
411010,"2019",1,1,2,4
411010,"2020",3,0,1,4
411010,"2021",6,2,13,21
411010,"2022",13,1,8,22
411010,"2023",10,2,19,31
411020,"2015",4,0,2,6
411020,"2016",3,0,2,5
411020,"2017",2,0,5,7
411020,"2018",0,0,1,1
411020,"2019",0,1,4,5
411020,"2020",0,0,2,2
411020,"2021",4,0,5,9
411020,"2022",1,2,3,6
411020,"2023",0,1,2,3
411030,"2023",0,0,1,1
411040,"2016",1,0,0,1
411040,"2017",1,0,1,2
411040,"2018",0,0,1,1
411040,"2019",1,0,1,2
411040,"2020",0,0,1,1
411040,"2022",0,0,1,1
411040,"2023",2,0,1,3
411050,"2015",3,2,6,11
411050,"2016",2,2,10,14
411050,"2017",5,0,12,17
411050,"2018",4,1,7,12
411050,"2019",1,0,0,1
411050,"2020",0,0,1,1
411050,"2021",1,0,2,3
411050,"2023",2,2,3,7
411060,"2015",0,0,1,1
411060,"2016",0,1,2,3
411060,"2017",2,0,6,8
411060,"2018",3,1,5,9
411060,"2019",5,1,3,9
411060,"2020",1,1,2,4
411060,"2021",0,0,1,1
411065,"2017",0,0,1,1
411065,"2022",1,0,1,2
411065,"2023",1,0,0,1
411070,"2015",7,6,15,28
411070,"2016",9,5,13,27
411070,"2017",2,3,6,11
411070,"2018",3,0,10,13
411070,"2019",4,1,8,13
411070,"2020",6,0,8,14
411070,"2021",23,6,18,47
411070,"2022",23,4,29,56
411070,"2023",10,2,19,31
411080,"2016",0,0,2,2
411080,"2017",0,0,3,3
411080,"2018",0,0,1,1
411080,"2019",1,0,1,2
411080,"2020",3,0,2,5
411080,"2022",0,1,0,1
411080,"2023",1,1,1,3
411090,"2019",0,0,1,1
411090,"2020",0,0,1,1
411090,"2022",1,0,0,1
411090,"2023",0,2,0,2
411095,"2016",0,0,2,2
411095,"2018",1,1,1,3
411095,"2020",0,0,1,1
411095,"2021",1,0,0,1
411100,"2015",0,0,1,1
411100,"2016",0,0,2,2
411100,"2017",1,0,2,3
411100,"2018",1,0,1,2
411100,"2019",0,0,1,1
411100,"2021",1,0,2,3
411110,"2015",3,0,1,4
411110,"2016",0,0,2,2
411110,"2017",2,1,4,7
411110,"2018",0,1,3,4
411110,"2019",1,1,1,3
411110,"2021",1,0,0,1
411110,"2022",0,0,3,3
411110,"2023",0,0,3,3
411120,"2015",0,0,1,1
411120,"2016",6,1,6,13
411120,"2017",4,0,6,10
411120,"2018",4,1,1,6
411120,"2019",5,0,9,14
411120,"2020",3,1,2,6
411120,"2021",1,0,4,5
411120,"2022",1,0,5,6
411120,"2023",2,0,2,4
411125,"2015",6,0,12,18
411125,"2016",7,0,14,21
411125,"2017",4,2,15,21
411125,"2018",5,2,15,22
411125,"2019",7,0,8,15
411125,"2020",5,1,11,17
411125,"2021",6,3,9,18
411125,"2022",7,1,18,26
411125,"2023",6,2,11,19
411130,"2015",1,0,1,2
411130,"2018",0,0,1,1
411130,"2019",1,1,0,2
411130,"2020",0,1,0,1
411130,"2022",0,0,1,1
411130,"2023",0,1,0,1
411140,"2015",1,0,4,5
411140,"2016",0,0,1,1
411140,"2017",0,0,3,3
411140,"2018",0,1,0,1
411140,"2019",0,0,1,1
411140,"2020",0,0,5,5
411140,"2021",0,0,1,1
411140,"2022",0,1,1,2
411140,"2023",2,0,2,4
411150,"2018",0,0,1,1
411150,"2019",0,0,1,1
411150,"2020",1,2,9,12
411150,"2021",3,2,1,6
411150,"2022",3,0,0,3
411150,"2023",0,0,1,1
411155,"2015",1,0,1,2
411155,"2016",2,1,2,5
411155,"2017",1,0,0,1
411155,"2018",1,0,1,2
411155,"2019",0,1,0,1
411155,"2020",1,0,1,2
411155,"2021",0,1,1,2
411155,"2022",1,0,1,2
411155,"2023",1,0,1,2
411160,"2016",0,0,1,1
411160,"2019",0,0,1,1
411160,"2020",1,0,0,1
411160,"2021",1,0,0,1
411170,"2015",1,0,0,1
411170,"2016",2,0,0,2
411170,"2017",4,0,5,9
411170,"2018",1,0,0,1
411170,"2019",1,0,2,3
411170,"2020",0,0,1,1
411170,"2021",0,0,2,2
411170,"2022",0,0,1,1
411170,"2023",1,0,2,3
411180,"2015",8,3,12,23
411180,"2016",14,2,20,36
411180,"2017",8,1,19,28
411180,"2018",10,1,26,37
411180,"2019",10,2,17,29
411180,"2020",9,2,10,21
411180,"2021",11,3,18,32
411180,"2022",9,3,18,30
411180,"2023",7,3,21,31
411190,"2015",0,0,2,2
411190,"2016",1,0,2,3
411190,"2019",3,0,3,6
411190,"2020",0,0,1,1
411190,"2021",1,0,1,2
411190,"2022",1,0,0,1
411190,"2023",0,2,0,2
411200,"2015",1,0,3,4
411200,"2016",3,1,5,9
411200,"2017",3,0,1,4
411200,"2018",5,1,2,8
411200,"2019",4,1,3,8
411200,"2020",2,0,1,3
411200,"2021",2,0,2,4
411200,"2022",0,0,2,2
411200,"2023",0,1,0,1
411210,"2015",4,1,13,18
411210,"2016",5,0,13,18
411210,"2017",6,1,5,12
411210,"2018",7,2,6,15
411210,"2019",1,0,6,7
411210,"2020",2,3,7,12
411210,"2021",2,0,2,4
411210,"2022",0,0,5,5
411210,"2023",1,0,2,3
411220,"2015",2,0,0,2
411220,"2016",1,0,1,2
411220,"2017",1,0,0,1
411220,"2018",0,0,1,1
411220,"2020",2,0,1,3
411220,"2021",1,1,0,2
411220,"2022",2,0,2,4
411220,"2023",0,1,1,2
411230,"2015",0,0,1,1
411230,"2016",0,0,1,1
411230,"2017",1,0,0,1
411230,"2018",2,0,2,4
411230,"2019",1,0,0,1
411230,"2020",1,0,2,3
411230,"2021",0,0,1,1
411230,"2022",2,0,3,5
411230,"2023",1,0,1,2
411240,"2016",0,0,1,1
411240,"2017",0,0,2,2
411240,"2018",0,1,2,3
411240,"2021",0,0,1,1
411240,"2022",0,0,1,1
411240,"2023",1,1,0,2
411250,"2021",0,0,1,1
411260,"2017",0,0,1,1
411260,"2022",1,0,1,2
411270,"2015",1,0,3,4
411270,"2016",3,0,5,8
411270,"2017",0,1,2,3
411270,"2018",1,0,4,5
411270,"2019",3,0,5,8
411270,"2020",2,0,3,5
411270,"2021",1,1,5,7
411270,"2022",1,0,1,2
411270,"2023",0,0,3,3
411275,"2016",0,0,2,2
411275,"2017",0,0,1,1
411275,"2018",0,0,1,1
411275,"2021",1,0,1,2
411275,"2022",0,0,1,1
411280,"2015",4,1,2,7
411280,"2016",0,0,2,2
411280,"2017",2,1,2,5
411280,"2018",1,0,2,3
411280,"2019",2,0,5,7
411280,"2020",1,0,5,6
411280,"2021",1,0,4,5
411280,"2022",2,0,2,4
411280,"2023",0,1,4,5
411290,"2015",0,0,2,2
411290,"2016",1,1,0,2
411290,"2017",1,0,1,2
411290,"2018",0,0,3,3
411290,"2019",0,0,1,1
411290,"2021",0,0,1,1
411290,"2022",2,0,1,3
411295,"2015",2,0,0,2
411295,"2017",1,0,0,1
411295,"2018",1,0,1,2
411295,"2019",0,1,1,2
411295,"2020",0,1,0,1
411295,"2021",3,0,1,4
411295,"2022",0,0,2,2
411295,"2023",1,0,1,2
411300,"2016",0,0,1,1
411300,"2017",1,0,1,2
411300,"2018",0,0,1,1
411300,"2019",0,0,3,3
411300,"2021",0,0,1,1
411300,"2022",0,0,1,1
411300,"2023",1,0,1,2
411310,"2018",0,0,1,1
411310,"2021",0,0,1,1
411320,"2015",9,5,6,20
411320,"2016",12,2,11,25
411320,"2017",5,1,5,11
411320,"2018",2,3,9,14
411320,"2019",4,0,2,6
411320,"2020",5,2,6,13
411320,"2021",1,0,7,8
411320,"2022",4,1,5,10
411320,"2023",5,0,4,9
411325,"2015",0,0,4,4
411325,"2017",0,0,2,2
411325,"2018",1,0,5,6
411325,"2019",0,0,2,2
411325,"2020",1,2,1,4
411325,"2021",0,0,7,7
411325,"2022",1,0,1,2
411325,"2023",0,0,1,1
411330,"2015",4,1,6,11
411330,"2016",4,1,12,17
411330,"2017",3,0,3,6
411330,"2018",0,0,2,2
411330,"2019",0,2,3,5
411330,"2020",2,0,4,6
411330,"2021",0,0,1,1
411330,"2022",0,2,1,3
411330,"2023",0,0,3,3
411340,"2017",1,0,2,3
411340,"2019",1,0,1,2
411340,"2021",0,0,1,1
411342,"2016",0,0,1,1
411342,"2021",0,0,1,1
411342,"2023",0,0,1,1
411345,"2015",0,0,1,1
411345,"2016",1,0,0,1
411345,"2017",1,0,0,1
411345,"2018",1,0,2,3
411345,"2019",1,0,3,4
411345,"2020",1,0,1,2
411345,"2021",0,0,8,8
411345,"2022",3,0,1,4
411345,"2023",0,1,0,1
411350,"2015",1,2,3,6
411350,"2016",1,0,2,3
411350,"2017",1,0,0,1
411350,"2018",2,0,0,2
411350,"2019",0,0,2,2
411350,"2023",6,1,5,12
411360,"2017",0,1,1,2
411360,"2019",0,0,1,1
411360,"2020",0,1,1,2
411360,"2022",0,0,2,2
411370,"2015",36,5,71,112
411370,"2016",47,8,65,120
411370,"2017",43,9,91,143
411370,"2018",51,10,93,154
411370,"2019",50,12,87,149
411370,"2020",24,10,39,73
411370,"2021",27,7,43,77
411370,"2022",24,3,33,60
411370,"2023",13,2,19,34
411373,"2015",2,1,2,5
411373,"2016",0,0,2,2
411373,"2017",1,0,0,1
411373,"2018",2,0,1,3
411373,"2019",1,0,1,2
411373,"2020",0,0,5,5
411373,"2021",1,0,2,3
411373,"2022",0,1,1,2
411380,"2019",1,0,0,1
411390,"2015",1,0,2,3
411390,"2016",1,0,3,4
411390,"2017",1,1,0,2
411390,"2018",0,0,1,1
411390,"2019",0,1,0,1
411390,"2020",0,0,1,1
411390,"2021",5,1,4,10
411390,"2022",2,0,3,5
411400,"2015",0,0,1,1
411400,"2016",0,0,1,1
411400,"2018",0,0,1,1
411400,"2019",1,0,4,5
411400,"2020",3,0,1,4
411400,"2021",3,0,0,3
411400,"2022",1,1,4,6
411400,"2023",1,1,1,3
411410,"2015",3,0,3,6
411410,"2016",1,0,7,8
411410,"2017",4,0,7,11
411410,"2018",0,0,2,2
411410,"2019",9,0,3,12
411410,"2020",3,1,3,7
411410,"2021",0,0,4,4
411410,"2022",2,1,1,4
411410,"2023",1,1,1,3
411420,"2015",2,0,4,6
411420,"2016",0,0,3,3
411420,"2017",3,0,9,12
411420,"2018",0,0,2,2
411420,"2019",2,1,2,5
411420,"2020",0,1,0,1
411420,"2021",4,0,8,12
411420,"2022",2,0,2,4
411420,"2023",1,2,3,6
411430,"2015",3,0,7,10
411430,"2016",1,1,6,8
411430,"2017",4,0,8,12
411430,"2018",1,3,6,10
411430,"2019",4,3,6,13
411430,"2020",3,5,6,14
411430,"2021",2,1,3,6
411430,"2022",2,1,3,6
411430,"2023",1,1,3,5
411435,"2016",0,0,1,1
411435,"2017",0,0,2,2
411435,"2019",1,0,1,2
411435,"2021",1,0,1,2
411440,"2016",1,0,0,1
411440,"2017",0,0,1,1
411440,"2018",0,0,1,1
411440,"2019",1,1,1,3
411440,"2020",2,0,3,5
411440,"2021",1,0,1,2
411440,"2022",2,0,3,5
411440,"2023",2,1,3,6
411450,"2015",1,0,4,5
411450,"2017",2,0,0,2
411450,"2018",0,0,1,1
411450,"2020",1,0,2,3
411450,"2021",0,0,1,1
411450,"2022",0,0,1,1
411450,"2023",0,0,1,1
411460,"2015",5,4,11,20
411460,"2016",9,0,7,16
411460,"2017",4,3,25,32
411460,"2018",8,5,13,26
411460,"2019",6,7,17,30
411460,"2020",10,5,11,26
411460,"2021",5,2,11,18
411460,"2022",9,3,15,27
411460,"2023",1,0,10,11
411470,"2015",3,0,4,7
411470,"2016",0,1,1,2
411470,"2017",1,0,2,3
411470,"2018",4,0,2,6
411470,"2019",0,1,2,3
411470,"2021",1,1,2,4
411470,"2022",0,0,1,1
411470,"2023",0,1,0,1
411480,"2015",4,0,2,6
411480,"2016",6,2,4,12
411480,"2017",8,3,12,23
411480,"2018",4,2,2,8
411480,"2019",5,2,5,12
411480,"2020",5,1,6,12
411480,"2021",9,1,7,17
411480,"2022",8,2,10,20
411480,"2023",5,0,2,7
411490,"2015",0,0,1,1
411490,"2016",2,0,2,4
411490,"2017",1,0,5,6
411490,"2018",3,1,1,5
411490,"2019",0,0,5,5
411490,"2020",2,0,2,4
411490,"2021",1,1,2,4
411490,"2022",1,0,2,3
411490,"2023",0,0,1,1
411500,"2019",0,0,1,1
411500,"2021",1,0,4,5
411500,"2022",3,1,1,5
411500,"2023",1,0,5,6
411510,"2015",1,0,5,6
411510,"2016",4,1,4,9
411510,"2017",3,0,8,11
411510,"2018",3,2,7,12
411510,"2019",1,1,8,10
411510,"2020",1,0,1,2
411510,"2021",5,1,13,19
411510,"2022",5,0,2,7
411510,"2023",0,1,3,4
411520,"2015",52,8,57,117
411520,"2016",33,11,70,114
411520,"2017",50,8,74,132
411520,"2018",38,4,51,93
411520,"2019",56,11,75,142
411520,"2020",23,10,39,72
411520,"2021",22,6,25,53
411520,"2022",20,9,27,56
411520,"2023",11,11,30,52
411530,"2016",1,1,2,4
411530,"2017",2,3,3,8
411530,"2018",2,1,4,7
411530,"2019",6,0,0,6
411530,"2020",1,0,2,3
411530,"2021",0,1,3,4
411530,"2022",0,0,3,3
411535,"2015",0,0,1,1
411535,"2016",0,1,2,3
411535,"2017",1,0,2,3
411535,"2018",1,0,2,3
411535,"2019",1,0,0,1
411535,"2020",0,2,1,3
411535,"2021",0,2,0,2
411535,"2022",0,1,2,3
411535,"2023",0,0,3,3
411540,"2015",3,1,11,15
411540,"2016",4,0,6,10
411540,"2017",5,4,4,13
411540,"2018",2,0,5,7
411540,"2019",1,0,0,1
411540,"2020",0,2,0,2
411540,"2021",0,1,1,2
411540,"2022",2,0,2,4
411540,"2023",2,0,1,3
411545,"2016",0,0,1,1
411550,"2015",0,0,2,2
411550,"2016",1,0,1,2
411550,"2017",2,0,0,2
411550,"2018",0,0,2,2
411550,"2019",2,0,0,2
411550,"2020",1,1,1,3
411550,"2021",2,0,2,4
411550,"2023",0,0,1,1
411560,"2015",1,1,2,4
411560,"2016",4,2,6,12
411560,"2017",1,0,1,2
411560,"2018",0,1,0,1
411560,"2019",0,0,1,1
411560,"2020",2,0,1,3
411560,"2021",0,0,1,1
411560,"2022",1,0,0,1
411560,"2023",1,1,1,3
411570,"2015",10,2,17,29
411570,"2016",19,5,10,34
411570,"2017",12,9,20,41
411570,"2018",11,3,8,22
411570,"2019",10,4,8,22
411570,"2020",2,4,12,18
411570,"2021",7,1,15,23
411570,"2022",11,8,11,30
411570,"2023",2,2,14,18
411573,"2015",0,0,1,1
411573,"2018",0,0,1,1
411573,"2020",0,1,0,1
411575,"2015",1,1,5,7
411575,"2016",1,0,2,3
411575,"2017",0,0,2,2
411575,"2018",0,1,5,6
411575,"2019",2,2,2,6
411575,"2020",2,0,1,3
411575,"2021",2,1,2,5
411575,"2022",1,1,1,3
411580,"2015",4,1,3,8
411580,"2016",9,2,14,25
411580,"2017",10,1,8,19
411580,"2018",10,2,9,21
411580,"2019",11,1,11,23
411580,"2020",10,4,14,28
411580,"2021",8,7,13,28
411580,"2022",10,4,24,38
411580,"2023",5,4,15,24
411585,"2017",2,0,1,3
411585,"2019",1,0,1,2
411585,"2020",0,0,1,1
411585,"2021",0,0,1,1
411585,"2022",2,0,0,2
411585,"2023",0,0,1,1
411590,"2015",1,0,1,2
411590,"2018",1,0,0,1
411590,"2022",1,0,0,1
411590,"2023",1,0,2,3
411600,"2018",0,0,1,1
411605,"2015",1,0,0,1
411605,"2016",1,0,0,1
411605,"2017",0,0,3,3
411605,"2018",1,0,0,1
411605,"2019",1,0,0,1
411605,"2020",0,1,1,2
411605,"2022",0,1,0,1
411610,"2015",1,0,4,5
411610,"2016",1,1,1,3
411610,"2017",1,0,6,7
411610,"2018",2,0,1,3
411610,"2019",1,0,2,3
411610,"2020",2,0,4,6
411610,"2021",1,0,2,3
411610,"2022",4,0,2,6
411620,"2015",2,1,0,3
411620,"2016",0,1,4,5
411620,"2017",1,0,4,5
411620,"2018",2,0,4,6
411620,"2019",3,0,3,6
411620,"2020",2,1,0,3
411620,"2021",0,0,1,1
411620,"2023",1,2,0,3
411630,"2015",0,0,1,1
411630,"2016",0,0,1,1
411630,"2018",0,0,1,1
411630,"2019",0,0,1,1
411630,"2020",0,0,2,2
411630,"2021",0,1,1,2
411630,"2022",1,0,1,2
411630,"2023",2,0,0,2
411640,"2016",0,0,2,2
411640,"2018",0,0,1,1
411640,"2019",1,0,0,1
411640,"2020",0,0,2,2
411660,"2018",1,0,0,1
411660,"2023",0,0,1,1
411670,"2016",0,0,2,2
411670,"2017",0,0,1,1
411670,"2018",1,1,2,4
411670,"2019",1,0,2,3
411670,"2020",2,0,1,3
411670,"2021",2,1,3,6
411670,"2022",0,0,1,1
411680,"2015",2,3,3,8
411680,"2018",0,0,1,1
411680,"2019",0,1,1,2
411680,"2020",0,0,2,2
411680,"2021",1,0,3,4
411690,"2015",1,1,0,2
411690,"2016",1,0,1,2
411690,"2017",0,0,1,1
411690,"2018",1,0,0,1
411690,"2019",1,0,2,3
411690,"2020",1,1,3,5
411690,"2022",0,0,1,1
411690,"2023",1,1,0,2
411695,"2015",1,0,1,2
411695,"2016",2,1,3,6
411695,"2017",1,0,3,4
411695,"2018",0,0,5,5
411695,"2019",0,0,1,1
411695,"2020",2,0,1,3
411695,"2021",0,0,1,1
411695,"2023",1,0,0,1
411700,"2015",0,0,1,1
411700,"2016",0,1,0,1
411700,"2017",1,0,0,1
411700,"2023",0,0,4,4
411705,"2015",1,0,2,3
411705,"2016",3,0,2,5
411705,"2017",0,0,1,1
411705,"2022",0,0,2,2
411710,"2015",1,0,2,3
411710,"2020",0,0,1,1
411710,"2022",3,0,5,8
411710,"2023",2,1,2,5
411720,"2015",0,0,1,1
411720,"2016",1,0,1,2
411720,"2017",1,0,2,3
411720,"2018",2,0,4,6
411720,"2019",2,0,1,3
411720,"2020",0,0,2,2
411720,"2021",0,0,1,1
411720,"2022",3,1,2,6
411720,"2023",1,0,0,1
411721,"2015",0,0,1,1
411721,"2016",0,0,2,2
411721,"2017",0,0,3,3
411721,"2018",0,0,1,1
411722,"2015",1,0,0,1
411722,"2016",0,0,1,1
411722,"2017",4,0,4,8
411722,"2018",1,1,1,3
411722,"2019",3,0,2,5
411722,"2020",0,1,2,3
411722,"2021",1,0,5,6
411722,"2022",2,0,2,4
411722,"2023",2,0,3,5
411725,"2015",0,0,2,2
411725,"2016",2,0,3,5
411725,"2017",1,0,0,1
411725,"2018",1,1,2,4
411725,"2019",1,0,0,1
411725,"2020",0,0,1,1
411725,"2021",2,0,0,2
411725,"2023",1,0,1,2
411727,"2015",0,0,1,1
411727,"2016",1,2,4,7
411727,"2017",1,0,1,2
411727,"2018",0,0,1,1
411727,"2019",2,0,1,3
411727,"2020",0,0,2,2
411727,"2021",0,0,2,2
411729,"2015",0,0,1,1
411729,"2016",1,0,1,2
411729,"2017",1,0,0,1
411729,"2019",0,1,0,1
411729,"2020",0,0,2,2
411729,"2021",0,0,2,2
411729,"2022",0,0,1,1
411729,"2023",1,0,1,2
411730,"2015",1,0,0,1
411730,"2016",1,0,4,5
411730,"2017",1,0,5,6
411730,"2018",3,0,6,9
411730,"2019",1,0,1,2
411730,"2020",2,0,3,5
411730,"2021",5,0,3,8
411730,"2022",1,1,1,3
411730,"2023",0,0,1,1
411740,"2015",1,0,1,2
411740,"2016",0,0,1,1
411740,"2017",0,0,2,2
411740,"2019",1,0,0,1
411740,"2020",0,0,1,1
411745,"2015",0,1,1,2
411745,"2016",0,0,1,1
411745,"2017",0,0,2,2
411745,"2018",5,2,2,9
411745,"2019",2,0,2,4
411745,"2020",2,0,1,3
411745,"2021",0,0,3,3
411745,"2023",0,0,1,1
411750,"2015",5,1,6,12
411750,"2016",4,1,7,12
411750,"2017",3,2,13,18
411750,"2018",4,1,9,14
411750,"2019",7,2,9,18
411750,"2020",7,0,10,17
411750,"2021",2,1,6,9
411750,"2022",3,0,6,9
411750,"2023",1,1,6,8
411760,"2015",5,1,9,15
411760,"2016",12,2,21,35
411760,"2017",4,1,7,12
411760,"2018",1,0,4,5
411760,"2019",3,0,11,14
411760,"2020",5,0,7,12
411760,"2021",3,0,6,9
411760,"2022",0,0,5,5
411760,"2023",4,0,8,12
411770,"2015",0,2,8,10
411770,"2016",1,0,3,4
411770,"2017",3,1,6,10
411770,"2018",0,1,5,6
411770,"2019",2,2,3,7
411770,"2020",5,4,1,10
411770,"2021",2,1,3,6
411770,"2022",2,1,2,5
411770,"2023",1,1,6,8
411780,"2015",1,1,5,7
411780,"2016",0,1,4,5
411780,"2017",2,2,5,9
411780,"2018",3,2,10,15
411780,"2019",4,2,4,10
411780,"2020",0,0,6,6
411780,"2021",1,0,5,6
411780,"2022",2,0,4,6
411780,"2023",3,1,4,8
411790,"2015",1,0,9,10
411790,"2016",3,1,8,12
411790,"2017",1,1,1,3
411790,"2018",0,0,5,5
411790,"2019",0,0,1,1
411790,"2020",1,0,0,1
411790,"2021",10,0,8,18
411790,"2022",6,5,15,26
411790,"2023",7,1,13,21
411800,"2015",0,0,2,2
411800,"2016",0,0,2,2
411800,"2017",1,0,1,2
411800,"2018",0,0,1,1
411800,"2021",1,0,2,3
411800,"2022",3,2,9,14
411800,"2023",0,0,4,4
411810,"2017",0,0,1,1
411810,"2019",1,0,1,2
411810,"2020",1,0,0,1
411810,"2021",1,0,4,5
411810,"2022",2,0,4,6
411820,"2015",29,6,39,74
411820,"2016",28,12,58,98
411820,"2017",21,6,49,76
411820,"2018",16,4,32,52
411820,"2019",19,2,30,51
411820,"2020",9,1,9,19
411820,"2021",8,3,10,21
411820,"2022",11,6,18,35
411820,"2023",11,6,16,33
411830,"2016",1,0,0,1
411830,"2022",1,0,0,1
411830,"2023",0,0,1,1
411840,"2015",5,0,7,12
411840,"2016",0,0,1,1
411840,"2017",2,1,3,6
411840,"2018",0,0,5,5
411840,"2019",0,0,2,2
411840,"2020",1,1,4,6
411840,"2021",9,3,15,27
411840,"2022",28,7,39,74
411840,"2023",23,9,20,52
411845,"2015",0,1,0,1
411845,"2016",0,0,2,2
411845,"2017",1,0,0,1
411845,"2018",0,0,1,1
411845,"2019",2,0,1,3
411845,"2021",0,0,1,1
411845,"2022",1,0,2,3
411845,"2023",0,0,3,3
411850,"2015",0,0,13,13
411850,"2016",22,1,29,52
411850,"2017",20,1,33,54
411850,"2018",33,11,50,94
411850,"2019",21,12,42,75
411850,"2020",17,7,35,59
411850,"2021",23,5,39,67
411850,"2022",19,12,43,74
411850,"2023",19,7,34,60
411860,"2015",1,0,1,2
411860,"2016",1,1,0,2
411860,"2017",1,0,4,5
411860,"2018",2,0,5,7
411860,"2019",1,0,3,4
411860,"2020",0,0,2,2
411860,"2021",0,0,1,1
411860,"2022",1,1,0,2
411860,"2023",3,1,3,7
411870,"2015",0,0,2,2
411870,"2016",0,0,1,1
411870,"2017",2,0,0,2
411870,"2018",1,0,1,2
411870,"2019",1,0,2,3
411870,"2020",1,0,2,3
411870,"2021",1,0,0,1
411870,"2022",1,0,1,2
411870,"2023",0,0,2,2
411880,"2015",0,0,3,3
411880,"2016",0,0,1,1
411880,"2017",1,0,0,1
411880,"2018",0,1,2,3
411880,"2019",2,1,3,6
411880,"2020",0,0,2,2
411880,"2021",2,0,3,5
411880,"2022",1,0,0,1
411880,"2023",1,0,1,2
411885,"2015",5,0,4,9
411885,"2016",1,0,7,8
411885,"2017",3,0,1,4
411885,"2018",2,1,4,7
411885,"2019",1,0,4,5
411885,"2020",3,1,4,8
411885,"2021",3,1,1,5
411885,"2022",0,0,3,3
411885,"2023",0,0,3,3
411890,"2015",2,1,9,12
411890,"2016",0,2,5,7
411890,"2017",5,0,3,8
411890,"2018",8,3,6,17
411890,"2019",2,0,5,7
411890,"2020",0,1,1,2
411890,"2021",0,0,2,2
411890,"2022",4,1,1,6
411900,"2015",2,0,2,4
411900,"2016",0,1,1,2
411900,"2017",1,0,0,1
411900,"2019",0,0,1,1
411900,"2020",2,0,1,3
411900,"2021",1,0,0,1
411900,"2022",0,0,1,1
411900,"2023",0,1,0,1
411910,"2015",1,2,3,6
411910,"2016",3,0,5,8
411910,"2017",0,0,4,4
411910,"2018",1,0,4,5
411910,"2019",3,2,4,9
411910,"2020",0,0,3,3
411910,"2021",2,2,6,10
411910,"2022",1,2,8,11
411910,"2023",2,0,1,3
411915,"2015",35,9,65,109
411915,"2016",28,7,45,80
411915,"2017",33,15,55,103
411915,"2018",36,11,67,114
411915,"2019",55,8,83,146
411915,"2020",46,11,55,112
411915,"2021",29,13,57,99
411915,"2022",31,13,43,87
411915,"2023",18,6,32,56
411920,"2017",1,0,0,1
411920,"2020",0,0,4,4
411920,"2022",0,0,1,1
411930,"2015",0,0,4,4
411930,"2016",3,4,24,31
411930,"2017",8,0,12,20
411930,"2018",0,0,7,7
411930,"2019",2,1,4,7
411930,"2020",3,0,13,16
411930,"2021",4,1,7,12
411930,"2022",2,0,5,7
411930,"2023",2,0,6,8
411940,"2015",2,2,4,8
411940,"2016",2,1,6,9
411940,"2017",6,0,7,13
411940,"2018",5,2,12,19
411940,"2019",7,1,9,17
411940,"2020",3,1,15,19
411940,"2021",2,2,13,17
411940,"2022",4,0,5,9
411940,"2023",0,1,5,6
411950,"2015",22,3,30,55
411950,"2016",17,9,48,74
411950,"2017",19,2,43,64
411950,"2018",34,14,50,98
411950,"2019",29,3,46,78
411950,"2020",27,14,60,101
411950,"2021",22,9,57,88
411950,"2022",23,13,28,64
411950,"2023",24,6,27,57
411960,"2015",6,2,11,19
411960,"2016",5,2,8,15
411960,"2017",16,4,17,37
411960,"2018",20,3,17,40
411960,"2019",17,4,33,54
411960,"2020",5,2,17,24
411960,"2021",7,1,12,20
411960,"2022",3,0,6,9
411960,"2023",1,2,11,14
411970,"2020",0,0,1,1
411970,"2021",0,0,3,3
411970,"2022",1,0,4,5
411970,"2023",2,0,2,4
411980,"2017",0,0,1,1
411980,"2018",2,0,0,2
411980,"2020",1,0,0,1
411980,"2021",1,1,0,2
411980,"2022",4,2,0,6
411980,"2023",4,1,0,5
411990,"2015",85,21,190,296
411990,"2016",70,10,160,240
411990,"2017",83,29,152,264
411990,"2018",50,22,70,142
411990,"2019",23,7,27,57
411990,"2020",25,11,35,71
411990,"2021",10,4,13,27
411990,"2022",16,4,17,37
411990,"2023",30,7,34,71
411995,"2015",5,0,3,8
411995,"2016",5,0,11,16
411995,"2017",3,0,12,15
411995,"2018",2,1,7,10
411995,"2019",0,2,3,5
411995,"2020",1,0,1,2
411995,"2021",2,0,2,4
411995,"2022",2,3,6,11
411995,"2023",2,0,5,7
412000,"2015",0,1,1,2
412000,"2016",1,0,1,2
412000,"2017",2,0,0,2
412000,"2018",0,0,1,1
412000,"2020",1,0,1,2
412000,"2021",2,0,0,2
412000,"2022",0,0,1,1
412000,"2023",0,0,2,2
412010,"2016",0,0,2,2
412010,"2017",1,0,2,3
412010,"2018",2,0,0,2
412010,"2019",0,1,3,4
412010,"2020",0,0,1,1
412010,"2021",2,0,2,4
412010,"2022",0,1,0,1
412010,"2023",1,0,0,1
412015,"2016",0,2,0,2
412020,"2015",0,0,2,2
412020,"2016",0,1,0,1
412020,"2021",1,0,0,1
412020,"2022",0,0,1,1
412020,"2023",0,0,3,3
412030,"2015",3,0,1,4
412030,"2016",2,0,2,4
412030,"2017",1,0,4,5
412030,"2018",1,0,1,2
412030,"2019",0,0,1,1
412030,"2020",1,0,1,2
412030,"2021",0,0,1,1
412030,"2022",0,0,2,2
412030,"2023",1,1,0,2
412033,"2016",1,0,1,2
412033,"2017",0,0,1,1
412033,"2019",1,0,0,1
412035,"2015",0,0,1,1
412035,"2016",1,1,2,4
412035,"2017",0,0,1,1
412035,"2019",0,0,1,1
412035,"2020",1,0,1,2
412035,"2021",1,1,0,2
412035,"2023",0,0,1,1
412040,"2015",1,0,0,1
412040,"2016",1,0,0,1
412040,"2017",1,0,3,4
412040,"2018",1,0,1,2
412040,"2019",1,0,1,2
412040,"2020",2,0,0,2
412040,"2021",1,0,0,1
412040,"2022",0,0,1,1
412050,"2015",0,0,2,2
412050,"2016",1,0,1,2
412050,"2017",1,0,2,3
412050,"2018",0,0,1,1
412050,"2019",0,0,1,1
412050,"2020",3,0,0,3
412050,"2021",1,0,0,1
412050,"2022",0,1,1,2
412050,"2023",2,0,0,2
412060,"2015",2,2,5,9
412060,"2016",1,1,6,8
412060,"2017",3,0,6,9
412060,"2018",6,1,11,18
412060,"2019",3,1,3,7
412060,"2020",1,0,0,1
412060,"2021",0,0,4,4
412060,"2022",3,0,0,3
412060,"2023",1,0,3,4
412065,"2015",2,0,0,2
412065,"2016",0,0,1,1
412065,"2017",0,0,5,5
412065,"2018",1,0,0,1
412065,"2019",1,0,2,3
412065,"2020",1,0,2,3
412065,"2023",0,0,1,1
412070,"2015",1,0,0,1
412070,"2016",0,0,1,1
412070,"2017",1,1,2,4
412070,"2018",0,0,1,1
412070,"2020",1,0,0,1
412070,"2021",3,1,0,4
412070,"2022",1,0,3,4
412070,"2023",1,0,2,3
412080,"2015",7,0,7,14
412080,"2016",0,1,3,4
412080,"2017",5,0,7,12
412080,"2018",8,0,9,17
412080,"2019",4,1,10,15
412080,"2020",3,0,4,7
412080,"2021",2,0,7,9
412080,"2022",4,1,4,9
412080,"2023",1,0,1,2
412085,"2015",1,0,1,2
412085,"2018",0,0,1,1
412085,"2020",0,0,2,2
412085,"2021",0,1,0,1
412085,"2023",0,0,1,1
412090,"2015",2,1,3,6
412090,"2016",2,1,1,4
412090,"2017",3,2,8,13
412090,"2018",1,0,7,8
412090,"2019",0,0,1,1
412090,"2020",1,1,0,2
412090,"2021",0,1,8,9
412090,"2022",0,1,4,5
412090,"2023",0,1,4,5
412100,"2015",1,0,2,3
412100,"2016",0,1,1,2
412100,"2017",0,0,2,2
412100,"2018",0,0,1,1
412100,"2021",1,0,1,2
412100,"2022",1,0,1,2
412100,"2023",0,0,4,4
412110,"2015",3,1,3,7
412110,"2017",0,0,2,2
412110,"2018",0,1,2,3
412110,"2019",1,0,1,2
412110,"2020",2,0,2,4
412110,"2022",1,0,0,1
412120,"2015",3,1,5,9
412120,"2016",1,0,7,8
412120,"2017",1,1,4,6
412120,"2018",1,1,3,5
412120,"2019",1,0,6,7
412120,"2020",2,0,5,7
412120,"2021",3,0,7,10
412120,"2022",1,1,5,7
412120,"2023",2,2,5,9
412125,"2016",1,1,2,4
412125,"2017",1,0,0,1
412125,"2018",0,0,2,2
412125,"2020",0,0,1,1
412125,"2022",1,0,0,1
412130,"2015",0,1,0,1
412130,"2016",1,0,0,1
412130,"2017",0,0,1,1
412130,"2019",1,0,0,1
412135,"2015",2,0,2,4
412135,"2016",1,0,1,2
412135,"2021",0,0,1,1
412135,"2022",0,0,1,1
412135,"2023",0,0,1,1
412140,"2015",2,0,3,5
412140,"2016",1,0,4,5
412140,"2017",0,0,5,5
412140,"2018",3,0,1,4
412140,"2019",2,2,0,4
412140,"2020",0,0,1,1
412140,"2022",2,0,1,3
412140,"2023",4,1,2,7
412150,"2015",0,1,4,5
412150,"2016",1,0,2,3
412150,"2017",1,0,3,4
412150,"2018",1,2,1,4
412150,"2019",0,0,2,2
412150,"2020",0,0,1,1
412150,"2021",0,1,8,9
412150,"2022",8,1,5,14
412150,"2023",6,2,5,13
412160,"2016",1,0,1,2
412160,"2017",1,0,1,2
412160,"2019",0,1,0,1
412160,"2021",0,1,0,1
412170,"2015",0,0,2,2
412170,"2016",0,0,2,2
412170,"2018",3,1,4,8
412170,"2019",1,0,1,2
412170,"2020",0,0,4,4
412170,"2021",7,5,7,19
412170,"2022",2,0,0,2
412175,"2015",0,1,1,2
412175,"2016",1,0,0,1
412175,"2019",1,0,0,1
412175,"2022",0,0,1,1
412180,"2015",1,0,0,1
412180,"2016",3,0,5,8
412180,"2017",3,1,1,5
412180,"2018",1,0,1,2
412180,"2019",0,0,4,4
412180,"2020",0,0,1,1
412180,"2021",1,0,0,1
412180,"2022",1,0,4,5
412180,"2023",4,1,0,5
412190,"2015",2,1,6,9
412190,"2016",2,1,5,8
412190,"2017",0,0,4,4
412190,"2018",0,1,4,5
412190,"2019",1,0,3,4
412190,"2021",0,0,1,1
412200,"2015",4,0,4,8
412200,"2016",0,0,1,1
412200,"2017",1,0,0,1
412200,"2018",2,0,3,5
412200,"2019",3,0,3,6
412200,"2020",1,0,2,3
412200,"2021",6,0,4,10
412200,"2022",2,0,1,3
412200,"2023",0,0,2,2
412210,"2015",0,0,2,2
412210,"2016",1,0,1,2
412210,"2017",0,0,1,1
412210,"2018",1,0,0,1
412210,"2022",0,1,1,2
412215,"2015",1,1,2,4
412215,"2016",2,0,3,5
412215,"2017",2,0,0,2
412215,"2019",1,0,2,3
412215,"2020",1,0,1,2
412215,"2022",1,0,0,1
412217,"2017",0,0,1,1
412217,"2022",1,0,0,1
412220,"2015",11,1,14,26
412220,"2016",6,3,11,20
412220,"2017",1,2,15,18
412220,"2018",3,1,27,31
412220,"2019",3,1,17,21
412220,"2020",8,0,7,15
412220,"2021",6,0,12,18
412220,"2022",7,6,11,24
412220,"2023",4,2,15,21
412230,"2015",7,2,5,14
412230,"2016",1,1,7,9
412230,"2017",8,1,4,13
412230,"2018",1,1,7,9
412230,"2019",3,0,8,11
412230,"2020",0,3,2,5
412230,"2021",4,0,3,7
412230,"2022",0,1,2,3
412240,"2015",1,0,3,4
412240,"2016",7,1,12,20
412240,"2017",0,0,1,1
412240,"2018",3,0,3,6
412240,"2019",5,2,6,13
412240,"2020",1,0,2,3
412240,"2021",1,0,1,2
412240,"2022",4,1,3,8
412240,"2023",2,2,1,5
412250,"2015",1,0,1,2
412250,"2017",0,0,2,2
412250,"2018",1,0,1,2
412250,"2019",1,0,2,3
412250,"2021",0,0,2,2
412250,"2022",1,0,0,1
412260,"2016",4,1,3,8
412260,"2017",0,1,2,3
412260,"2018",0,1,1,2
412260,"2021",0,0,1,1
412260,"2022",1,0,1,2
412265,"2019",1,0,0,1
412265,"2021",0,0,2,2
412280,"2015",0,1,0,1
412280,"2016",0,0,1,1
412280,"2017",1,0,0,1
412280,"2020",2,0,0,2
412280,"2022",1,0,0,1
412290,"2015",0,1,0,1
412290,"2017",0,0,1,1
412290,"2021",0,0,1,1
412290,"2022",2,0,1,3
412300,"2015",1,0,6,7
412300,"2016",4,0,1,5
412300,"2017",5,0,10,15
412300,"2018",6,2,10,18
412300,"2019",1,0,1,2
412300,"2020",1,0,0,1
412300,"2021",0,0,2,2
412300,"2022",0,0,1,1
412300,"2023",0,0,1,1
412310,"2015",0,0,1,1
412310,"2016",0,0,1,1
412310,"2018",1,0,0,1
412310,"2019",1,0,0,1
412310,"2021",0,0,1,1
412320,"2015",0,0,1,1
412320,"2016",1,0,1,2
412320,"2018",0,0,2,2
412320,"2020",0,0,1,1
412320,"2023",0,0,1,1
412330,"2015",0,1,0,1
412330,"2017",0,0,1,1
412330,"2019",1,0,0,1
412330,"2021",1,0,0,1
412330,"2022",1,0,0,1
412330,"2023",1,0,1,2
412340,"2016",1,0,2,3
412340,"2017",1,0,4,5
412340,"2019",1,0,0,1
412340,"2020",1,1,3,5
412340,"2021",1,0,0,1
412340,"2022",1,0,2,3
412340,"2023",0,0,2,2
412350,"2015",1,0,0,1
412350,"2016",0,0,6,6
412350,"2017",4,1,8,13
412350,"2018",5,2,6,13
412350,"2019",0,0,7,7
412350,"2020",3,2,4,9
412350,"2021",1,1,3,5
412350,"2022",5,2,14,21
412350,"2023",1,0,5,6
412360,"2017",1,0,0,1
412360,"2018",1,0,0,1
412360,"2019",0,0,1,1
412370,"2022",1,0,2,3
412370,"2023",1,1,1,3
412380,"2017",0,0,1,1
412380,"2018",1,0,0,1
412380,"2020",0,1,1,2
412380,"2022",1,0,2,3
412380,"2023",4,0,1,5
412382,"2015",1,0,0,1
412382,"2016",1,0,1,2
412382,"2018",0,0,1,1
412382,"2019",2,0,2,4
412382,"2022",0,0,1,1
412385,"2016",0,0,3,3
412385,"2017",2,1,1,4
412385,"2018",1,1,2,4
412385,"2019",1,0,3,4
412385,"2020",2,0,4,6
412385,"2021",0,0,2,2
412385,"2022",0,0,3,3
412385,"2023",1,1,1,3
412390,"2017",0,0,1,1
412390,"2018",2,1,3,6
412390,"2019",1,0,2,3
412390,"2020",2,0,0,2
412390,"2022",0,1,0,1
412390,"2023",0,1,1,2
412395,"2015",0,0,1,1
412400,"2015",0,0,2,2
412400,"2016",0,0,1,1
412400,"2017",1,0,0,1
412400,"2018",1,1,1,3
412400,"2019",2,1,0,3
412400,"2020",0,0,1,1
412400,"2021",0,0,1,1
412400,"2022",0,0,2,2
412400,"2023",0,1,0,1
412402,"2015",1,1,4,6
412402,"2016",1,1,4,6
412402,"2017",3,1,5,9
412402,"2018",1,0,9,10
412402,"2019",1,1,2,4
412402,"2020",3,1,2,6
412402,"2021",2,0,8,10
412402,"2022",1,0,8,9
412402,"2023",0,0,2,2
412405,"2015",4,1,15,20
412405,"2016",5,2,13,20
412405,"2017",9,5,13,27
412405,"2018",8,1,22,31
412405,"2019",3,1,8,12
412405,"2020",5,2,8,15
412405,"2021",5,0,10,15
412405,"2022",5,2,4,11
412405,"2023",4,0,4,8
412410,"2015",3,1,13,17
412410,"2016",12,1,17,30
412410,"2017",15,4,18,37
412410,"2018",11,2,20,33
412410,"2019",3,2,11,16
412410,"2020",14,3,7,24
412410,"2021",6,1,7,14
412410,"2022",4,2,12,18
412410,"2023",4,5,4,13
412420,"2017",0,0,1,1
412420,"2018",0,1,1,2
412420,"2022",0,0,3,3
412420,"2023",0,1,0,1
412430,"2018",0,0,1,1
412440,"2016",0,0,1,1
412440,"2021",0,0,1,1
412440,"2022",1,0,0,1
412450,"2020",1,1,2,4
412450,"2021",0,0,1,1
412450,"2023",0,0,1,1
412460,"2016",1,0,0,1
412460,"2017",0,0,1,1
412460,"2019",1,0,1,2
412460,"2022",4,1,7,12
412460,"2023",1,0,2,3
412470,"2015",0,0,2,2
412470,"2016",2,0,2,4
412470,"2017",0,1,3,4
412470,"2018",3,0,0,3
412470,"2019",0,2,1,3
412470,"2020",0,0,2,2
412470,"2021",1,1,1,3
412480,"2016",0,1,0,1
412480,"2018",1,0,3,4
412480,"2020",1,0,2,3
412480,"2021",0,0,2,2
412480,"2022",0,0,1,1
412480,"2023",2,0,0,2
412490,"2021",1,0,0,1
412490,"2022",0,0,2,2
412490,"2023",0,0,3,3
412500,"2015",0,1,3,4
412500,"2016",1,1,3,5
412500,"2017",2,0,5,7
412500,"2018",2,0,2,4
412500,"2019",3,0,2,5
412500,"2020",1,1,3,5
412500,"2021",0,0,4,4
412500,"2022",0,0,2,2
412500,"2023",1,2,2,5
412510,"2015",2,0,9,11
412510,"2016",5,0,12,17
412510,"2017",2,1,9,12
412510,"2018",6,2,7,15
412510,"2019",0,0,3,3
412510,"2020",2,0,2,4
412510,"2021",1,0,3,4
412510,"2022",0,0,1,1
412520,"2019",0,0,1,1
412520,"2020",0,0,1,1
412520,"2021",0,0,1,1
412520,"2022",1,0,0,1
412520,"2023",1,0,1,2
412530,"2016",1,0,0,1
412530,"2017",0,0,1,1
412530,"2018",1,0,0,1
412535,"2015",1,1,2,4
412535,"2016",1,0,2,3
412535,"2017",1,0,0,1
412535,"2018",0,0,2,2
412535,"2019",1,0,1,2
412540,"2015",1,0,0,1
412540,"2016",0,0,1,1
412540,"2017",0,2,2,4
412540,"2018",0,1,2,3
412540,"2019",0,0,1,1
412540,"2020",0,0,1,1
412540,"2021",0,0,1,1
412540,"2022",1,0,3,4
412540,"2023",0,0,1,1
412545,"2016",0,0,1,1
412545,"2017",1,0,0,1
412545,"2018",0,0,1,1
412545,"2019",2,0,1,3
412545,"2021",1,0,2,3
412550,"2015",55,21,89,165
412550,"2016",64,31,111,206
412550,"2017",50,13,84,147
412550,"2018",41,20,76,137
412550,"2019",36,9,69,114
412550,"2020",24,14,55,93
412550,"2021",35,16,87,138
412550,"2022",53,12,70,135
412550,"2023",36,10,47,93
412555,"2015",0,0,2,2
412560,"2015",7,2,20,29
412560,"2016",10,3,23,36
412560,"2017",3,1,13,17
412560,"2018",9,3,15,27
412560,"2019",5,1,18,24
412560,"2020",4,0,7,11
412560,"2021",4,2,14,20
412560,"2022",2,1,8,11
412560,"2023",2,2,2,6
412570,"2015",1,0,3,4
412570,"2016",3,2,6,11
412570,"2017",2,0,3,5
412570,"2020",3,0,4,7
412570,"2021",1,2,8,11
412570,"2022",4,3,12,19
412570,"2023",4,1,4,9
412575,"2015",2,1,2,5
412575,"2016",1,1,1,3
412575,"2017",3,0,1,4
412575,"2018",2,0,0,2
412575,"2019",4,1,1,6
412575,"2020",2,0,0,2
412575,"2021",2,0,3,5
412575,"2023",0,0,1,1
412580,"2018",0,0,1,1
412580,"2019",2,0,4,6
412580,"2020",1,0,1,2
412580,"2022",0,0,1,1
412580,"2023",0,0,1,1
412590,"2023",0,0,1,1
412600,"2015",0,0,2,2
412600,"2016",1,0,4,5
412600,"2018",0,0,2,2
412600,"2019",0,1,1,2
412600,"2020",1,0,1,2
412600,"2023",0,0,2,2
412610,"2016",0,0,2,2
412610,"2017",0,1,1,2
412610,"2020",1,0,1,2
412610,"2022",1,1,0,2
412610,"2023",1,0,0,1
412620,"2015",0,0,1,1
412620,"2016",0,1,2,3
412620,"2017",0,0,2,2
412620,"2018",0,1,1,2
412620,"2019",0,0,1,1
412620,"2020",0,0,3,3
412620,"2021",0,0,1,1
412620,"2022",1,0,1,2
412625,"2015",7,1,13,21
412625,"2016",18,4,21,43
412625,"2017",17,4,24,45
412625,"2018",7,4,17,28
412625,"2019",12,1,10,23
412625,"2020",14,2,29,45
412625,"2021",25,3,30,58
412625,"2022",24,4,27,55
412625,"2023",6,3,17,26
412627,"2016",0,1,0,1
412627,"2018",0,0,1,1
412627,"2019",0,0,2,2
412627,"2020",0,0,2,2
412627,"2022",1,1,3,5
412630,"2015",0,0,3,3
412630,"2016",1,1,5,7
412630,"2017",0,0,5,5
412630,"2018",1,2,16,19
412630,"2019",1,1,11,13
412630,"2020",3,2,6,11
412630,"2021",3,0,10,13
412630,"2022",7,0,4,11
412630,"2023",1,0,3,4
412635,"2015",0,0,2,2
412635,"2016",1,0,4,5
412635,"2017",0,0,2,2
412635,"2018",1,1,3,5
412635,"2019",3,0,2,5
412635,"2020",1,0,2,3
412635,"2021",3,0,3,6
412635,"2022",3,0,1,4
412640,"2016",1,0,0,1
412640,"2017",1,0,1,2
412640,"2018",0,0,1,1
412640,"2019",0,0,1,1
412640,"2021",1,0,0,1
412640,"2023",0,0,2,2
412650,"2015",2,0,0,2
412650,"2016",0,0,2,2
412650,"2017",0,0,4,4
412650,"2018",2,1,1,4
412650,"2019",0,0,1,1
412650,"2020",1,1,2,4
412650,"2021",0,0,2,2
412650,"2022",0,1,0,1
412660,"2015",1,0,2,3
412660,"2016",2,2,3,7
412660,"2017",3,2,3,8
412660,"2018",1,0,5,6
412660,"2019",4,0,1,5
412660,"2020",3,0,3,6
412660,"2021",1,0,1,2
412660,"2022",3,2,3,8
412660,"2023",2,0,0,2
412665,"2021",1,0,2,3
412665,"2023",0,0,1,1
412667,"2015",1,0,1,2
412667,"2016",0,1,2,3
412667,"2017",2,0,1,3
412667,"2018",2,0,4,6
412667,"2019",2,0,3,5
412667,"2020",1,0,2,3
412667,"2021",0,1,5,6
412667,"2022",1,0,0,1
412667,"2023",0,0,1,1
412670,"2016",0,0,1,1
412670,"2021",0,0,1,1
412670,"2022",0,0,5,5
412670,"2023",2,0,2,4
412680,"2015",0,0,1,1
412680,"2016",1,0,2,3
412680,"2018",2,0,2,4
412680,"2019",0,0,3,3
412680,"2020",0,0,2,2
412680,"2021",2,0,1,3
412680,"2022",0,0,1,1
412690,"2015",2,0,3,5
412690,"2017",2,0,0,2
412690,"2018",0,0,2,2
412690,"2019",2,0,3,5
412690,"2020",0,1,2,3
412690,"2021",1,1,0,2
412690,"2022",2,0,1,3
412700,"2015",1,0,0,1
412700,"2016",0,0,4,4
412700,"2017",1,0,2,3
412700,"2018",0,1,3,4
412700,"2020",0,0,1,1
412700,"2021",4,0,3,7
412700,"2022",4,0,3,7
412700,"2023",2,0,8,10
412710,"2015",2,0,6,8
412710,"2016",5,1,3,9
412710,"2017",4,1,20,25
412710,"2018",18,4,17,39
412710,"2019",12,1,12,25
412710,"2020",7,3,10,20
412710,"2021",8,4,18,30
412710,"2022",0,0,3,3
412720,"2015",0,0,1,1
412720,"2016",3,0,3,6
412720,"2017",0,1,2,3
412720,"2018",2,1,5,8
412720,"2019",1,0,1,2
412720,"2020",3,0,3,6
412720,"2021",1,1,6,8
412720,"2022",2,0,0,2
412730,"2015",3,0,1,4
412730,"2016",1,0,4,5
412730,"2018",0,0,1,1
412730,"2021",2,0,1,3
412730,"2022",3,0,0,3
412730,"2023",6,0,4,10
412740,"2015",2,1,3,6
412740,"2016",2,0,6,8
412740,"2017",4,1,5,10
412740,"2018",4,1,3,8
412740,"2019",1,0,7,8
412740,"2020",3,1,6,10
412740,"2021",3,0,4,7
412740,"2022",2,0,7,9
412740,"2023",0,1,3,4
412750,"2015",0,0,3,3
412750,"2016",3,0,3,6
412750,"2017",6,0,5,11
412750,"2018",3,0,4,7
412750,"2019",0,2,2,4
412750,"2020",2,0,4,6
412750,"2021",6,0,2,8
412750,"2022",0,0,1,1
412750,"2023",1,0,0,1
412760,"2015",2,1,0,3
412760,"2016",6,0,2,8
412760,"2017",5,3,5,13
412760,"2018",1,1,2,4
412760,"2019",2,0,3,5
412760,"2020",1,0,3,4
412760,"2021",2,0,3,5
412760,"2022",2,3,1,6
412760,"2023",0,4,2,6
412770,"2015",23,5,57,85
412770,"2016",14,2,38,54
412770,"2017",51,15,58,124
412770,"2018",43,15,64,122
412770,"2019",26,8,51,85
412770,"2020",29,10,41,80
412770,"2021",24,9,54,87
412770,"2022",27,9,45,81
412770,"2023",12,5,20,37
412780,"2015",2,0,3,5
412780,"2018",0,0,1,1
412780,"2019",2,0,0,2
412780,"2020",1,1,1,3
412780,"2021",1,0,0,1
412780,"2022",2,0,1,3
412780,"2023",1,1,0,2
412785,"2015",0,0,2,2
412785,"2016",0,0,2,2
412785,"2017",0,1,2,3
412785,"2018",1,0,3,4
412785,"2019",1,2,0,3
412785,"2020",1,0,2,3
412785,"2021",1,0,4,5
412785,"2022",0,0,3,3
412785,"2023",0,0,1,1
412788,"2015",2,1,7,10
412788,"2016",3,0,8,11
412788,"2017",2,0,5,7
412788,"2018",2,1,6,9
412788,"2019",0,1,3,4
412788,"2020",1,2,0,3
412788,"2021",1,2,2,5
412788,"2022",0,0,3,3
412788,"2023",1,0,4,5
412790,"2015",0,0,1,1
412790,"2016",1,0,2,3
412790,"2017",2,0,1,3
412790,"2018",2,0,1,3
412790,"2019",1,0,3,4
412790,"2020",0,0,1,1
412790,"2021",0,0,1,1
412795,"2015",1,0,0,1
412795,"2016",0,1,2,3
412795,"2017",4,0,8,12
412795,"2018",0,0,3,3
412795,"2019",1,0,3,4
412795,"2020",0,1,2,3
412795,"2021",1,0,1,2
412795,"2022",0,0,2,2
412795,"2023",1,0,0,1
412796,"2015",1,0,2,3
412796,"2016",2,1,3,6
412796,"2017",5,2,2,9
412796,"2018",1,0,3,4
412796,"2019",6,1,4,11
412796,"2020",2,1,2,5
412796,"2021",2,1,2,5
412796,"2022",0,0,3,3
412796,"2023",4,0,3,7
412800,"2015",0,1,4,5
412800,"2016",0,0,2,2
412800,"2018",0,1,2,3
412800,"2019",1,0,8,9
412800,"2020",4,0,6,10
412800,"2021",5,3,10,18
412800,"2022",3,0,5,8
412800,"2023",2,1,3,6
412810,"2015",30,4,44,78
412810,"2016",30,6,61,97
412810,"2017",24,8,57,89
412810,"2018",30,13,60,103
412810,"2019",37,14,48,99
412810,"2020",24,13,37,74
412810,"2021",26,7,49,82
412810,"2022",27,6,46,79
412810,"2023",11,6,16,33
412820,"2015",9,7,26,42
412820,"2016",7,1,21,29
412820,"2017",17,7,31,55
412820,"2018",17,3,24,44
412820,"2019",18,4,19,41
412820,"2020",12,3,11,26
412820,"2021",8,4,16,28
412820,"2022",5,1,7,13
412820,"2023",8,2,9,19
412830,"2016",1,1,2,4
412830,"2017",1,0,5,6
412830,"2019",1,0,0,1
412830,"2021",0,0,3,3
412830,"2022",1,0,0,1
412840,"2019",0,0,1,1
412840,"2021",3,0,0,3
412840,"2022",0,1,0,1
412840,"2023",2,0,0,2
412850,"2015",0,0,3,3
412850,"2016",1,0,3,4
412850,"2017",2,0,1,3
412850,"2018",1,0,4,5
412850,"2019",1,0,3,4
412850,"2020",1,2,2,5
412850,"2021",1,0,2,3
412850,"2022",5,1,5,11
412850,"2023",0,0,2,2
412853,"2015",0,0,1,1
412853,"2016",2,1,2,5
412853,"2017",2,0,3,5
412853,"2018",3,0,4,7
412853,"2019",2,0,0,2
412853,"2020",1,0,1,2
412853,"2021",0,1,0,1
412853,"2022",0,0,1,1
412855,"2015",1,0,6,7
412855,"2016",3,0,4,7
412855,"2017",2,0,4,6
412855,"2018",2,0,2,4
412855,"2019",0,0,3,3
412855,"2020",1,0,1,2
412855,"2021",0,0,1,1
412855,"2022",0,0,4,4
412855,"2023",0,0,1,1
412860,"2015",1,0,0,1
412860,"2016",0,0,2,2
412860,"2017",1,0,0,1
412860,"2018",0,0,1,1
412860,"2021",1,0,0,1
412860,"2022",1,0,0,1
412862,"2015",1,0,1,2
412862,"2016",0,0,3,3
412862,"2017",2,0,1,3
412862,"2018",1,1,2,4
412862,"2019",0,0,2,2
412862,"2020",3,0,0,3
412862,"2021",2,0,1,3
412862,"2022",0,1,0,1
412862,"2023",0,0,2,2
412863,"2016",1,0,5,6
412863,"2017",0,0,2,2
412863,"2018",2,0,2,4
412863,"2019",1,0,2,3
412863,"2020",1,0,3,4
412863,"2021",1,0,3,4
412863,"2022",0,1,1,2
412863,"2023",1,0,1,2
412865,"2015",0,0,1,1
412865,"2016",1,0,1,2
412870,"2016",1,0,3,4
412870,"2017",3,0,5,8
412870,"2018",1,0,3,4
412870,"2019",1,0,3,4
412870,"2020",0,0,5,5
412870,"2021",0,0,4,4
412870,"2022",2,0,5,7
412870,"2023",0,0,2,2
412880,"2015",0,1,3,4
412880,"2016",2,1,3,6
412880,"2017",0,0,4,4
412880,"2018",0,1,2,3
412880,"2019",3,1,3,7
412880,"2020",3,0,3,6
412880,"2021",2,2,1,5
412880,"2022",1,1,0,2
412880,"2023",1,0,0,1
420005,"2023",1,1,0,2
420010,"2015",1,0,2,3
420010,"2016",3,0,1,4
420010,"2017",1,0,3,4
420010,"2018",1,0,4,5
420010,"2019",3,0,0,3
420010,"2020",2,0,2,4
420010,"2021",1,0,0,1
420010,"2022",1,0,5,6
420010,"2023",6,1,3,10
420020,"2015",2,0,1,3
420020,"2017",1,0,0,1
420020,"2018",3,0,2,5
420020,"2019",3,0,2,5
420020,"2020",6,2,1,9
420020,"2021",0,0,4,4
420020,"2022",5,0,2,7
420020,"2023",1,0,3,4
420030,"2015",0,1,0,1
420030,"2016",1,0,0,1
420030,"2017",0,0,1,1
420030,"2018",1,2,1,4
420030,"2019",0,0,1,1
420030,"2020",1,1,0,2
420030,"2022",1,2,2,5
420030,"2023",1,0,2,3
420040,"2017",0,0,1,1
420040,"2018",0,0,3,3
420040,"2019",1,0,1,2
420040,"2020",1,0,2,3
420040,"2021",1,0,1,2
420040,"2022",0,0,1,1
420050,"2015",2,0,3,5
420050,"2016",2,2,4,8
420050,"2017",2,1,2,5
420050,"2018",1,0,1,2
420050,"2019",0,0,1,1
420050,"2020",0,1,1,2
420050,"2021",1,0,0,1
420050,"2023",1,0,0,1
420055,"2015",1,0,0,1
420055,"2018",1,0,0,1
420060,"2015",1,0,0,1
420060,"2017",3,0,2,5
420060,"2018",1,0,1,2
420060,"2019",3,0,2,5
420060,"2021",0,1,1,2
420060,"2022",2,0,0,2
420060,"2023",0,0,2,2
420070,"2015",3,2,1,6
420070,"2016",0,1,4,5
420070,"2017",0,1,0,1
420070,"2019",1,1,0,2
420070,"2020",1,1,0,2
420070,"2021",1,0,1,2
420070,"2022",2,0,0,2
420075,"2021",0,1,0,1
420080,"2015",0,0,2,2
420080,"2016",0,0,3,3
420080,"2017",0,0,1,1
420080,"2018",1,0,2,3
420080,"2019",0,1,4,5
420080,"2021",1,0,1,2
420080,"2022",1,0,0,1
420080,"2023",1,0,2,3
420090,"2016",1,0,0,1
420090,"2017",0,1,1,2
420090,"2018",0,0,1,1
420090,"2019",1,1,0,2
420090,"2020",1,0,0,1
420090,"2023",0,0,1,1
420100,"2015",0,0,1,1
420100,"2017",2,0,0,2
420100,"2018",0,0,1,1
420100,"2019",1,0,0,1
420100,"2020",1,0,0,1
420100,"2022",1,0,4,5
420100,"2023",1,0,1,2
420110,"2015",1,0,2,3
420110,"2016",1,0,1,2
420110,"2017",2,0,1,3
420110,"2018",0,0,1,1
420110,"2020",0,0,1,1
420110,"2021",1,0,0,1
420120,"2015",1,0,4,5
420120,"2018",2,0,4,6
420120,"2019",1,0,2,3
420120,"2020",2,1,3,6
420120,"2021",0,0,1,1
420120,"2022",1,1,3,5
420120,"2023",0,0,1,1
420125,"2015",4,0,2,6
420125,"2016",2,0,1,3
420125,"2017",4,2,7,13
420125,"2018",2,0,2,4
420125,"2019",2,0,1,3
420125,"2020",0,0,1,1
420125,"2021",1,0,1,2
420125,"2022",1,0,1,2
420125,"2023",1,1,2,4
420127,"2021",1,0,0,1
420130,"2015",5,2,12,19
420130,"2016",9,3,17,29
420130,"2017",12,0,11,23
420130,"2018",6,2,12,20
420130,"2019",7,3,16,26
420130,"2020",9,3,12,24
420130,"2021",10,3,10,23
420130,"2022",12,2,19,33
420130,"2023",8,3,18,29
420140,"2015",26,2,23,51
420140,"2016",14,7,20,41
420140,"2017",21,8,14,43
420140,"2018",13,5,20,38
420140,"2019",12,7,18,37
420140,"2020",12,4,21,37
420140,"2021",18,2,15,35
420140,"2022",8,3,15,26
420140,"2023",8,0,4,12
420150,"2015",1,0,2,3
420150,"2016",0,1,2,3
420150,"2017",1,0,1,2
420150,"2018",1,0,0,1
420150,"2019",0,1,1,2
420150,"2020",1,0,0,1
420150,"2022",0,1,0,1
420160,"2016",0,0,1,1
420160,"2018",0,0,1,1
420160,"2019",1,0,0,1
420160,"2021",1,0,0,1
420165,"2018",0,0,1,1
420165,"2022",0,0,1,1
420170,"2015",3,0,2,5
420170,"2016",2,0,2,4
420170,"2017",1,1,2,4
420170,"2019",1,0,2,3
420170,"2020",0,0,2,2
420170,"2021",0,0,2,2
420170,"2022",1,0,0,1
420170,"2023",1,0,0,1
420180,"2017",1,0,1,2
420180,"2019",0,0,1,1
420180,"2020",0,0,2,2
420180,"2022",1,0,1,2
420190,"2017",6,0,2,8
420190,"2018",1,0,2,3
420190,"2019",2,0,2,4
420190,"2020",1,0,1,2
420190,"2021",3,0,0,3
420190,"2022",1,0,2,3
420190,"2023",1,0,0,1
420195,"2015",2,0,4,6
420195,"2016",4,0,3,7
420195,"2017",2,1,4,7
420195,"2018",4,0,0,4
420195,"2019",2,1,5,8
420195,"2020",3,2,6,11
420195,"2021",3,4,3,10
420195,"2022",2,0,1,3
420195,"2023",2,0,1,3
420200,"2015",13,4,16,33
420200,"2016",22,1,37,60
420200,"2017",16,8,32,56
420200,"2018",15,6,39,60
420200,"2019",32,10,37,79
420200,"2020",18,4,33,55
420200,"2021",21,6,20,47
420200,"2022",19,5,26,50
420200,"2023",13,6,16,35
420205,"2015",3,2,3,8
420205,"2016",4,0,1,5
420205,"2017",1,0,2,3
420205,"2018",2,1,5,8
420205,"2019",1,0,2,3
420205,"2020",0,1,1,2
420205,"2021",2,0,3,5
420205,"2022",2,1,1,4
420205,"2023",2,0,1,3
420207,"2015",2,2,3,7
420207,"2016",3,1,3,7
420207,"2017",1,0,5,6
420207,"2018",6,0,3,9
420207,"2019",2,0,2,4
420207,"2020",3,0,6,9
420207,"2021",2,0,3,5
420207,"2022",1,2,0,3
420207,"2023",4,1,3,8
420208,"2015",0,0,1,1
420208,"2016",0,1,1,2
420208,"2017",1,0,2,3
420208,"2018",0,0,1,1
420208,"2020",0,1,0,1
420208,"2021",1,1,1,3
420210,"2015",10,3,13,26
420210,"2016",8,5,18,31
420210,"2017",8,1,8,17
420210,"2018",5,0,11,16
420210,"2019",14,5,12,31
420210,"2020",7,1,13,21
420210,"2021",8,2,12,22
420210,"2022",7,1,14,22
420210,"2023",8,1,10,19
420213,"2015",1,0,3,4
420213,"2016",2,0,2,4
420213,"2017",2,0,0,2
420213,"2018",1,0,0,1
420213,"2019",0,0,1,1
420213,"2020",0,0,2,2
420213,"2021",0,1,1,2
420213,"2022",1,0,3,4
420213,"2023",1,2,2,5
420215,"2015",0,0,2,2
420215,"2017",0,0,1,1
420215,"2018",0,0,1,1
420215,"2020",1,0,0,1
420215,"2023",0,0,1,1
420220,"2015",1,0,1,2
420220,"2016",1,1,2,4
420220,"2017",1,0,4,5
420220,"2018",0,0,2,2
420220,"2019",0,1,0,1
420220,"2020",0,0,3,3
420220,"2021",2,0,2,4
420220,"2022",0,1,2,3
420220,"2023",1,0,2,3
420230,"2015",5,2,22,29
420230,"2016",19,2,29,50
420230,"2017",13,1,30,44
420230,"2018",16,4,31,51
420230,"2019",14,1,35,50
420230,"2020",16,6,16,38
420230,"2021",9,7,15,31
420230,"2022",14,5,18,37
420230,"2023",10,4,11,25
420240,"2015",13,1,14,28
420240,"2016",29,9,50,88
420240,"2017",40,11,54,105
420240,"2018",37,14,65,116
420240,"2019",48,13,60,121
420240,"2020",31,10,45,86
420240,"2021",22,11,47,80
420240,"2022",37,9,60,106
420240,"2023",43,10,59,112
420243,"2015",0,0,1,1
420243,"2016",0,0,1,1
420243,"2020",0,0,1,1
420243,"2021",1,0,2,3
420243,"2022",0,1,1,2
420245,"2015",2,1,2,5
420245,"2016",5,0,3,8
420245,"2017",3,2,5,10
420245,"2018",5,3,5,13
420245,"2019",5,0,14,19
420245,"2020",4,1,3,8
420245,"2021",4,4,4,12
420245,"2022",3,1,3,7
420245,"2023",5,0,4,9
420250,"2015",0,1,1,2
420250,"2016",1,0,0,1
420250,"2017",1,0,1,2
420250,"2018",0,0,1,1
420250,"2020",1,0,0,1
420250,"2021",0,0,1,1
420250,"2022",0,0,2,2
420250,"2023",1,0,0,1
420253,"2016",1,0,0,1
420253,"2017",0,0,2,2
420253,"2018",0,0,1,1
420253,"2019",0,0,1,1
420257,"2015",1,0,1,2
420257,"2016",5,1,3,9
420257,"2017",0,0,1,1
420257,"2018",5,0,1,6
420257,"2019",0,0,1,1
420257,"2020",2,0,0,2
420257,"2021",1,0,1,2
420257,"2022",2,1,1,4
420257,"2023",0,0,1,1
420260,"2015",0,0,2,2
420260,"2016",0,1,2,3
420260,"2017",1,0,1,2
420260,"2019",2,0,1,3
420260,"2020",0,0,2,2
420260,"2021",1,0,4,5
420260,"2022",0,0,1,1
420260,"2023",2,0,1,3
420270,"2015",3,0,2,5
420270,"2016",1,0,4,5
420270,"2022",0,0,1,1
420270,"2023",1,0,1,2
420280,"2015",2,2,13,17
420280,"2016",2,0,5,7
420280,"2017",4,1,3,8
420280,"2018",4,2,3,9
420280,"2019",1,0,3,4
420280,"2020",1,0,4,5
420280,"2021",3,0,3,6
420280,"2022",0,0,3,3
420280,"2023",0,1,4,5
420285,"2016",1,0,0,1
420285,"2017",2,0,2,4
420285,"2018",1,0,3,4
420285,"2021",0,0,1,1
420285,"2022",2,0,0,2
420287,"2022",0,0,1,1
420290,"2015",26,8,47,81
420290,"2016",36,10,51,97
420290,"2017",22,5,20,47
420290,"2018",18,7,23,48
420290,"2019",28,4,32,64
420290,"2020",15,5,32,52
420290,"2021",9,2,17,28
420290,"2022",12,3,15,30
420290,"2023",24,7,28,59
420300,"2015",23,5,44,72
420300,"2016",12,3,30,45
420300,"2017",12,6,30,48
420300,"2018",15,8,28,51
420300,"2019",20,7,31,58
420300,"2020",14,6,34,54
420300,"2021",25,6,43,74
420300,"2022",21,5,37,63
420300,"2023",15,4,24,43
420310,"2017",1,0,2,3
420310,"2021",1,0,1,2
420310,"2023",0,0,1,1
420315,"2015",1,0,1,2
420315,"2016",0,0,2,2
420315,"2017",0,0,1,1
420315,"2019",0,0,1,1
420315,"2020",2,1,2,5
420315,"2021",1,0,4,5
420315,"2022",3,0,4,7
420315,"2023",0,0,1,1
420320,"2015",5,2,17,24
420320,"2016",9,0,25,34
420320,"2017",15,4,24,43
420320,"2018",15,3,23,41
420320,"2019",19,3,30,52
420320,"2020",6,1,30,37
420320,"2021",13,5,21,39
420320,"2022",10,2,23,35
420320,"2023",14,4,15,33
420325,"2017",1,0,1,2
420325,"2018",1,1,0,2
420325,"2021",1,0,0,1
420325,"2022",0,1,0,1
420330,"2015",0,0,1,1
420330,"2016",0,0,2,2
420330,"2017",1,0,1,2
420330,"2018",2,0,0,2
420330,"2019",0,2,5,7
420330,"2020",0,0,3,3
420330,"2021",5,0,2,7
420330,"2022",2,1,1,4
420330,"2023",3,0,4,7
420340,"2015",0,1,1,2
420340,"2018",0,0,1,1
420340,"2021",2,0,3,5
420340,"2022",3,0,0,3
420340,"2023",0,1,0,1
420350,"2015",2,0,2,4
420350,"2016",2,0,1,3
420350,"2018",1,0,1,2
420350,"2019",0,0,2,2
420350,"2020",0,0,4,4
420350,"2021",1,0,2,3
420360,"2015",6,0,11,17
420360,"2016",8,0,2,10
420360,"2017",1,1,17,19
420360,"2018",3,1,8,12
420360,"2019",2,4,10,16
420360,"2020",1,1,11,13
420360,"2021",5,5,6,16
420360,"2022",5,1,9,15
420360,"2023",4,2,11,17
420370,"2015",1,1,3,5
420370,"2016",1,0,5,6
420370,"2017",1,1,3,5
420370,"2018",1,1,3,5
420370,"2019",0,0,1,1
420370,"2020",4,0,3,7
420370,"2021",3,0,1,4
420370,"2022",1,2,2,5
420370,"2023",2,1,0,3
420380,"2015",16,3,34,53
420380,"2016",24,2,33,59
420380,"2017",12,3,19,34
420380,"2018",8,5,18,31
420380,"2019",6,4,17,27
420380,"2020",7,4,19,30
420380,"2021",8,3,17,28
420380,"2022",17,7,22,46
420380,"2023",11,3,18,32
420390,"2015",5,1,10,16
420390,"2016",10,2,7,19
420390,"2017",5,1,10,16
420390,"2018",7,3,11,21
420390,"2019",8,4,6,18
420390,"2020",3,3,10,16
420390,"2021",2,1,6,9
420390,"2022",4,0,3,7
420390,"2023",0,1,0,1
420395,"2015",4,1,7,12
420395,"2016",2,0,2,4
420395,"2017",2,1,4,7
420395,"2018",1,0,4,5
420395,"2019",0,0,3,3
420395,"2020",1,0,3,4
420395,"2022",1,0,4,5
420395,"2023",1,0,1,2
420400,"2015",1,0,3,4
420400,"2016",0,0,1,1
420400,"2017",2,1,0,3
420400,"2018",1,1,5,7
420400,"2020",2,0,0,2
420400,"2021",0,0,3,3
420400,"2022",0,0,2,2
420410,"2016",0,0,2,2
420410,"2017",0,0,2,2
420410,"2018",0,1,1,2
420410,"2019",0,0,2,2
420410,"2020",0,1,0,1
420410,"2022",0,1,0,1
420415,"2015",1,1,0,2
420415,"2017",0,1,0,1
420415,"2018",0,0,1,1
420415,"2019",1,0,0,1
420415,"2023",0,0,2,2
420417,"2015",0,0,1,1
420417,"2016",1,0,0,1
420417,"2018",0,0,2,2
420417,"2019",0,0,1,1
420417,"2020",0,0,1,1
420417,"2023",0,0,1,1
420419,"2017",1,0,0,1
420419,"2018",2,1,0,3
420419,"2020",0,0,2,2
420419,"2021",1,0,1,2
420420,"2015",39,5,50,94
420420,"2016",35,9,45,89
420420,"2017",27,7,57,91
420420,"2018",25,11,45,81
420420,"2019",32,7,62,101
420420,"2020",35,3,39,77
420420,"2021",36,15,44,95
420420,"2022",36,4,50,90
420420,"2023",19,8,23,50
420425,"2015",2,1,5,8
420425,"2016",2,0,2,4
420425,"2017",0,2,2,4
420425,"2018",3,1,2,6
420425,"2019",2,1,5,8
420425,"2020",0,0,5,5
420425,"2021",5,0,0,5
420425,"2022",1,0,0,1
420425,"2023",0,0,1,1
420430,"2015",1,1,2,4
420430,"2016",2,2,6,10
420430,"2017",3,1,3,7
420430,"2018",1,0,1,2
420430,"2019",3,0,3,6
420430,"2020",2,0,4,6
420430,"2021",8,4,8,20
420430,"2022",7,1,6,14
420430,"2023",4,2,7,13
420435,"2016",2,1,0,3
420435,"2017",0,0,2,2
420435,"2018",0,0,1,1
420435,"2019",1,0,0,1
420435,"2020",1,0,0,1
420435,"2021",0,0,1,1
420435,"2023",0,0,2,2
420440,"2015",1,0,6,7
420440,"2016",0,0,2,2
420440,"2017",3,0,1,4
420440,"2018",0,1,2,3
420440,"2019",0,0,2,2
420440,"2020",2,0,1,3
420440,"2021",2,0,3,5
420440,"2022",0,0,1,1
420440,"2023",1,0,0,1
420445,"2015",0,0,1,1
420445,"2017",1,0,3,4
420445,"2018",0,0,1,1
420445,"2019",1,0,0,1
420450,"2015",3,1,5,9
420450,"2016",4,1,2,7
420450,"2017",4,1,1,6
420450,"2018",3,1,6,10
420450,"2019",2,0,3,5
420450,"2020",0,1,1,2
420450,"2021",2,0,2,4
420450,"2022",5,0,2,7
420450,"2023",3,2,5,10
420455,"2015",0,0,3,3
420455,"2016",1,0,0,1
420455,"2017",0,0,2,2
420455,"2018",2,0,3,5
420455,"2019",2,0,1,3
420455,"2020",1,0,1,2
420455,"2021",6,1,2,9
420455,"2022",1,0,5,6
420455,"2023",1,0,2,3
420460,"2015",56,9,84,149
420460,"2016",40,13,73,126
420460,"2017",40,7,56,103
420460,"2018",44,4,53,101
420460,"2019",44,10,66,120
420460,"2020",31,8,63,102
420460,"2021",36,12,47,95
420460,"2022",34,8,48,90
420460,"2023",28,10,36,74
420470,"2015",0,0,1,1
420470,"2016",1,0,0,1
420470,"2018",2,3,3,8
420470,"2019",1,0,1,2
420470,"2020",1,0,0,1
420470,"2022",0,0,1,1
420470,"2023",1,0,0,1
420475,"2017",0,0,2,2
420475,"2018",2,0,1,3
420480,"2015",3,0,10,13
420480,"2016",1,0,9,10
420480,"2017",2,1,5,8
420480,"2018",1,0,4,5
420480,"2019",2,0,4,6
420480,"2020",3,1,5,9
420480,"2021",4,2,8,14
420480,"2022",4,0,12,16
420480,"2023",7,2,14,23
420490,"2015",0,1,2,3
420490,"2016",1,0,2,3
420490,"2017",0,1,0,1
420490,"2018",0,0,1,1
420490,"2019",1,0,0,1
420490,"2021",1,1,0,2
420490,"2022",0,2,1,3
420490,"2023",0,0,1,1
420500,"2015",0,0,2,2
420500,"2016",0,0,1,1
420500,"2017",1,0,1,2
420500,"2018",2,0,3,5
420500,"2019",0,0,1,1
420500,"2020",2,0,3,5
420500,"2021",1,0,1,2
420500,"2022",5,1,2,8
420500,"2023",0,1,0,1
420510,"2015",0,0,1,1
420510,"2016",0,0,1,1
420510,"2017",4,0,2,6
420510,"2018",0,0,1,1
420510,"2019",0,1,1,2
420510,"2020",1,0,0,1
420510,"2021",0,0,1,1
420510,"2022",0,0,1,1
420515,"2015",1,0,1,2
420515,"2017",0,0,2,2
420515,"2019",0,0,1,1
420515,"2020",0,0,1,1
420515,"2023",1,0,0,1
420517,"2017",1,0,1,2
420517,"2019",1,0,4,5
420517,"2021",0,0,1,1
420517,"2022",1,0,1,2
420519,"2015",0,0,1,1
420519,"2017",1,0,0,1
420519,"2018",0,1,2,3
420519,"2019",2,0,0,2
420519,"2020",0,0,1,1
420519,"2021",1,0,1,2
420519,"2022",1,0,0,1
420520,"2017",1,0,1,2
420520,"2018",1,0,1,2
420520,"2019",0,0,1,1
420520,"2021",3,1,0,4
420530,"2015",4,0,2,6
420530,"2016",3,0,4,7
420530,"2017",0,0,3,3
420530,"2018",0,0,1,1
420530,"2019",3,0,3,6
420530,"2020",2,1,2,5
420530,"2021",0,1,3,4
420530,"2022",1,0,1,2
420530,"2023",0,2,1,3
420535,"2015",0,1,0,1
420535,"2016",0,0,1,1
420535,"2017",0,1,1,2
420535,"2018",2,0,1,3
420535,"2020",1,0,1,2
420535,"2021",2,0,0,2
420535,"2022",1,0,0,1
420535,"2023",1,0,1,2
420540,"2015",94,24,123,241
420540,"2016",112,26,157,295
420540,"2017",106,25,155,286
420540,"2018",110,33,136,279
420540,"2019",119,26,177,322
420540,"2020",95,32,148,275
420540,"2021",98,27,157,282
420540,"2022",107,29,126,262
420540,"2023",79,26,105,210
420543,"2017",0,0,3,3
420543,"2018",0,0,1,1
420543,"2019",1,0,1,2
420543,"2021",1,0,0,1
420543,"2022",0,0,1,1
420543,"2023",1,0,0,1
420545,"2015",5,0,5,10
420545,"2016",5,2,10,17
420545,"2017",8,0,7,15
420545,"2018",4,1,8,13
420545,"2019",3,0,12,15
420545,"2020",3,1,7,11
420545,"2021",3,3,8,14
420545,"2022",7,1,2,10
420545,"2023",3,0,10,13
420550,"2015",2,2,6,10
420550,"2016",5,3,6,14
420550,"2017",4,1,8,13
420550,"2018",0,0,7,7
420550,"2019",4,0,7,11
420550,"2020",4,0,8,12
420550,"2021",8,2,11,21
420550,"2022",3,0,11,14
420550,"2023",2,2,6,10
420555,"2015",0,0,3,3
420555,"2016",0,0,1,1
420555,"2021",1,0,0,1
420555,"2022",1,0,0,1
420555,"2023",0,0,1,1
420560,"2017",1,0,1,2
420560,"2019",2,0,0,2
420560,"2022",0,0,2,2
420560,"2023",1,0,0,1
420570,"2015",8,1,3,12
420570,"2016",5,1,7,13
420570,"2017",6,1,5,12
420570,"2018",2,2,5,9
420570,"2019",6,2,9,17
420570,"2020",3,1,2,6
420570,"2021",7,0,1,8
420570,"2022",4,0,4,8
420570,"2023",6,0,5,11
420580,"2015",5,1,6,12
420580,"2016",1,2,9,12
420580,"2017",4,1,6,11
420580,"2018",3,2,12,17
420580,"2019",6,2,4,12
420580,"2020",8,0,1,9
420580,"2021",4,3,4,11
420580,"2022",2,3,5,10
420580,"2023",1,0,4,5
420590,"2015",7,2,22,31
420590,"2016",15,4,22,41
420590,"2017",13,4,20,37
420590,"2018",12,5,14,31
420590,"2019",7,2,22,31
420590,"2020",14,1,9,24
420590,"2021",14,3,20,37
420590,"2022",17,6,30,53
420590,"2023",9,4,17,30
420600,"2015",0,1,3,4
420600,"2016",2,0,4,6
420600,"2017",1,0,5,6
420600,"2018",2,1,3,6
420600,"2019",2,1,7,10
420600,"2020",0,1,2,3
420600,"2021",1,1,4,6
420600,"2022",2,0,2,4
420600,"2023",2,1,3,6
420610,"2015",0,0,2,2
420610,"2016",0,1,2,3
420610,"2018",2,0,1,3
420610,"2021",0,0,4,4
420620,"2015",3,0,5,8
420620,"2016",3,0,3,6
420620,"2017",2,0,2,4
420620,"2018",1,0,0,1
420620,"2019",0,0,1,1
420620,"2020",2,0,0,2
420620,"2022",1,1,2,4
420620,"2023",0,0,1,1
420630,"2015",4,2,4,10
420630,"2016",5,0,7,12
420630,"2017",3,0,4,7
420630,"2018",3,0,2,5
420630,"2019",5,1,3,9
420630,"2020",2,0,4,6
420630,"2021",4,2,3,9
420630,"2022",1,2,0,3
420630,"2023",1,1,6,8
420640,"2015",1,0,1,2
420640,"2016",0,1,1,2
420640,"2018",5,0,2,7
420640,"2019",0,0,1,1
420640,"2020",0,0,1,1
420640,"2022",0,1,0,1
420640,"2023",0,0,1,1
420650,"2015",5,1,7,13
420650,"2016",4,4,14,22
420650,"2017",11,2,9,22
420650,"2018",7,4,13,24
420650,"2019",6,0,11,17
420650,"2020",5,1,7,13
420650,"2021",13,2,15,30
420650,"2022",9,4,15,28
420650,"2023",12,3,11,26
420660,"2015",1,0,0,1
420660,"2016",1,0,2,3
420660,"2017",0,0,2,2
420660,"2022",0,0,1,1
420660,"2023",1,0,0,1
420665,"2015",0,0,1,1
420665,"2016",0,1,1,2
420665,"2017",2,0,1,3
420665,"2019",0,0,2,2
420665,"2020",0,0,1,1
420665,"2021",0,0,1,1
420665,"2022",1,0,2,3
420670,"2015",3,1,5,9
420670,"2016",1,1,0,2
420670,"2017",1,0,0,1
420670,"2018",1,0,4,5
420670,"2019",1,0,3,4
420670,"2020",0,0,1,1
420670,"2021",1,0,2,3
420670,"2022",2,0,1,3
420670,"2023",0,0,3,3
420675,"2016",0,0,1,1
420675,"2017",1,0,0,1
420675,"2019",1,0,0,1
420675,"2022",1,0,1,2
420680,"2017",3,0,0,3
420680,"2018",0,0,1,1
420680,"2019",0,0,1,1
420680,"2020",1,1,2,4
420680,"2021",0,1,0,1
420690,"2015",2,3,10,15
420690,"2016",3,0,9,12
420690,"2017",6,0,4,10
420690,"2018",4,0,4,8
420690,"2019",1,2,6,9
420690,"2020",1,1,3,5
420690,"2021",5,0,4,9
420690,"2022",1,0,5,6
420690,"2023",1,0,4,5
420700,"2015",12,1,10,23
420700,"2016",13,2,10,25
420700,"2017",8,2,11,21
420700,"2018",10,2,15,27
420700,"2019",11,4,16,31
420700,"2020",8,2,14,24
420700,"2021",7,2,16,25
420700,"2022",6,0,3,9
420700,"2023",2,0,5,7
420710,"2015",0,2,6,8
420710,"2016",7,0,1,8
420710,"2017",3,0,3,6
420710,"2018",3,2,5,10
420710,"2019",1,0,2,3
420710,"2020",3,1,2,6
420710,"2021",5,0,1,6
420710,"2022",4,0,1,5
420710,"2023",3,1,3,7
420720,"2015",2,0,0,2
420720,"2016",1,2,3,6
420720,"2017",3,0,2,5
420720,"2018",0,0,1,1
420720,"2019",2,1,1,4
420720,"2020",1,2,1,4
420720,"2021",1,0,2,3
420720,"2022",1,0,2,3
420720,"2023",0,0,2,2
420730,"2015",11,0,17,28
420730,"2016",12,5,15,32
420730,"2017",17,3,15,35
420730,"2018",5,1,23,29
420730,"2019",8,5,12,25
420730,"2020",16,3,8,27
420730,"2021",18,3,10,31
420730,"2022",10,1,9,20
420730,"2023",6,5,14,25
420740,"2016",1,0,0,1
420740,"2017",2,0,4,6
420740,"2018",2,1,2,5
420740,"2019",0,0,1,1
420740,"2020",0,0,3,3
420740,"2021",1,0,3,4
420740,"2022",1,0,0,1
420750,"2015",11,1,23,35
420750,"2016",16,4,22,42
420750,"2017",11,6,24,41
420750,"2018",14,4,23,41
420750,"2019",8,1,12,21
420750,"2020",8,3,17,28
420750,"2021",12,4,13,29
420750,"2022",11,4,15,30
420750,"2023",13,1,15,29
420757,"2015",0,0,1,1
420757,"2016",0,0,1,1
420757,"2017",1,0,0,1
420757,"2019",1,0,0,1
420757,"2020",1,0,0,1
420757,"2021",1,0,0,1
420757,"2022",0,0,1,1
420760,"2019",1,0,0,1
420760,"2020",2,0,0,2
420760,"2022",0,1,0,1
420765,"2015",1,0,0,1
420765,"2016",0,0,1,1
420765,"2017",0,0,1,1
420765,"2019",3,1,1,5
420765,"2020",2,0,0,2
420765,"2021",0,0,1,1
420765,"2022",1,0,1,2
420768,"2016",1,0,1,2
420768,"2017",1,0,2,3
420768,"2018",1,0,1,2
420768,"2019",1,0,2,3
420768,"2020",0,1,1,2
420768,"2021",1,0,3,4
420768,"2022",2,0,3,5
420768,"2023",0,1,2,3
420770,"2015",0,0,1,1
420770,"2016",0,0,1,1
420770,"2017",1,0,1,2
420770,"2020",0,0,1,1
420770,"2021",0,0,1,1
420770,"2023",1,0,0,1
420775,"2015",2,0,2,4
420775,"2016",1,0,2,3
420775,"2017",1,0,2,3
420775,"2018",3,0,1,4
420775,"2019",1,0,2,3
420775,"2020",2,2,1,5
420775,"2021",3,1,1,5
420775,"2022",1,0,1,2
420775,"2023",2,0,2,4
420780,"2015",0,0,2,2
420780,"2020",1,0,2,3
420780,"2021",1,1,5,7
420780,"2022",1,1,2,4
420780,"2023",0,0,1,1
420785,"2015",1,0,2,3
420785,"2016",2,0,1,3
420785,"2017",1,0,1,2
420785,"2022",0,0,2,2
420785,"2023",1,0,0,1
420790,"2015",2,1,7,10
420790,"2016",1,0,1,2
420790,"2017",0,2,2,4
420790,"2018",2,1,1,4
420790,"2020",1,0,1,2
420790,"2021",0,1,2,3
420790,"2022",1,0,0,1
420790,"2023",2,1,2,5
420800,"2016",1,0,0,1
420800,"2017",0,0,1,1
420800,"2020",0,0,1,1
420800,"2021",2,0,3,5
420800,"2022",1,0,0,1
420800,"2023",1,0,0,1
420810,"2015",4,2,8,14
420810,"2016",0,1,5,6
420810,"2017",2,0,11,13
420810,"2018",3,1,2,6
420810,"2019",1,0,1,2
420810,"2020",1,0,2,3
420810,"2021",2,2,3,7
420810,"2022",4,0,5,9
420810,"2023",2,0,2,4
420820,"2015",40,11,80,131
420820,"2016",41,9,85,135
420820,"2017",24,9,59,92
420820,"2018",35,8,47,90
420820,"2019",38,10,59,107
420820,"2020",54,12,78,144
420820,"2021",50,15,79,144
420820,"2022",49,14,76,139
420820,"2023",27,11,45,83
420830,"2015",2,3,6,11
420830,"2016",4,0,21,25
420830,"2017",13,4,15,32
420830,"2018",9,4,23,36
420830,"2019",19,1,19,39
420830,"2020",5,3,12,20
420830,"2021",8,0,10,18
420830,"2022",5,2,15,22
420830,"2023",5,4,7,16
420840,"2015",0,0,3,3
420840,"2017",2,1,3,6
420840,"2018",2,0,1,3
420840,"2019",0,0,1,1
420840,"2020",0,0,1,1
420840,"2021",1,1,1,3
420840,"2022",2,0,3,5
420840,"2023",2,0,5,7
420845,"2015",5,0,6,11
420845,"2016",7,1,12,20
420845,"2017",5,2,4,11
420845,"2018",6,1,8,15
420845,"2019",3,2,4,9
420845,"2020",3,0,5,8
420845,"2021",3,0,6,9
420845,"2022",5,0,9,14
420845,"2023",6,2,2,10
420850,"2015",1,0,0,1
420850,"2016",2,1,5,8
420850,"2017",3,0,9,12
420850,"2018",8,2,6,16
420850,"2019",6,1,4,11
420850,"2020",6,0,7,13
420850,"2021",2,0,5,7
420850,"2022",4,4,10,18
420850,"2023",2,1,1,4
420860,"2017",0,1,0,1
420860,"2019",0,1,1,2
420870,"2015",1,0,2,3
420870,"2016",3,0,1,4
420870,"2017",4,0,1,5
420870,"2018",3,0,0,3
420870,"2019",1,0,1,2
420870,"2020",1,0,1,2
420870,"2021",1,1,1,3
420870,"2022",1,0,2,3
420870,"2023",0,0,1,1
420880,"2015",5,1,4,10
420880,"2016",3,1,5,9
420880,"2017",0,1,2,3
420880,"2018",4,2,0,6
420880,"2019",0,0,4,4
420880,"2020",1,0,1,2
420880,"2021",1,0,1,2
420880,"2022",1,1,1,3
420880,"2023",2,0,0,2
420890,"2015",34,1,43,78
420890,"2016",25,10,61,96
420890,"2017",41,10,43,94
420890,"2018",43,15,36,94
420890,"2019",23,10,46,79
420890,"2020",33,18,46,97
420890,"2021",45,22,48,115
420890,"2022",45,14,40,99
420890,"2023",21,9,47,77
420895,"2015",1,0,0,1
420895,"2016",1,0,0,1
420895,"2019",0,0,1,1
420900,"2015",2,0,1,3
420900,"2016",0,1,3,4
420900,"2017",2,0,2,4
420900,"2018",0,3,4,7
420900,"2019",1,0,3,4
420900,"2020",4,1,2,7
420900,"2021",2,0,1,3
420900,"2023",1,2,0,3
420910,"2015",98,25,162,285
420910,"2016",100,39,179,318
420910,"2017",115,21,153,289
420910,"2018",87,31,133,251
420910,"2019",115,27,176,318
420910,"2020",65,34,138,237
420910,"2021",84,27,128,239
420910,"2022",84,21,110,215
420910,"2023",74,25,115,214
420915,"2015",2,0,0,2
420915,"2016",0,0,3,3
420915,"2017",2,1,2,5
420915,"2018",3,0,3,6
420915,"2019",2,1,2,5
420915,"2020",0,0,1,1
420915,"2021",0,0,1,1
420915,"2022",0,0,1,1
420915,"2023",1,0,2,3
420917,"2022",0,0,1,1
420920,"2015",0,0,1,1
420920,"2018",1,0,0,1
420920,"2019",0,0,1,1
420920,"2022",0,0,1,1
420920,"2023",0,1,0,1
420930,"2015",18,4,30,52
420930,"2016",11,8,22,41
420930,"2017",14,7,31,52
420930,"2018",18,3,33,54
420930,"2019",9,4,25,38
420930,"2020",19,4,28,51
420930,"2021",10,2,36,48
420930,"2022",22,7,34,63
420930,"2023",19,4,28,51
420940,"2015",3,0,5,8
420940,"2016",7,2,20,29
420940,"2017",8,0,12,20
420940,"2018",5,1,5,11
420940,"2019",7,0,5,12
420940,"2020",3,0,0,3
420940,"2021",3,0,0,3
420940,"2022",2,0,4,6
420940,"2023",3,2,1,6
420945,"2015",0,0,1,1
420945,"2016",0,0,1,1
420945,"2022",0,0,1,1
420950,"2015",0,0,1,1
420950,"2017",1,0,1,2
420950,"2018",2,0,3,5
420950,"2019",1,1,2,4
420950,"2020",2,0,4,6
420950,"2021",3,0,3,6
420950,"2022",1,0,0,1
420950,"2023",1,0,2,3
420960,"2015",4,0,6,10
420960,"2016",4,1,1,6
420960,"2017",1,0,5,6
420960,"2018",2,3,3,8
420960,"2019",6,0,3,9
420960,"2020",0,0,5,5
420960,"2022",1,1,1,3
420960,"2023",1,0,5,6
420970,"2015",1,1,3,5
420970,"2016",0,0,7,7
420970,"2017",2,0,3,5
420970,"2018",2,0,1,3
420970,"2019",2,0,3,5
420970,"2020",2,0,4,6
420970,"2021",1,0,2,3
420970,"2022",1,0,6,7
420970,"2023",1,1,1,3
420980,"2017",2,0,1,3
420980,"2019",0,0,2,2
420980,"2020",1,0,1,2
420980,"2021",0,0,1,1
420985,"2016",0,0,2,2
420985,"2018",0,1,0,1
420985,"2021",2,0,0,2
420985,"2022",0,0,2,2
420985,"2023",0,0,1,1
420990,"2015",1,0,4,5
420990,"2016",2,0,1,3
420990,"2017",4,1,4,9
420990,"2018",1,0,2,3
420990,"2019",1,0,1,2
420990,"2020",0,0,6,6
420990,"2021",0,0,2,2
420990,"2022",0,0,3,3
420990,"2023",1,0,2,3
421000,"2015",1,0,3,4
421000,"2016",2,1,1,4
421000,"2017",0,1,3,4
421000,"2018",2,0,2,4
421000,"2019",0,1,0,1
421000,"2020",2,0,3,5
421000,"2021",0,1,1,2
421000,"2022",0,0,2,2
421000,"2023",2,0,0,2
421003,"2015",0,1,0,1
421003,"2017",1,0,0,1
421003,"2018",1,0,2,3
421003,"2020",0,1,0,1
421003,"2022",1,0,0,1
421005,"2017",2,0,0,2
421005,"2019",1,0,0,1
421005,"2020",0,0,1,1
421005,"2021",1,0,0,1
421005,"2022",0,0,1,1
421005,"2023",0,0,1,1
421010,"2015",15,4,18,37
421010,"2016",7,3,9,19
421010,"2017",6,3,15,24
421010,"2018",11,2,9,22
421010,"2019",9,0,9,18
421010,"2020",11,0,10,21
421010,"2021",8,1,15,24
421010,"2022",11,4,14,29
421010,"2023",7,3,10,20
421020,"2015",0,0,2,2
421020,"2016",1,0,1,2
421020,"2018",0,0,1,1
421020,"2019",1,0,1,2
421030,"2015",2,0,5,7
421030,"2016",3,1,3,7
421030,"2017",4,1,8,13
421030,"2018",4,1,1,6
421030,"2019",1,0,2,3
421030,"2020",0,0,1,1
421030,"2021",0,1,2,3
421030,"2022",3,0,5,8
421030,"2023",2,0,0,2
421040,"2015",1,0,6,7
421040,"2016",2,0,1,3
421040,"2017",1,1,2,4
421040,"2018",1,0,2,3
421040,"2019",0,1,1,2
421040,"2020",3,0,1,4
421040,"2021",0,0,4,4
421040,"2022",1,1,4,6
421040,"2023",1,1,3,5
421050,"2015",5,0,12,17
421050,"2016",9,5,12,26
421050,"2017",15,2,16,33
421050,"2018",10,3,13,26
421050,"2019",13,5,5,23
421050,"2020",21,0,9,30
421050,"2021",19,2,15,36
421050,"2022",20,6,19,45
421050,"2023",10,5,16,31
421055,"2016",0,0,1,1
421060,"2015",4,0,2,6
421060,"2016",4,2,1,7
421060,"2017",3,0,4,7
421060,"2018",3,2,6,11
421060,"2019",2,3,0,5
421060,"2020",1,0,1,2
421060,"2021",1,1,6,8
421060,"2022",2,2,3,7
421060,"2023",1,1,2,4
421070,"2015",0,0,1,1
421070,"2016",0,0,2,2
421070,"2017",0,0,1,1
421070,"2018",1,0,2,3
421070,"2021",0,0,3,3
421070,"2022",2,1,0,3
421070,"2023",0,0,4,4
421080,"2015",1,0,1,2
421080,"2016",1,0,3,4
421080,"2018",2,0,2,4
421080,"2019",0,0,1,1
421080,"2020",0,0,2,2
421080,"2021",0,0,1,1
421080,"2022",0,0,2,2
421080,"2023",2,0,0,2
421085,"2018",0,0,1,1
421085,"2022",0,0,2,2
421090,"2015",1,0,2,3
421090,"2016",2,0,2,4
421090,"2017",1,0,0,1
421090,"2019",0,1,1,2
421090,"2020",1,0,0,1
421090,"2021",1,0,0,1
421100,"2015",1,0,2,3
421100,"2016",0,2,1,3
421100,"2017",2,1,0,3
421100,"2018",0,0,2,2
421100,"2019",2,1,1,4
421100,"2020",0,0,3,3
421100,"2021",2,0,0,2
421100,"2022",1,0,1,2
421100,"2023",1,1,1,3
421105,"2015",0,0,2,2
421105,"2016",0,0,4,4
421105,"2017",0,1,0,1
421105,"2018",1,0,1,2
421105,"2019",0,0,1,1
421105,"2020",0,0,1,1
421105,"2021",0,0,1,1
421105,"2022",0,0,2,2
421105,"2023",1,0,2,3
421110,"2015",0,1,5,6
421110,"2016",3,0,3,6
421110,"2017",0,0,1,1
421110,"2018",2,0,0,2
421110,"2019",1,0,0,1
421110,"2020",2,0,3,5
421110,"2021",0,0,1,1
421110,"2022",2,1,0,3
421110,"2023",2,0,0,2
421120,"2015",6,2,5,13
421120,"2016",4,0,4,8
421120,"2017",5,1,6,12
421120,"2018",5,2,3,10
421120,"2019",4,0,7,11
421120,"2020",2,1,1,4
421120,"2021",1,2,2,5
421120,"2022",1,0,2,3
421120,"2023",2,0,2,4
421125,"2016",0,0,3,3
421125,"2019",1,0,0,1
421130,"2015",13,3,21,37
421130,"2016",14,2,23,39
421130,"2017",8,3,24,35
421130,"2018",10,1,17,28
421130,"2019",11,2,16,29
421130,"2020",13,8,23,44
421130,"2021",22,3,35,60
421130,"2022",29,12,26,67
421130,"2023",21,3,30,54
421140,"2015",0,1,2,3
421140,"2017",1,0,0,1
421140,"2018",0,0,1,1
421140,"2019",1,0,0,1
421140,"2020",1,0,1,2
421140,"2023",0,0,1,1
421145,"2016",0,0,1,1
421145,"2017",0,0,1,1
421145,"2018",1,0,0,1
421145,"2019",0,0,1,1
421145,"2022",1,0,0,1
421150,"2015",0,0,4,4
421150,"2016",1,0,4,5
421150,"2017",2,1,6,9
421150,"2018",1,1,5,7
421150,"2020",3,2,1,6
421150,"2021",1,1,1,3
421150,"2022",1,0,0,1
421150,"2023",3,0,1,4
421160,"2015",2,0,3,5
421160,"2016",3,0,2,5
421160,"2017",2,0,1,3
421160,"2018",3,1,1,5
421160,"2019",1,1,2,4
421160,"2020",2,3,4,9
421160,"2021",1,0,3,4
421160,"2022",1,0,4,5
421160,"2023",1,0,1,2
421165,"2017",0,0,1,1
421165,"2018",0,0,1,1
421165,"2019",1,0,0,1
421170,"2015",3,0,10,13
421170,"2016",4,0,12,16
421170,"2017",8,1,5,14
421170,"2018",4,2,7,13
421170,"2019",3,1,5,9
421170,"2020",3,3,7,13
421170,"2021",5,0,5,10
421170,"2022",4,1,1,6
421170,"2023",0,0,5,5
421175,"2015",0,0,1,1
421175,"2016",0,0,5,5
421175,"2017",2,0,2,4
421175,"2018",1,2,1,4
421175,"2019",0,1,1,2
421175,"2020",1,0,2,3
421175,"2021",3,0,3,6
421175,"2022",1,0,6,7
421175,"2023",2,0,3,5
421180,"2015",2,0,3,5
421180,"2016",1,1,1,3
421180,"2017",0,2,5,7
421180,"2018",3,0,1,4
421180,"2019",3,0,1,4
421180,"2020",2,1,2,5
421180,"2021",1,0,1,2
421180,"2022",0,0,1,1
421180,"2023",1,0,0,1
421185,"2017",0,0,2,2
421185,"2018",0,0,1,1
421185,"2020",0,0,1,1
421185,"2022",1,1,0,2
421185,"2023",0,0,1,1
421187,"2015",1,0,0,1
421187,"2018",0,0,1,1
421189,"2016",0,0,1,1
421189,"2017",0,0,2,2
421189,"2018",1,0,1,2
421189,"2019",0,0,1,1
421189,"2021",0,0,1,1
421189,"2022",0,0,2,2
421190,"2015",27,7,41,75
421190,"2016",33,10,56,99
421190,"2017",34,16,75,125
421190,"2018",43,11,85,139
421190,"2019",46,16,92,154
421190,"2020",37,20,56,113
421190,"2021",56,16,64,136
421190,"2022",39,18,69,126
421190,"2023",35,16,53,104
421200,"2015",0,0,2,2
421200,"2016",0,0,5,5
421200,"2017",0,2,4,6
421200,"2018",1,1,3,5
421200,"2019",1,0,3,4
421200,"2020",1,1,1,3
421200,"2021",2,0,5,7
421200,"2022",2,0,0,2
421200,"2023",2,0,1,3
421205,"2016",0,1,0,1
421205,"2017",1,0,0,1
421205,"2018",1,0,0,1
421205,"2019",0,0,1,1
421210,"2015",0,1,0,1
421210,"2016",1,2,0,3
421210,"2017",0,0,1,1
421210,"2018",0,0,1,1
421210,"2019",2,0,1,3
421210,"2020",0,1,1,2
421210,"2021",1,1,1,3
421210,"2022",1,0,1,2
421210,"2023",1,0,0,1
421220,"2015",1,0,8,9
421220,"2016",5,2,9,16
421220,"2017",4,1,3,8
421220,"2018",6,0,3,9
421220,"2019",3,0,2,5
421220,"2020",3,0,2,5
421220,"2021",0,1,2,3
421220,"2022",0,1,7,8
421220,"2023",0,1,3,4
421223,"2016",1,0,1,2
421223,"2020",0,1,1,2
421223,"2023",1,0,0,1
421225,"2015",1,0,1,2
421225,"2016",0,0,2,2
421225,"2017",0,0,2,2
421225,"2018",4,2,1,7
421225,"2019",3,0,2,5
421225,"2020",0,0,3,3
421225,"2021",0,3,1,4
421225,"2022",1,0,0,1
421225,"2023",2,0,0,2
421227,"2016",0,1,0,1
421227,"2017",1,0,0,1
421227,"2020",0,0,1,1
421227,"2021",1,0,1,2
421227,"2022",0,1,0,1
421230,"2015",0,0,2,2
421230,"2016",2,0,6,8
421230,"2017",2,3,6,11
421230,"2018",1,0,6,7
421230,"2019",2,0,1,3
421230,"2020",1,0,2,3
421230,"2021",1,1,2,4
421230,"2022",1,1,1,3
421230,"2023",0,0,1,1
421240,"2015",2,0,0,2
421240,"2017",0,0,2,2
421240,"2018",0,0,1,1
421240,"2021",0,0,1,1
421240,"2023",1,0,0,1
421250,"2015",2,3,3,8
421250,"2016",1,3,8,12
421250,"2017",2,3,5,10
421250,"2018",1,0,4,5
421250,"2019",3,0,5,8
421250,"2020",1,0,8,9
421250,"2021",8,4,3,15
421250,"2022",5,1,6,12
421250,"2023",3,2,5,10
421260,"2017",0,0,1,1
421265,"2015",0,0,1,1
421265,"2016",0,0,1,1
421265,"2017",1,0,2,3
421265,"2018",0,0,1,1
421265,"2019",1,0,0,1
421265,"2020",1,0,2,3
421265,"2023",1,0,1,2
421270,"2016",0,0,2,2
421270,"2017",0,2,2,4
421270,"2018",1,0,3,4
421270,"2020",1,0,4,5
421270,"2021",0,0,4,4
421270,"2022",1,0,0,1
421280,"2015",10,3,13,26
421280,"2016",6,1,10,17
421280,"2017",2,1,8,11
421280,"2018",3,0,3,6
421280,"2019",2,0,3,5
421280,"2020",6,1,9,16
421280,"2021",4,0,7,11
421280,"2022",5,2,0,7
421280,"2023",4,2,7,13
421290,"2015",0,1,2,3
421290,"2016",1,0,0,1
421290,"2017",0,0,1,1
421290,"2018",4,0,3,7
421290,"2019",2,1,0,3
421290,"2020",1,0,0,1
421290,"2021",4,0,0,4
421290,"2022",1,0,1,2
421300,"2015",0,0,1,1
421300,"2017",1,0,0,1
421300,"2018",0,0,1,1
421300,"2021",0,0,1,1
421300,"2022",2,0,3,5
421310,"2016",0,1,1,2
421310,"2019",0,0,1,1
421310,"2021",2,0,0,2
421310,"2022",0,0,1,1
421315,"2015",1,0,0,1
421315,"2016",0,0,1,1
421315,"2018",1,0,0,1
421315,"2022",0,0,1,1
421320,"2015",7,1,6,14
421320,"2016",10,7,12,29
421320,"2017",12,1,10,23
421320,"2018",15,2,10,27
421320,"2019",9,4,6,19
421320,"2020",3,0,4,7
421320,"2021",8,2,10,20
421320,"2022",4,3,6,13
421320,"2023",3,1,5,9
421330,"2017",0,0,1,1
421330,"2018",1,0,1,2
421330,"2020",0,0,2,2
421330,"2021",0,0,3,3
421330,"2023",0,0,1,1
421335,"2015",0,0,3,3
421335,"2019",0,0,2,2
421335,"2021",0,0,2,2
421335,"2022",1,0,1,2
421340,"2016",2,0,3,5
421340,"2017",1,0,0,1
421340,"2018",0,0,4,4
421340,"2019",1,0,1,2
421340,"2020",1,0,1,2
421340,"2021",2,1,3,6
421340,"2022",0,0,2,2
421340,"2023",1,0,3,4
421350,"2015",1,2,3,6
421350,"2016",4,0,3,7
421350,"2017",6,1,4,11
421350,"2018",2,1,6,9
421350,"2019",5,3,10,18
421350,"2020",5,0,1,6
421350,"2021",7,5,7,19
421350,"2022",5,2,4,11
421350,"2023",2,2,3,7
421360,"2015",8,0,13,21
421360,"2016",7,1,18,26
421360,"2017",7,1,16,24
421360,"2018",6,1,10,17
421360,"2019",2,0,9,11
421360,"2020",5,4,14,23
421360,"2021",1,3,5,9
421360,"2022",4,1,4,9
421360,"2023",6,1,5,12
421370,"2015",1,0,0,1
421370,"2016",0,0,1,1
421370,"2017",1,0,6,7
421370,"2018",2,1,3,6
421370,"2019",2,1,7,10
421370,"2020",3,2,5,10
421370,"2021",2,1,9,12
421370,"2022",2,0,6,8
421370,"2023",1,0,2,3
421380,"2015",2,0,2,4
421380,"2016",1,0,2,3
421380,"2017",2,0,2,4
421380,"2018",1,0,2,3
421380,"2019",1,0,1,2
421380,"2020",0,1,1,2
421380,"2021",0,1,3,4
421380,"2023",3,0,1,4
421400,"2015",6,2,7,15
421400,"2016",0,0,4,4
421400,"2017",7,2,9,18
421400,"2018",4,2,0,6
421400,"2019",2,0,4,6
421400,"2020",4,0,8,12
421400,"2021",3,1,5,9
421400,"2022",0,1,3,4
421400,"2023",0,1,0,1
421410,"2015",0,1,1,2
421410,"2016",0,1,1,2
421410,"2017",0,0,1,1
421410,"2018",1,0,0,1
421410,"2019",2,1,0,3
421410,"2020",0,1,0,1
421410,"2022",1,0,0,1
421410,"2023",0,0,1,1
421415,"2016",2,0,1,3
421415,"2017",1,0,0,1
421415,"2019",0,0,2,2
421415,"2020",1,0,2,3
421415,"2021",0,0,1,1
421415,"2022",1,0,0,1
421415,"2023",0,0,1,1
421420,"2015",1,0,1,2
421420,"2016",3,0,2,5
421420,"2017",2,0,3,5
421420,"2018",0,0,2,2
421420,"2019",0,2,0,2
421420,"2020",2,0,1,3
421420,"2021",1,1,2,4
421420,"2022",0,0,2,2
421420,"2023",0,0,1,1
421430,"2016",1,0,1,2
421430,"2017",1,0,1,2
421430,"2019",0,0,1,1
421430,"2021",1,0,2,3
421440,"2015",0,0,2,2
421440,"2016",2,0,1,3
421440,"2017",3,0,1,4
421440,"2018",0,1,1,2
421440,"2019",1,0,4,5
421440,"2020",0,0,1,1
421440,"2021",3,0,2,5
421440,"2022",2,0,1,3
421440,"2023",0,0,1,1
421450,"2017",0,0,1,1
421450,"2018",1,0,0,1
421450,"2019",0,0,2,2
421450,"2020",0,1,1,2
421450,"2021",0,1,3,4
421450,"2022",1,1,2,4
421450,"2023",0,0,1,1
421460,"2015",1,0,1,2
421460,"2016",0,0,1,1
421460,"2017",2,0,1,3
421460,"2018",1,0,4,5
421460,"2019",2,1,6,9
421460,"2020",1,1,2,4
421460,"2021",3,1,0,4
421460,"2022",3,1,1,5
421460,"2023",3,0,3,6
421470,"2015",2,0,4,6
421470,"2016",2,1,2,5
421470,"2017",1,0,2,3
421470,"2018",1,1,0,2
421470,"2019",1,1,0,2
421470,"2020",2,0,3,5
421470,"2021",1,0,2,3
421470,"2022",1,0,0,1
421470,"2023",1,0,0,1
421480,"2015",3,0,6,9
421480,"2016",6,2,6,14
421480,"2017",18,5,15,38
421480,"2018",19,6,25,50
421480,"2019",8,4,19,31
421480,"2020",12,2,15,29
421480,"2021",10,1,17,28
421480,"2022",13,1,18,32
421480,"2023",8,1,11,20
421490,"2015",1,0,0,1
421490,"2017",0,0,1,1
421490,"2019",1,0,0,1
421490,"2020",0,0,1,1
421490,"2023",0,1,1,2
421500,"2015",15,4,42,61
421500,"2016",17,4,34,55
421500,"2017",12,3,21,36
421500,"2018",13,3,22,38
421500,"2019",8,3,16,27
421500,"2020",9,4,11,24
421500,"2021",9,1,12,22
421500,"2022",5,0,15,20
421500,"2023",6,1,7,14
421505,"2015",0,0,1,1
421505,"2020",0,0,1,1
421505,"2021",0,0,4,4
421507,"2015",0,0,1,1
421507,"2017",0,0,1,1
421507,"2020",0,0,1,1
421507,"2021",1,1,2,4
421510,"2015",1,0,3,4
421510,"2016",2,0,3,5
421510,"2017",0,2,1,3
421510,"2018",1,1,1,3
421510,"2019",1,1,1,3
421510,"2020",2,0,2,4
421510,"2021",0,1,2,3
421510,"2022",2,0,3,5
421510,"2023",1,0,1,2
421520,"2015",1,1,1,3
421520,"2018",1,1,0,2
421520,"2021",0,0,1,1
421520,"2022",1,0,0,1
421530,"2015",0,0,3,3
421530,"2017",1,0,1,2
421530,"2018",1,0,2,3
421530,"2019",0,0,1,1
421530,"2020",3,0,0,3
421530,"2021",2,0,1,3
421530,"2022",1,1,0,2
421530,"2023",1,0,0,1
421535,"2015",2,0,0,2
421535,"2016",1,0,1,2
421535,"2017",1,0,1,2
421535,"2018",1,0,1,2
421535,"2020",0,1,0,1
421535,"2021",1,0,0,1
421535,"2022",0,0,1,1
421540,"2015",0,2,0,2
421540,"2017",0,1,1,2
421540,"2018",0,0,1,1
421540,"2020",0,0,2,2
421540,"2021",0,0,1,1
421545,"2015",1,1,4,6
421545,"2016",3,0,2,5
421545,"2017",0,0,3,3
421545,"2018",2,0,2,4
421545,"2019",2,0,0,2
421545,"2020",0,0,1,1
421545,"2021",3,0,1,4
421545,"2022",0,0,1,1
421545,"2023",0,1,0,1
421550,"2015",2,0,4,6
421550,"2016",1,0,5,6
421550,"2017",0,0,9,9
421550,"2018",2,0,9,11
421550,"2019",0,0,6,6
421550,"2020",2,2,4,8
421550,"2021",2,1,6,9
421550,"2022",1,0,4,5
421550,"2023",1,0,4,5
421555,"2020",0,0,1,1
421560,"2016",0,1,0,1
421560,"2018",0,1,0,1
421560,"2021",0,1,0,1
421565,"2015",1,0,4,5
421565,"2016",2,0,1,3
421565,"2017",1,2,2,5
421565,"2018",1,0,3,4
421565,"2019",2,1,3,6
421565,"2020",5,0,3,8
421565,"2021",1,0,1,2
421565,"2022",4,1,2,7
421565,"2023",1,0,0,1
421567,"2015",0,0,5,5
421567,"2017",1,0,2,3
421567,"2018",2,0,0,2
421567,"2019",1,0,1,2
421567,"2020",0,1,0,1
421567,"2021",2,1,1,4
421567,"2022",2,1,2,5
421567,"2023",0,0,1,1
421568,"2015",0,0,1,1
421568,"2016",0,0,2,2
421568,"2017",2,0,1,3
421568,"2018",0,1,3,4
421568,"2019",1,0,1,2
421568,"2020",1,0,0,1
421568,"2021",0,1,1,2
421568,"2022",1,0,0,1
421568,"2023",0,0,1,1
421569,"2016",0,0,1,1
421569,"2021",0,1,0,1
421570,"2015",5,1,4,10
421570,"2016",3,1,11,15
421570,"2017",5,3,7,15
421570,"2018",6,2,9,17
421570,"2019",8,0,7,15
421570,"2020",6,2,2,10
421570,"2021",5,0,6,11
421570,"2022",6,2,7,15
421570,"2023",3,1,3,7
421575,"2017",0,0,2,2
421575,"2018",0,0,1,1
421575,"2020",1,0,1,2
421575,"2021",0,0,1,1
421580,"2015",2,2,2,6
421580,"2016",1,4,4,9
421580,"2017",13,2,17,32
421580,"2018",12,6,14,32
421580,"2019",6,1,11,18
421580,"2020",10,5,13,28
421580,"2021",14,3,18,35
421580,"2022",10,8,17,35
421580,"2023",4,7,25,36
421590,"2015",1,0,1,2
421590,"2016",0,0,1,1
421590,"2019",1,0,0,1
421590,"2020",0,0,1,1
421590,"2021",1,0,0,1
421590,"2022",1,1,0,2
421590,"2023",0,0,1,1
421600,"2015",5,0,1,6
421600,"2016",3,0,3,6
421600,"2017",1,0,6,7
421600,"2018",1,1,1,3
421600,"2019",1,0,0,1
421600,"2020",0,1,0,1
421600,"2022",1,0,0,1
421600,"2023",0,1,0,1
421605,"2015",1,0,0,1
421605,"2016",1,0,0,1
421605,"2017",1,0,0,1
421605,"2019",1,0,1,2
421605,"2021",1,0,1,2
421605,"2022",2,0,2,4
421605,"2023",0,0,1,1
421610,"2015",0,0,1,1
421610,"2016",1,0,1,2
421610,"2017",0,0,4,4
421610,"2019",0,1,2,3
421610,"2021",0,1,1,2
421610,"2022",1,0,1,2
421610,"2023",2,0,1,3
421620,"2015",9,1,22,32
421620,"2016",9,2,13,24
421620,"2017",12,3,22,37
421620,"2018",9,4,14,27
421620,"2019",5,2,17,24
421620,"2020",13,4,16,33
421620,"2021",6,3,10,19
421620,"2022",4,0,9,13
421620,"2023",6,4,6,16
421625,"2017",1,1,0,2
421625,"2018",0,0,1,1
421625,"2019",0,0,2,2
421625,"2021",1,0,1,2
421630,"2015",3,2,4,9
421630,"2016",5,0,5,10
421630,"2017",3,2,9,14
421630,"2018",4,0,6,10
421630,"2019",3,2,7,12
421630,"2020",5,0,3,8
421630,"2021",4,1,5,10
421630,"2022",7,1,7,15
421630,"2023",0,1,3,4
421635,"2015",1,0,1,2
421635,"2017",2,1,0,3
421635,"2018",0,1,1,2
421635,"2019",1,0,0,1
421635,"2020",0,1,0,1
421635,"2022",3,0,2,5
421640,"2015",1,0,4,5
421640,"2016",3,1,4,8
421640,"2017",2,1,0,3
421640,"2018",3,0,3,6
421640,"2019",2,0,0,2
421640,"2020",1,1,2,4
421640,"2021",2,0,1,3
421640,"2022",2,0,0,2
421650,"2015",0,0,1,1
421650,"2016",0,0,1,1
421650,"2017",2,0,1,3
421650,"2018",2,0,5,7
421650,"2019",4,0,10,14
421650,"2020",2,0,4,6
421650,"2021",2,1,7,10
421650,"2022",5,1,8,14
421650,"2023",3,1,5,9
421660,"2015",44,7,65,116
421660,"2016",49,13,82,144
421660,"2017",52,8,94,154
421660,"2018",53,22,91,166
421660,"2019",54,20,79,153
421660,"2020",53,18,70,141
421660,"2021",65,12,74,151
421660,"2022",52,14,73,139
421660,"2023",37,9,56,102
421670,"2016",1,0,1,2
421670,"2017",2,1,2,5
421670,"2018",0,0,3,3
421670,"2019",2,1,0,3
421670,"2020",2,0,1,3
421670,"2021",1,0,1,2
421670,"2022",1,0,0,1
421670,"2023",1,0,1,2
421680,"2017",1,0,1,2
421680,"2018",0,0,1,1
421680,"2019",2,0,0,2
421680,"2020",2,0,0,2
421680,"2021",0,0,1,1
421680,"2023",0,0,1,1
421690,"2015",1,1,4,6
421690,"2016",5,0,2,7
421690,"2017",3,1,8,12
421690,"2018",1,0,7,8
421690,"2019",1,0,3,4
421690,"2020",0,0,2,2
421690,"2021",1,0,1,2
421690,"2023",0,0,1,1
421700,"2015",4,0,4,8
421700,"2016",4,0,10,14
421700,"2017",4,0,2,6
421700,"2019",1,0,1,2
421700,"2020",0,0,5,5
421700,"2021",2,0,2,4
421700,"2022",2,0,1,3
421700,"2023",0,0,1,1
421710,"2015",1,0,0,1
421710,"2016",1,0,2,3
421710,"2017",1,0,0,1
421710,"2018",2,0,0,2
421710,"2019",1,0,0,1
421710,"2020",1,0,0,1
421710,"2022",0,0,1,1
421715,"2015",0,0,1,1
421715,"2016",0,1,0,1
421715,"2018",1,0,2,3
421715,"2019",4,0,0,4
421715,"2020",2,0,1,3
421715,"2021",0,0,3,3
421715,"2022",1,0,1,2
421715,"2023",1,0,0,1
421720,"2015",12,1,8,21
421720,"2016",6,0,3,9
421720,"2017",5,0,5,10
421720,"2018",7,2,6,15
421720,"2019",4,2,8,14
421720,"2020",3,1,3,7
421720,"2021",1,0,6,7
421720,"2022",2,1,6,9
421720,"2023",2,0,6,8
421725,"2018",1,0,2,3
421725,"2019",1,0,0,1
421725,"2020",0,0,1,1
421725,"2023",1,0,0,1
421730,"2015",0,0,5,5
421730,"2016",2,1,0,3
421730,"2017",3,0,4,7
421730,"2018",1,0,1,2
421730,"2019",2,1,2,5
421730,"2020",1,0,6,7
421730,"2021",0,0,1,1
421730,"2023",0,0,1,1
421740,"2015",4,1,1,6
421740,"2016",3,0,6,9
421740,"2017",2,2,3,7
421740,"2018",7,2,8,17
421740,"2019",3,0,2,5
421740,"2020",5,1,3,9
421740,"2021",5,1,3,9
421740,"2022",2,2,5,9
421740,"2023",0,0,2,2
421750,"2015",6,0,4,10
421750,"2016",1,0,3,4
421750,"2017",3,0,3,6
421750,"2018",2,1,4,7
421750,"2019",5,0,4,9
421750,"2020",4,0,4,8
421750,"2021",2,1,4,7
421750,"2022",2,0,5,7
421750,"2023",2,0,1,3
421755,"2015",0,2,1,3
421755,"2016",1,0,1,2
421755,"2019",0,0,2,2
421755,"2021",0,0,1,1
421755,"2023",0,0,2,2
421760,"2015",2,1,2,5
421760,"2016",1,0,1,2
421760,"2017",3,0,5,8
421760,"2018",3,1,3,7
421760,"2019",3,1,5,9
421760,"2020",3,0,3,6
421760,"2021",4,2,3,9
421760,"2022",2,0,4,6
421760,"2023",1,0,2,3
421770,"2015",9,1,16,26
421770,"2016",5,2,10,17
421770,"2017",4,5,8,17
421770,"2018",7,2,8,17
421770,"2019",7,1,3,11
421770,"2020",6,3,17,26
421770,"2021",6,0,5,11
421770,"2022",4,0,6,10
421770,"2023",3,1,4,8
421775,"2015",1,1,1,3
421775,"2016",1,0,0,1
421775,"2017",1,0,4,5
421775,"2018",0,2,0,2
421775,"2019",2,0,2,4
421775,"2020",1,0,0,1
421775,"2021",0,0,1,1
421775,"2022",1,0,1,2
421780,"2015",2,0,10,12
421780,"2016",1,0,0,1
421780,"2017",11,1,13,25
421780,"2018",6,1,5,12
421780,"2019",0,2,4,6
421780,"2020",0,0,4,4
421780,"2021",5,0,3,8
421780,"2022",3,0,5,8
421780,"2023",2,1,5,8
421790,"2015",0,0,1,1
421790,"2016",0,0,1,1
421790,"2018",1,0,1,2
421790,"2019",1,0,0,1
421790,"2020",3,0,1,4
421790,"2023",1,0,0,1
421795,"2016",2,2,0,4
421795,"2017",0,0,1,1
421795,"2018",2,0,2,4
421795,"2019",0,1,2,3
421795,"2020",2,1,1,4
421795,"2021",1,0,0,1
421795,"2022",2,0,2,4
421795,"2023",4,1,0,5
421800,"2015",7,1,10,18
421800,"2016",2,1,20,23
421800,"2017",8,1,15,24
421800,"2018",7,2,14,23
421800,"2019",9,1,8,18
421800,"2020",6,3,11,20
421800,"2021",7,1,10,18
421800,"2022",8,0,17,25
421800,"2023",4,1,9,14
421810,"2015",0,0,2,2
421810,"2016",1,1,1,3
421810,"2017",0,0,2,2
421810,"2018",1,0,0,1
421810,"2019",3,1,1,5
421810,"2021",1,0,1,2
421810,"2023",1,0,3,4
421820,"2015",3,1,13,17
421820,"2016",8,5,14,27
421820,"2017",6,1,5,12
421820,"2018",3,1,7,11
421820,"2019",2,0,10,12
421820,"2020",5,2,10,17
421820,"2021",2,0,7,9
421820,"2022",4,0,4,8
421820,"2023",4,0,8,12
421825,"2015",1,0,5,6
421825,"2016",1,0,6,7
421825,"2017",3,0,5,8
421825,"2018",1,1,5,7
421825,"2019",1,1,1,3
421825,"2020",4,0,2,6
421825,"2021",2,0,4,6
421825,"2022",2,0,5,7
421825,"2023",0,0,1,1
421830,"2015",0,0,2,2
421830,"2016",5,1,8,14
421830,"2017",4,0,9,13
421830,"2018",10,0,12,22
421830,"2019",7,2,8,17
421830,"2020",4,2,11,17
421830,"2021",5,2,13,20
421830,"2022",11,1,6,18
421830,"2023",7,2,10,19
421835,"2015",0,1,0,1
421835,"2016",2,0,2,4
421835,"2017",1,1,0,2
421835,"2018",0,0,1,1
421835,"2019",0,1,0,1
421835,"2020",0,1,1,2
421840,"2016",1,0,0,1
421840,"2018",2,0,0,2
421840,"2019",1,0,0,1
421840,"2020",0,0,1,1
421840,"2021",0,0,1,1
421840,"2022",1,0,0,1
421840,"2023",0,0,1,1
421850,"2015",3,0,3,6
421850,"2016",2,0,1,3
421850,"2017",0,1,0,1
421850,"2018",0,1,2,3
421850,"2019",2,0,2,4
421850,"2020",1,0,1,2
421850,"2022",0,0,1,1
421860,"2016",0,0,2,2
421860,"2017",0,1,2,3
421860,"2018",2,0,3,5
421860,"2019",2,0,3,5
421860,"2020",3,0,2,5
421860,"2021",3,1,0,4
421860,"2022",2,0,0,2
421860,"2023",0,0,4,4
421870,"2015",13,4,26,43
421870,"2016",8,4,8,20
421870,"2017",7,4,9,20
421870,"2018",9,1,8,18
421870,"2019",10,4,7,21
421870,"2020",9,1,5,15
421870,"2021",6,0,5,11
421870,"2022",6,1,16,23
421870,"2023",8,6,6,20
421875,"2017",0,0,1,1
421875,"2018",0,0,1,1
421875,"2019",2,0,0,2
421875,"2021",0,0,1,1
421875,"2023",1,0,1,2
421880,"2015",1,0,3,4
421880,"2016",1,0,0,1
421880,"2017",1,0,3,4
421880,"2018",1,0,5,6
421880,"2019",2,0,2,4
421880,"2020",1,0,3,4
421880,"2021",1,0,0,1
421880,"2022",2,0,1,3
421880,"2023",0,1,2,3
421885,"2017",0,0,1,1
421885,"2018",0,0,1,1
421885,"2019",0,0,1,1
421885,"2022",1,0,0,1
421890,"2015",1,0,2,3
421890,"2016",1,1,2,4
421890,"2017",0,0,1,1
421890,"2018",0,0,1,1
421890,"2019",0,0,4,4
421890,"2020",0,0,1,1
421890,"2021",1,1,2,4
421890,"2022",1,0,2,3
421890,"2023",1,0,2,3
421895,"2017",1,0,0,1
421895,"2020",0,1,0,1
421900,"2015",6,1,7,14
421900,"2016",6,0,4,10
421900,"2017",3,0,3,6
421900,"2018",0,0,3,3
421900,"2019",5,1,6,12
421900,"2020",9,0,2,11
421900,"2021",3,0,1,4
421900,"2022",1,1,6,8
421900,"2023",1,1,2,4
421910,"2015",0,0,1,1
421910,"2016",0,1,1,2
421910,"2017",1,0,1,2
421910,"2018",2,1,2,5
421910,"2019",0,1,2,3
421910,"2022",1,0,1,2
421910,"2023",2,0,1,3
421915,"2016",1,0,0,1
421915,"2017",0,0,1,1
421915,"2018",0,0,1,1
421915,"2020",0,0,1,1
421915,"2021",0,0,1,1
421915,"2022",0,0,2,2
421917,"2015",0,0,1,1
421917,"2016",0,0,1,1
421917,"2018",0,0,2,2
421917,"2019",1,0,0,1
421920,"2016",2,0,1,3
421920,"2017",0,0,2,2
421920,"2018",1,0,3,4
421920,"2020",1,0,0,1
421920,"2021",1,0,1,2
421920,"2022",1,0,1,2
421920,"2023",2,0,1,3
421930,"2015",6,3,20,29
421930,"2016",2,1,17,20
421930,"2017",3,1,9,13
421930,"2018",4,2,10,16
421930,"2019",5,0,7,12
421930,"2020",13,0,8,21
421930,"2021",12,1,11,24
421930,"2022",8,5,19,32
421930,"2023",6,1,13,20
421935,"2015",1,0,2,3
421935,"2016",3,0,1,4
421935,"2017",2,1,2,5
421935,"2018",0,1,1,2
421935,"2019",1,0,1,2
421935,"2021",0,0,1,1
421940,"2015",0,0,1,1
421940,"2016",2,1,2,5
421940,"2017",2,0,2,4
421940,"2018",0,0,1,1
421940,"2019",1,0,1,2
421940,"2020",1,0,1,2
421940,"2021",1,0,1,2
421940,"2022",1,0,0,1
421950,"2015",2,0,5,7
421950,"2016",5,1,5,11
421950,"2017",7,3,10,20
421950,"2018",1,2,4,7
421950,"2019",7,1,10,18
421950,"2020",5,5,6,16
421950,"2021",5,3,2,10
421950,"2022",10,2,9,21
421950,"2023",8,0,8,16
421970,"2015",1,0,3,4
421970,"2016",2,0,6,8
421970,"2017",0,0,1,1
421970,"2018",0,0,4,4
421970,"2019",0,0,3,3
421970,"2020",7,0,5,12
421970,"2021",2,0,5,7
421970,"2022",2,1,3,6
421970,"2023",2,1,0,3
421985,"2015",2,0,1,3
421985,"2016",2,0,2,4
421985,"2017",1,1,0,2
421985,"2018",1,0,4,5
421985,"2019",1,0,1,2
421985,"2020",0,1,3,4
421985,"2021",0,0,2,2
421985,"2022",1,0,0,1
421985,"2023",1,0,0,1
422000,"2015",1,0,5,6
422000,"2016",6,1,6,13
422000,"2017",1,1,1,3
422000,"2018",2,0,2,4
422000,"2019",2,0,7,9
422000,"2020",0,0,1,1
422000,"2021",3,2,2,7
422000,"2022",1,0,2,3
422000,"2023",0,1,3,4
430003,"2015",2,0,1,3
430003,"2016",0,0,1,1
430003,"2017",1,1,2,4
430003,"2018",1,0,3,4
430003,"2019",1,1,1,3
430003,"2020",2,0,1,3
430003,"2021",2,1,1,4
430003,"2022",1,0,3,4
430003,"2023",0,0,3,3
430005,"2015",0,1,1,2
430005,"2019",0,0,1,1
430005,"2020",0,0,1,1
430005,"2021",0,0,1,1
430005,"2023",5,0,0,5
430010,"2015",4,0,1,5
430010,"2016",2,0,3,5
430010,"2017",1,0,1,2
430010,"2018",4,1,2,7
430010,"2019",1,0,2,3
430010,"2020",0,1,0,1
430010,"2021",0,0,2,2
430010,"2022",1,0,1,2
430010,"2023",2,1,3,6
430020,"2020",1,1,2,4
430020,"2021",0,0,1,1
430030,"2023",0,0,1,1
430040,"2015",0,1,6,7
430040,"2017",5,0,3,8
430040,"2018",1,0,1,2
430040,"2019",1,0,2,3
430040,"2020",1,0,1,2
430040,"2021",0,1,2,3
430040,"2022",1,0,4,5
430040,"2023",1,0,1,2
430045,"2015",0,0,2,2
430045,"2016",1,0,0,1
430045,"2019",2,0,1,3
430045,"2020",1,0,0,1
430045,"2021",0,0,1,1
430047,"2018",1,0,0,1
430047,"2020",0,1,0,1
430050,"2016",1,0,0,1
430050,"2019",1,0,0,1
430050,"2020",1,2,0,3
430050,"2021",0,1,2,3
430050,"2022",0,0,1,1
430055,"2015",1,0,1,2
430055,"2019",1,0,0,1
430055,"2022",1,0,0,1
430057,"2016",0,1,0,1
430057,"2018",0,0,1,1
430057,"2021",0,1,0,1
430057,"2022",0,0,1,1
430057,"2023",0,0,1,1
430060,"2015",26,5,46,77
430060,"2016",19,3,37,59
430060,"2017",15,9,24,48
430060,"2018",15,1,21,37
430060,"2019",12,6,18,36
430060,"2020",21,7,21,49
430060,"2021",19,5,26,50
430060,"2022",12,4,24,40
430060,"2023",13,4,14,31
430063,"2015",0,0,1,1
430063,"2016",0,1,0,1
430063,"2018",0,0,2,2
430063,"2019",0,0,1,1
430063,"2020",0,0,3,3
430063,"2021",0,0,2,2
430063,"2023",0,0,1,1
430064,"2015",2,0,0,2
430064,"2016",0,1,1,2
430064,"2017",1,1,2,4
430064,"2019",0,0,1,1
430064,"2020",1,0,2,3
430064,"2021",0,0,1,1
430064,"2022",0,1,0,1
430064,"2023",1,0,5,6
430066,"2015",1,0,0,1
430066,"2020",0,0,1,1
430070,"2016",0,0,1,1
430070,"2018",0,0,1,1
430070,"2019",0,0,1,1
430070,"2020",1,0,0,1
430070,"2021",1,0,2,3
430070,"2022",3,0,1,4
430070,"2023",1,0,0,1
430080,"2015",0,0,1,1
430080,"2016",1,0,0,1
430080,"2017",2,0,0,2
430080,"2018",0,0,1,1
430080,"2019",2,1,2,5
430080,"2020",1,2,3,6
430080,"2021",1,0,1,2
430080,"2022",0,0,2,2
430080,"2023",0,0,1,1
430085,"2016",1,0,0,1
430085,"2017",0,0,1,1
430085,"2018",1,0,0,1
430085,"2019",1,0,1,2
430085,"2021",0,0,3,3
430085,"2022",1,0,0,1
430087,"2015",0,1,3,4
430087,"2016",0,0,2,2
430087,"2017",5,0,2,7
430087,"2018",0,0,3,3
430087,"2019",4,1,2,7
430087,"2020",1,0,6,7
430087,"2021",4,0,4,8
430087,"2022",4,2,3,9
430087,"2023",3,0,3,6
430090,"2018",0,0,1,1
430090,"2020",1,0,1,2
430100,"2015",1,1,1,3
430100,"2016",3,0,0,3
430100,"2019",0,1,0,1
430100,"2021",1,0,2,3
430100,"2022",2,0,3,5
430100,"2023",3,0,1,4
430105,"2015",1,0,3,4
430105,"2016",2,1,1,4
430105,"2017",0,0,1,1
430105,"2018",2,0,0,2
430105,"2019",0,0,1,1
430105,"2020",1,1,0,2
430105,"2021",0,0,1,1
430105,"2022",0,0,1,1
430107,"2015",1,0,0,1
430107,"2016",0,0,1,1
430107,"2021",0,2,1,3
430110,"2015",3,1,1,5
430110,"2016",5,0,2,7
430110,"2017",1,0,2,3
430110,"2018",2,0,4,6
430110,"2019",2,0,3,5
430110,"2020",4,0,1,5
430110,"2021",3,1,3,7
430110,"2022",2,1,5,8
430110,"2023",0,1,1,2
430120,"2015",0,0,1,1
430120,"2016",1,0,1,2
430120,"2022",0,0,1,1
430120,"2023",1,0,0,1
430130,"2015",2,2,9,13
430130,"2016",4,2,1,7
430130,"2017",4,0,2,6
430130,"2018",3,1,7,11
430130,"2019",2,0,7,9
430130,"2020",4,0,7,11
430130,"2021",2,0,2,4
430130,"2022",2,0,3,5
430130,"2023",4,0,4,8
430140,"2015",2,0,1,3
430140,"2016",0,0,1,1
430140,"2017",1,0,0,1
430140,"2018",1,0,1,2
430140,"2022",0,0,2,2
430150,"2016",1,1,2,4
430150,"2017",0,1,1,2
430150,"2018",0,1,1,2
430150,"2019",0,0,3,3
430150,"2021",1,0,0,1
430150,"2023",1,0,1,2
430155,"2017",0,1,0,1
430155,"2020",0,0,1,1
430155,"2021",0,0,1,1
430155,"2022",1,0,0,1
430155,"2023",1,0,0,1
430160,"2015",43,10,49,102
430160,"2016",43,7,49,99
430160,"2017",34,6,51,91
430160,"2018",35,6,48,89
430160,"2019",42,14,66,122
430160,"2020",25,9,45,79
430160,"2021",32,6,28,66
430160,"2022",26,4,23,53
430160,"2023",23,2,43,68
430163,"2015",3,2,2,7
430163,"2016",1,1,3,5
430163,"2017",3,0,3,6
430163,"2018",0,2,4,6
430163,"2019",0,0,5,5
430163,"2020",2,1,0,3
430163,"2021",2,0,3,5
430163,"2022",0,0,3,3
430163,"2023",0,1,2,3
430165,"2015",1,0,0,1
430165,"2016",0,1,3,4
430165,"2018",0,1,1,2
430165,"2019",1,0,0,1
430165,"2020",1,0,1,2
430165,"2021",0,0,2,2
430165,"2022",1,0,1,2
430170,"2015",1,0,0,1
430170,"2016",1,0,0,1
430170,"2017",1,0,2,3
430170,"2019",0,1,0,1
430170,"2021",1,0,2,3
430170,"2022",0,0,1,1
430170,"2023",0,0,1,1
430175,"2015",0,1,0,1
430175,"2016",1,0,0,1
430175,"2019",0,0,1,1
430175,"2020",1,1,1,3
430175,"2021",1,1,1,3
430175,"2022",2,0,0,2
430175,"2023",2,0,1,3
430180,"2017",1,0,1,2
430180,"2019",0,0,1,1
430180,"2020",1,0,0,1
430180,"2021",1,0,0,1
430180,"2022",2,0,0,2
430180,"2023",1,0,1,2
430185,"2017",1,0,0,1
430185,"2018",1,0,1,2
430185,"2020",1,0,1,2
430185,"2021",0,0,1,1
430185,"2022",0,0,1,1
430185,"2023",1,0,1,2
430187,"2015",0,1,0,1
430187,"2019",0,0,1,1
430187,"2022",0,1,1,2
430187,"2023",0,0,2,2
430190,"2015",1,0,0,1
430190,"2016",1,0,3,4
430190,"2017",0,0,4,4
430190,"2018",0,0,4,4
430190,"2019",1,0,3,4
430190,"2020",3,0,0,3
430190,"2021",2,1,2,5
430190,"2022",5,0,2,7
430190,"2023",1,0,1,2
430192,"2017",0,0,1,1
430200,"2016",0,2,2,4
430200,"2018",1,0,0,1
430200,"2019",1,0,0,1
430200,"2022",1,0,0,1
430205,"2015",2,1,4,7
430205,"2016",2,0,6,8
430205,"2017",1,0,1,2
430205,"2018",0,0,2,2
430205,"2019",0,0,1,1
430205,"2020",2,0,1,3
430205,"2021",1,0,1,2
430205,"2022",0,0,1,1
430210,"2015",27,7,31,65
430210,"2016",23,1,33,57
430210,"2017",14,4,24,42
430210,"2018",17,4,12,33
430210,"2019",14,1,7,22
430210,"2020",6,0,4,10
430210,"2021",12,0,11,23
430210,"2022",20,3,8,31
430210,"2023",10,1,10,21
430215,"2016",0,0,1,1
430215,"2019",0,0,1,1
430220,"2015",1,0,1,2
430220,"2016",0,0,1,1
430220,"2017",1,0,1,2
430220,"2018",2,1,1,4
430220,"2019",1,0,2,3
430220,"2020",2,0,3,5
430220,"2021",3,0,1,4
430220,"2022",3,0,1,4
430222,"2015",0,1,3,4
430222,"2016",0,0,1,1
430222,"2021",0,0,1,1
430223,"2015",0,0,1,1
430223,"2017",3,0,1,4
430223,"2018",1,0,0,1
430223,"2019",0,0,1,1
430223,"2020",2,0,0,2
430223,"2021",1,0,0,1
430225,"2015",1,0,0,1
430225,"2019",1,1,0,2
430225,"2020",1,0,0,1
430225,"2022",2,0,0,2
430225,"2023",1,1,0,2
430230,"2015",1,0,2,3
430230,"2016",1,0,2,3
430230,"2017",2,1,6,9
430230,"2018",0,1,4,5
430230,"2019",4,1,3,8
430230,"2020",2,0,6,8
430230,"2021",1,0,3,4
430230,"2022",6,0,3,9
430230,"2023",0,0,1,1
430235,"2015",1,1,2,4
430235,"2016",3,0,2,5
430235,"2017",3,0,3,6
430235,"2020",1,0,1,2
430235,"2021",0,4,1,5
430235,"2022",3,0,2,5
430235,"2023",2,0,2,4
430237,"2016",0,0,1,1
430237,"2017",1,0,0,1
430237,"2019",0,0,1,1
430237,"2020",1,2,0,3
430237,"2021",2,0,0,2
430237,"2022",0,0,2,2
430240,"2015",2,1,0,3
430240,"2016",2,4,3,9
430240,"2017",0,0,1,1
430240,"2018",2,1,2,5
430240,"2019",4,1,3,8
430240,"2020",2,0,3,5
430240,"2021",0,4,5,9
430240,"2022",2,1,0,3
430240,"2023",1,0,2,3
430245,"2019",0,2,0,2
430245,"2022",1,0,1,2
430258,"2017",1,0,0,1
430258,"2018",2,0,0,2
430258,"2021",0,1,0,1
430258,"2022",0,1,0,1
430258,"2023",0,1,0,1
430260,"2021",1,0,0,1
430260,"2022",0,0,4,4
430265,"2016",2,0,2,4
430265,"2017",0,1,0,1
430265,"2018",1,0,1,2
430265,"2019",0,0,1,1
430265,"2021",0,0,1,1
430265,"2022",4,0,1,5
430265,"2023",2,0,0,2
430270,"2015",2,0,5,7
430270,"2016",3,1,3,7
430270,"2017",0,0,2,2
430270,"2018",1,1,2,4
430270,"2019",2,0,3,5
430270,"2020",1,0,3,4
430270,"2021",7,0,2,9
430270,"2022",7,1,0,8
430270,"2023",1,1,1,3
430280,"2015",7,0,11,18
430280,"2016",12,5,10,27
430280,"2017",12,2,11,25
430280,"2018",13,4,8,25
430280,"2019",10,2,9,21
430280,"2020",11,2,13,26
430280,"2021",8,1,8,17
430280,"2022",8,6,11,25
430280,"2023",6,3,9,18
430290,"2016",1,0,0,1
430290,"2017",1,0,0,1
430290,"2018",1,0,2,3
430290,"2019",4,1,0,5
430290,"2020",0,0,2,2
430300,"2015",17,5,13,35
430300,"2016",17,11,14,42
430300,"2017",16,5,20,41
430300,"2018",14,3,12,29
430300,"2019",9,3,10,22
430300,"2020",5,3,14,22
430300,"2021",14,5,8,27
430300,"2022",4,4,13,21
430300,"2023",4,0,8,12
430310,"2015",13,1,13,27
430310,"2016",10,1,9,20
430310,"2017",4,1,7,12
430310,"2018",5,1,13,19
430310,"2019",5,2,11,18
430310,"2020",10,5,12,27
430310,"2021",8,1,12,21
430310,"2022",9,2,11,22
430310,"2023",4,0,8,12
430320,"2015",0,0,1,1
430320,"2016",0,0,1,1
430320,"2019",1,0,1,2
430320,"2022",0,0,1,1
430320,"2023",0,1,0,1
430330,"2020",0,0,1,1
430330,"2021",1,0,1,2
430340,"2021",0,0,2,2
430340,"2022",0,0,1,1
430340,"2023",1,0,2,3
430350,"2015",14,2,16,32
430350,"2016",8,3,5,16
430350,"2017",9,2,8,19
430350,"2018",13,5,13,31
430350,"2019",11,3,8,22
430350,"2020",7,1,4,12
430350,"2021",4,0,3,7
430350,"2022",9,0,6,15
430350,"2023",1,3,4,8
430360,"2016",1,1,1,3
430360,"2017",0,0,1,1
430360,"2018",1,0,1,2
430360,"2019",1,0,0,1
430360,"2020",1,0,1,2
430360,"2022",1,0,2,3
430360,"2023",0,1,0,1
430367,"2015",0,1,0,1
430367,"2016",0,0,1,1
430367,"2018",0,0,2,2
430367,"2019",0,0,1,1
430367,"2021",0,0,1,1
430370,"2018",1,0,1,2
430370,"2020",0,0,2,2
430370,"2023",0,0,1,1
430380,"2017",0,0,1,1
430380,"2018",1,0,0,1
430380,"2019",0,0,1,1
430380,"2022",0,0,1,1
430380,"2023",0,0,1,1
430390,"2015",6,3,10,19
430390,"2016",14,0,13,27
430390,"2017",15,4,12,31
430390,"2018",3,5,14,22
430390,"2019",11,2,10,23
430390,"2020",7,6,16,29
430390,"2021",5,2,5,12
430390,"2022",7,0,14,21
430390,"2023",4,5,2,11
430400,"2017",0,0,1,1
430400,"2020",0,0,1,1
430400,"2021",1,0,0,1
430400,"2022",0,0,1,1
430410,"2015",0,1,0,1
430410,"2017",0,0,1,1
430410,"2020",0,1,1,2
430420,"2015",1,0,1,2
430420,"2016",1,0,3,4
430420,"2017",0,3,5,8
430420,"2018",1,0,1,2
430420,"2019",1,0,1,2
430420,"2020",2,2,2,6
430420,"2021",0,0,2,2
430420,"2022",1,1,0,2
430420,"2023",0,2,2,4
430430,"2016",1,0,0,1
430430,"2017",1,0,0,1
430430,"2021",0,1,0,1
430435,"2015",1,1,5,7
430435,"2016",1,4,0,5
430435,"2017",3,0,3,6
430435,"2018",3,0,3,6
430435,"2019",1,1,9,11
430435,"2020",0,1,5,6
430435,"2021",1,0,2,3
430435,"2022",2,0,0,2
430435,"2023",2,0,2,4
430440,"2015",11,1,17,29
430440,"2016",14,3,20,37
430440,"2017",14,4,25,43
430440,"2018",13,2,16,31
430440,"2019",7,3,16,26
430440,"2020",5,3,5,13
430440,"2021",3,3,5,11
430440,"2022",6,2,9,17
430440,"2023",4,2,8,14
430450,"2015",0,1,0,1
430450,"2017",0,1,2,3
430450,"2019",0,0,1,1
430450,"2021",2,0,0,2
430450,"2022",4,1,0,5
430450,"2023",0,1,2,3
430460,"2015",111,32,171,314
430460,"2016",87,23,148,258
430460,"2017",96,21,120,237
430460,"2018",88,20,126,234
430460,"2019",81,23,111,215
430460,"2020",64,25,98,187
430460,"2021",83,22,87,192
430460,"2022",62,16,104,182
430460,"2023",50,16,63,129
430461,"2015",0,0,1,1
430461,"2016",1,0,1,2
430461,"2020",0,1,0,1
430462,"2015",0,0,2,2
430462,"2017",1,0,0,1
430462,"2021",0,1,1,2
430463,"2015",11,1,21,33
430463,"2016",11,2,15,28
430463,"2017",5,3,14,22
430463,"2018",10,4,13,27
430463,"2019",11,4,19,34
430463,"2020",5,1,5,11
430463,"2021",9,3,6,18
430463,"2022",11,2,10,23
430463,"2023",4,2,8,14
430465,"2015",1,0,0,1
430465,"2017",1,1,1,3
430465,"2019",0,0,1,1
430465,"2021",2,0,1,3
430465,"2022",1,0,0,1
430465,"2023",1,0,0,1
430466,"2015",3,0,10,13
430466,"2016",10,0,8,18
430466,"2017",10,2,13,25
430466,"2018",2,1,5,8
430466,"2019",2,2,6,10
430466,"2020",5,1,5,11
430466,"2021",5,2,4,11
430466,"2022",3,1,5,9
430466,"2023",0,1,5,6
430467,"2015",0,0,1,1
430467,"2022",1,0,1,2
430467,"2023",0,0,1,1
430468,"2015",3,2,2,7
430468,"2016",2,0,1,3
430468,"2017",5,3,8,16
430468,"2018",4,2,2,8
430468,"2019",1,1,2,4
430468,"2020",3,1,6,10
430468,"2021",0,0,4,4
430468,"2022",2,1,1,4
430468,"2023",0,0,4,4
430469,"2015",2,0,0,2
430469,"2016",2,1,0,3
430469,"2017",2,1,0,3
430469,"2018",0,1,0,1
430470,"2015",11,0,17,28
430470,"2016",5,4,14,23
430470,"2017",9,4,13,26
430470,"2018",14,5,10,29
430470,"2019",12,4,12,28
430470,"2020",6,0,6,12
430470,"2021",8,2,9,19
430470,"2022",7,2,10,19
430470,"2023",6,0,2,8
430471,"2015",2,0,0,2
430471,"2016",2,0,0,2
430471,"2021",0,0,1,1
430480,"2015",3,1,7,11
430480,"2016",4,1,10,15
430480,"2017",5,2,3,10
430480,"2018",5,1,1,7
430480,"2019",3,0,0,3
430480,"2020",2,0,2,4
430480,"2021",1,0,0,1
430480,"2022",1,2,0,3
430480,"2023",1,1,1,3
430485,"2021",0,0,1,1
430490,"2015",1,0,0,1
430490,"2020",1,0,0,1
430490,"2021",0,1,0,1
430490,"2022",0,0,1,1
430495,"2017",1,0,0,1
430495,"2018",1,0,1,2
430495,"2021",0,0,1,1
430495,"2022",2,1,1,4
430495,"2023",0,0,3,3
430500,"2015",0,0,1,1
430500,"2016",1,0,0,1
430500,"2017",0,1,3,4
430500,"2018",0,0,1,1
430500,"2020",0,0,1,1
430500,"2021",1,0,1,2
430500,"2022",0,0,2,2
430500,"2023",1,0,1,2
430510,"2015",33,12,80,125
430510,"2016",47,11,63,121
430510,"2017",41,17,86,144
430510,"2018",52,25,98,175
430510,"2019",62,22,76,160
430510,"2020",61,16,83,160
430510,"2021",42,19,67,128
430510,"2022",47,9,74,130
430510,"2023",38,18,51,107
430511,"2015",0,1,0,1
430511,"2016",0,1,0,1
430511,"2020",0,0,1,1
430511,"2023",1,0,0,1
430512,"2015",0,1,0,1
430512,"2016",1,0,1,2
430512,"2017",1,0,1,2
430512,"2018",2,0,2,4
430512,"2019",1,0,1,2
430512,"2020",1,1,0,2
430512,"2022",1,0,2,3
430513,"2015",1,0,0,1
430513,"2016",1,0,1,2
430513,"2017",4,1,0,5
430513,"2018",1,0,0,1
430513,"2019",0,0,1,1
430513,"2020",1,0,0,1
430513,"2021",1,0,0,1
430515,"2015",2,0,1,3
430515,"2016",1,1,0,2
430515,"2019",0,0,1,1
430515,"2023",0,0,1,1
430517,"2015",2,1,1,4
430517,"2016",1,0,1,2
430517,"2018",2,0,1,3
430517,"2019",1,0,2,3
430517,"2020",1,0,3,4
430517,"2021",1,1,2,4
430517,"2022",1,0,0,1
430517,"2023",1,0,3,4
430520,"2017",0,0,1,1
430520,"2019",0,1,3,4
430520,"2020",1,1,0,2
430520,"2022",1,0,1,2
430530,"2016",1,0,1,2
430530,"2018",2,0,0,2
430530,"2019",1,1,0,2
430530,"2021",1,0,1,2
430530,"2022",0,0,1,1
430535,"2015",5,1,3,9
430535,"2016",3,2,3,8
430535,"2017",3,0,1,4
430535,"2018",2,1,3,6
430535,"2019",8,3,7,18
430535,"2020",5,3,8,16
430535,"2021",5,3,8,16
430535,"2022",5,0,6,11
430535,"2023",1,1,0,2
430537,"2016",1,0,0,1
430537,"2019",0,1,1,2
430537,"2021",0,0,1,1
430537,"2022",0,0,1,1
430537,"2023",0,0,1,1
430540,"2020",1,0,0,1
430540,"2023",0,0,1,1
430543,"2015",0,0,1,1
430543,"2016",2,0,0,2
430543,"2017",1,0,1,2
430543,"2018",0,0,1,1
430543,"2019",1,1,0,2
430544,"2017",1,0,1,2
430544,"2018",2,1,0,3
430544,"2019",2,2,2,6
430544,"2020",0,1,0,1
430545,"2015",0,0,1,1
430545,"2016",7,0,2,9
430545,"2017",3,1,9,13
430545,"2018",3,3,3,9
430545,"2019",3,0,3,6
430545,"2020",5,1,2,8
430545,"2021",1,2,3,6
430545,"2022",1,0,3,4
430545,"2023",2,0,2,4
430550,"2017",0,0,1,1
430550,"2018",0,2,0,2
430550,"2021",0,0,1,1
430558,"2015",1,1,2,4
430558,"2016",0,0,1,1
430558,"2017",1,0,0,1
430558,"2018",0,1,0,1
430558,"2019",1,0,2,3
430558,"2020",1,0,1,2
430558,"2021",1,0,1,2
430558,"2022",2,0,1,3
430558,"2023",0,1,0,1
430560,"2016",0,0,1,1
430560,"2021",0,0,1,1
430560,"2022",1,0,1,2
430570,"2015",4,0,1,5
430570,"2016",2,0,4,6
430570,"2017",0,0,1,1
430570,"2018",0,1,0,1
430570,"2020",0,0,1,1
430570,"2021",0,1,0,1
430570,"2022",0,0,2,2
430570,"2023",1,0,0,1
430580,"2016",0,0,2,2
430580,"2020",1,0,0,1
430580,"2021",0,0,1,1
430580,"2022",1,0,0,1
430580,"2023",0,0,2,2
430583,"2020",1,0,0,1
430583,"2021",1,0,1,2
430583,"2022",1,0,0,1
430585,"2016",1,0,0,1
430585,"2017",1,0,1,2
430585,"2019",0,0,1,1
430587,"2016",0,1,0,1
430587,"2021",2,0,0,2
430587,"2023",1,0,0,1
430590,"2016",0,1,0,1
430590,"2017",0,0,1,1
430590,"2018",0,0,1,1
430590,"2019",0,0,1,1
430590,"2022",4,1,0,5
430590,"2023",2,1,3,6
430593,"2019",1,0,0,1
430595,"2016",0,0,1,1
430595,"2018",1,0,0,1
430595,"2019",0,1,0,1
430595,"2022",1,0,1,2
430597,"2017",0,0,1,1
430597,"2018",1,0,3,4
430597,"2019",1,0,0,1
430597,"2020",1,0,1,2
430597,"2022",1,1,0,2
430597,"2023",0,0,2,2
430600,"2016",4,2,2,8
430600,"2017",0,1,0,1
430600,"2018",0,0,2,2
430600,"2020",0,1,0,1
430600,"2021",0,0,1,1
430605,"2015",1,0,1,2
430605,"2016",0,1,1,2
430605,"2019",1,0,0,1
430605,"2020",1,0,1,2
430607,"2015",0,1,0,1
430607,"2016",1,0,0,1
430607,"2017",2,0,0,2
430607,"2018",2,0,0,2
430607,"2021",0,0,1,1
430607,"2023",1,0,1,2
430610,"2015",4,2,16,22
430610,"2016",6,2,11,19
430610,"2017",8,1,18,27
430610,"2018",5,2,7,14
430610,"2019",10,1,11,22
430610,"2020",6,4,8,18
430610,"2021",6,3,6,15
430610,"2022",3,2,12,17
430610,"2023",5,2,1,8
430613,"2018",0,0,1,1
430613,"2022",0,1,0,1
430613,"2023",1,0,0,1
430620,"2017",0,0,1,1
430620,"2018",1,0,3,4
430620,"2019",2,1,2,5
430620,"2020",2,2,3,7
430620,"2021",5,0,1,6
430620,"2022",2,0,0,2
430620,"2023",2,0,2,4
430630,"2020",0,0,1,1
430632,"2016",0,1,0,1
430632,"2019",0,0,1,1
430632,"2021",0,0,1,1
430632,"2022",1,0,0,1
430637,"2016",2,0,1,3
430637,"2018",0,0,1,1
430637,"2019",1,0,0,1
430637,"2022",0,0,1,1
430637,"2023",1,1,1,3
430640,"2015",5,4,10,19
430640,"2016",8,3,7,18
430640,"2017",6,2,4,12
430640,"2018",7,2,8,17
430640,"2019",12,3,13,28
430640,"2020",5,2,14,21
430640,"2021",7,1,4,12
430640,"2022",5,1,5,11
430640,"2023",1,0,2,3
430642,"2015",0,0,3,3
430642,"2019",0,0,1,1
430642,"2021",1,2,0,3
430642,"2023",1,0,1,2
430645,"2017",1,0,1,2
430645,"2020",2,0,0,2
430645,"2021",1,0,0,1
430645,"2022",2,0,0,2
430645,"2023",0,0,1,1
430650,"2015",3,0,1,4
430650,"2016",1,2,2,5
430650,"2017",5,1,0,6
430650,"2018",1,1,4,6
430650,"2019",4,0,1,5
430650,"2020",0,1,0,1
430650,"2021",0,0,1,1
430650,"2022",0,0,2,2
430655,"2022",0,0,1,1
430660,"2015",6,2,6,14
430660,"2016",6,5,8,19
430660,"2017",3,1,12,16
430660,"2018",5,4,8,17
430660,"2019",7,5,6,18
430660,"2020",2,1,6,9
430660,"2021",6,1,9,16
430660,"2022",2,2,3,7
430660,"2023",2,0,3,5
430670,"2015",0,0,2,2
430670,"2016",1,0,2,3
430670,"2021",0,0,1,1
430670,"2022",0,0,2,2
430673,"2016",0,0,1,1
430673,"2017",2,1,2,5
430673,"2018",1,0,0,1
430673,"2019",1,0,2,3
430673,"2021",1,0,0,1
430673,"2022",1,0,0,1
430673,"2023",0,0,1,1
430675,"2015",0,0,1,1
430675,"2016",0,0,1,1
430675,"2017",0,1,0,1
430675,"2018",1,0,0,1
430675,"2020",0,0,1,1
430675,"2021",0,0,1,1
430675,"2023",1,0,0,1
430676,"2015",7,1,7,15
430676,"2016",9,1,5,15
430676,"2017",5,0,3,8
430676,"2018",8,3,5,16
430676,"2019",15,3,18,36
430676,"2020",8,6,6,20
430676,"2021",4,5,10,19
430676,"2022",6,4,11,21
430676,"2023",4,1,7,12
430680,"2015",1,1,2,4
430680,"2016",1,1,1,3
430680,"2017",2,1,3,6
430680,"2018",1,3,9,13
430680,"2019",7,1,4,12
430680,"2020",3,1,4,8
430680,"2021",6,2,4,12
430680,"2022",2,4,7,13
430680,"2023",2,2,2,6
430690,"2015",1,0,1,2
430690,"2016",5,1,7,13
430690,"2017",3,1,5,9
430690,"2018",5,1,7,13
430690,"2019",2,0,1,3
430690,"2020",5,1,8,14
430690,"2021",0,2,8,10
430690,"2022",5,0,6,11
430690,"2023",5,3,5,13
430692,"2022",0,0,1,1
430693,"2019",1,2,0,3
430693,"2020",3,0,3,6
430693,"2021",2,0,0,2
430693,"2022",1,0,1,2
430695,"2017",1,0,1,2
430695,"2018",0,1,2,3
430695,"2019",2,0,1,3
430695,"2020",1,0,1,2
430695,"2021",1,0,1,2
430695,"2022",0,0,1,1
430697,"2016",2,0,0,2
430697,"2017",0,0,1,1
430697,"2020",0,0,1,1
430697,"2021",2,0,1,3
430697,"2022",1,1,1,3
430697,"2023",1,0,0,1
430700,"2015",1,0,0,1
430700,"2016",5,2,12,19
430700,"2017",22,4,13,39
430700,"2018",4,0,6,10
430700,"2019",2,3,4,9
430700,"2020",8,1,5,14
430700,"2021",17,5,16,38
430700,"2022",13,0,13,26
430700,"2023",17,4,9,30
430705,"2022",1,0,0,1
430705,"2023",1,0,0,1
430710,"2015",0,1,2,3
430710,"2017",1,0,4,5
430710,"2018",0,0,3,3
430710,"2019",1,0,3,4
430710,"2020",1,0,0,1
430710,"2021",0,1,1,2
430710,"2022",0,0,1,1
430710,"2023",1,0,0,1
430720,"2015",0,0,2,2
430720,"2017",0,0,1,1
430720,"2020",1,0,0,1
430720,"2021",1,0,2,3
430720,"2023",1,1,0,2
430730,"2015",2,0,2,4
430730,"2016",2,0,1,3
430730,"2017",0,0,2,2
430730,"2018",0,0,1,1
430730,"2020",0,0,2,2
430730,"2021",1,0,1,2
430730,"2023",1,0,1,2
430740,"2016",2,0,0,2
430740,"2017",1,0,4,5
430740,"2018",1,1,0,2
430740,"2019",0,1,2,3
430740,"2020",0,0,1,1
430740,"2021",0,1,0,1
430740,"2022",0,0,1,1
430740,"2023",0,0,1,1
430745,"2017",0,0,1,1
430745,"2018",0,1,0,1
430745,"2020",3,0,0,3
430745,"2022",0,0,4,4
430745,"2023",0,3,1,4
430750,"2015",0,0,3,3
430750,"2016",0,0,2,2
430750,"2017",1,0,2,3
430750,"2018",1,0,0,1
430750,"2019",1,0,2,3
430750,"2020",2,0,3,5
430750,"2021",0,0,2,2
430750,"2022",1,0,1,2
430750,"2023",0,0,1,1
430755,"2015",0,0,1,1
430755,"2018",2,0,3,5
430755,"2019",1,1,1,3
430755,"2020",1,0,1,2
430755,"2021",0,2,1,3
430755,"2022",1,0,0,1
430755,"2023",2,1,0,3
430760,"2015",20,4,26,50
430760,"2016",15,5,19,39
430760,"2017",20,4,13,37
430760,"2018",13,2,16,31
430760,"2019",9,0,12,21
430760,"2020",3,1,3,7
430760,"2021",6,2,12,20
430760,"2022",8,4,11,23
430760,"2023",3,3,5,11
430770,"2015",15,5,28,48
430770,"2016",9,3,23,35
430770,"2017",11,1,25,37
430770,"2018",11,4,25,40
430770,"2019",24,3,24,51
430770,"2020",21,9,18,48
430770,"2021",12,4,15,31
430770,"2022",11,5,17,33
430770,"2023",9,7,9,25
430780,"2015",14,1,15,30
430780,"2016",9,1,13,23
430780,"2017",13,4,11,28
430780,"2018",9,3,7,19
430780,"2019",3,3,9,15
430780,"2020",7,5,12,24
430780,"2021",9,3,11,23
430780,"2022",10,3,6,19
430780,"2023",3,2,7,12
430781,"2016",0,0,1,1
430781,"2021",0,0,1,1
430783,"2015",1,0,1,2
430783,"2018",0,0,1,1
430783,"2022",1,0,0,1
430783,"2023",1,0,0,1
430786,"2015",0,0,1,1
430786,"2018",2,0,0,2
430786,"2019",1,0,0,1
430786,"2022",0,1,1,2
430786,"2023",0,0,2,2
430790,"2015",1,0,4,5
430790,"2016",3,2,4,9
430790,"2017",10,3,7,20
430790,"2018",0,1,2,3
430790,"2019",4,0,3,7
430790,"2020",14,3,14,31
430790,"2021",12,2,16,30
430790,"2022",16,5,17,38
430790,"2023",4,2,15,21
430800,"2015",1,0,1,2
430800,"2016",3,0,0,3
430800,"2019",0,0,2,2
430800,"2020",0,0,2,2
430800,"2021",1,0,0,1
430805,"2015",2,0,0,2
430805,"2017",1,0,0,1
430805,"2018",1,0,0,1
430805,"2019",1,0,2,3
430805,"2020",0,1,0,1
430805,"2021",0,0,5,5
430805,"2022",0,0,2,2
430805,"2023",0,1,2,3
430807,"2015",1,0,4,5
430807,"2017",1,1,3,5
430807,"2018",0,0,3,3
430807,"2019",0,0,5,5
430807,"2020",0,1,0,1
430807,"2021",1,0,1,2
430807,"2022",0,1,0,1
430810,"2015",1,0,0,1
430810,"2017",1,0,0,1
430810,"2018",2,0,3,5
430810,"2019",1,1,2,4
430810,"2020",0,0,1,1
430810,"2021",1,0,1,2
430810,"2023",0,0,1,1
430820,"2015",0,0,1,1
430820,"2016",1,0,0,1
430820,"2017",2,0,3,5
430820,"2019",0,0,2,2
430820,"2022",1,0,2,3
430820,"2023",1,0,0,1
430825,"2015",2,0,0,2
430825,"2016",1,0,2,3
430825,"2017",1,0,0,1
430825,"2020",0,0,1,1
430825,"2022",0,0,1,1
430830,"2017",0,0,1,1
430830,"2020",1,0,0,1
430830,"2021",2,0,0,2
430830,"2022",0,0,1,1
430840,"2015",1,0,6,7
430840,"2018",0,0,1,1
430840,"2019",0,0,1,1
430840,"2022",0,0,1,1
430843,"2015",0,0,2,2
430843,"2020",1,0,1,2
430843,"2022",0,2,0,2
430843,"2023",1,0,0,1
430845,"2015",0,1,1,2
430845,"2017",1,0,0,1
430845,"2020",0,0,1,1
430845,"2021",1,0,0,1
430850,"2015",0,0,2,2
430850,"2016",1,0,3,4
430850,"2017",2,0,0,2
430850,"2018",3,0,3,6
430850,"2019",0,0,2,2
430850,"2020",2,0,1,3
430850,"2021",1,0,1,2
430850,"2022",2,0,2,4
430850,"2023",3,0,1,4
430860,"2015",3,1,6,10
430860,"2016",1,0,3,4
430860,"2017",4,1,4,9
430860,"2018",1,1,2,4
430860,"2019",10,2,4,16
430860,"2020",1,3,6,10
430860,"2021",1,1,5,7
430860,"2022",5,2,4,11
430860,"2023",2,2,1,5
430865,"2020",0,1,0,1
430865,"2022",1,0,1,2
430870,"2016",0,0,2,2
430870,"2017",2,0,1,3
430870,"2018",0,1,1,2
430870,"2019",1,0,0,1
430870,"2022",0,0,1,1
430880,"2015",0,0,3,3
430880,"2016",2,0,0,2
430880,"2018",1,1,0,2
430880,"2019",1,0,1,2
430880,"2020",0,0,1,1
430880,"2021",2,0,1,3
430880,"2022",1,0,1,2
430880,"2023",1,0,1,2
430890,"2015",1,2,4,7
430890,"2016",4,0,7,11
430890,"2017",1,0,2,3
430890,"2018",1,1,5,7
430890,"2019",4,0,2,6
430890,"2020",4,0,2,6
430890,"2021",3,0,4,7
430890,"2022",5,2,5,12
430890,"2023",2,0,2,4
430900,"2018",0,1,1,2
430900,"2020",0,0,1,1
430900,"2021",2,2,5,9
430900,"2022",0,1,0,1
430900,"2023",1,0,0,1
430905,"2015",3,0,1,4
430905,"2016",0,1,3,4
430905,"2017",0,1,2,3
430905,"2018",2,0,2,4
430905,"2019",1,0,2,3
430905,"2020",0,0,1,1
430905,"2021",1,1,3,5
430905,"2023",0,0,2,2
430910,"2015",2,1,6,9
430910,"2016",6,5,4,15
430910,"2017",4,3,10,17
430910,"2018",5,1,2,8
430910,"2019",1,1,1,3
430910,"2020",2,0,1,3
430910,"2021",3,0,1,4
430910,"2022",2,1,2,5
430910,"2023",1,0,2,3
430912,"2015",2,0,0,2
430912,"2016",2,0,1,3
430912,"2017",1,0,1,2
430912,"2018",0,0,1,1
430912,"2019",2,0,0,2
430912,"2020",2,0,0,2
430912,"2022",1,0,2,3
430912,"2023",1,0,0,1
430915,"2016",0,0,1,1
430915,"2018",1,0,0,1
430915,"2021",0,0,1,1
430915,"2023",0,0,1,1
430920,"2015",35,3,39,77
430920,"2016",34,4,57,95
430920,"2017",24,5,24,53
430920,"2018",30,11,41,82
430920,"2019",42,6,30,78
430920,"2020",35,8,48,91
430920,"2021",38,14,36,88
430920,"2022",22,8,33,63
430920,"2023",19,5,22,46
430925,"2015",0,0,1,1
430925,"2021",0,0,1,1
430930,"2015",8,4,15,27
430930,"2016",17,3,19,39
430930,"2017",7,4,15,26
430930,"2018",9,4,17,30
430930,"2019",13,4,33,50
430930,"2020",16,3,28,47
430930,"2021",15,5,25,45
430930,"2022",16,6,15,37
430930,"2023",6,4,16,26
430940,"2015",4,2,4,10
430940,"2016",2,0,4,6
430940,"2017",3,2,2,7
430940,"2018",1,0,5,6
430940,"2019",2,0,2,4
430940,"2020",3,1,2,6
430940,"2021",0,0,3,3
430940,"2022",2,1,3,6
430940,"2023",1,0,8,9
430950,"2019",0,0,1,1
430950,"2021",0,0,1,1
430950,"2022",2,0,0,2
430955,"2015",0,1,0,1
430955,"2017",0,1,0,1
430955,"2018",1,0,0,1
430955,"2022",1,1,2,4
430957,"2016",1,0,0,1
430960,"2017",0,1,2,3
430960,"2018",1,0,2,3
430960,"2019",2,0,0,2
430960,"2020",0,0,2,2
430960,"2021",1,0,0,1
430960,"2022",1,0,2,3
430965,"2015",7,0,3,10
430965,"2016",0,0,4,4
430965,"2017",2,0,5,7
430965,"2018",2,2,3,7
430965,"2019",3,0,4,7
430965,"2020",0,1,3,4
430965,"2021",0,0,1,1
430965,"2022",0,0,2,2
430965,"2023",0,0,2,2
430970,"2016",1,0,0,1
430970,"2021",2,0,0,2
430970,"2022",1,0,0,1
430970,"2023",0,0,1,1
430975,"2017",0,0,1,1
430980,"2015",0,0,1,1
430980,"2018",2,0,0,2
430980,"2023",0,0,1,1
430990,"2015",3,1,2,6
430990,"2016",0,1,2,3
430990,"2018",0,0,1,1
430990,"2021",2,0,2,4
430990,"2022",3,0,2,5
430995,"2019",1,0,0,1
430995,"2020",0,1,0,1
430995,"2022",0,0,1,1
431000,"2020",1,0,0,1
431000,"2022",1,1,0,2
431000,"2023",0,0,2,2
431010,"2015",16,3,13,32
431010,"2016",4,5,16,25
431010,"2017",7,4,18,29
431010,"2018",11,4,13,28
431010,"2019",4,0,20,24
431010,"2020",8,4,12,24
431010,"2021",11,2,6,19
431010,"2022",8,2,10,20
431010,"2023",4,2,4,10
431020,"2015",2,1,7,10
431020,"2016",11,4,24,39
431020,"2017",12,6,15,33
431020,"2018",4,2,11,17
431020,"2019",11,3,9,23
431020,"2020",9,3,6,18
431020,"2021",12,6,17,35
431020,"2022",8,5,14,27
431020,"2023",7,7,11,25
431030,"2015",1,0,0,1
431030,"2020",0,0,1,1
431030,"2021",0,0,1,1
431033,"2015",6,0,6,12
431033,"2016",7,0,7,14
431033,"2017",6,2,7,15
431033,"2018",4,1,4,9
431033,"2019",2,0,5,7
431033,"2020",5,0,4,9
431033,"2021",3,2,3,8
431033,"2022",1,0,3,4
431033,"2023",3,0,3,6
431036,"2015",1,1,1,3
431036,"2016",0,1,0,1
431036,"2017",2,0,0,2
431036,"2018",1,1,1,3
431036,"2019",0,0,1,1
431036,"2020",0,1,1,2
431036,"2021",1,0,1,2
431036,"2023",1,1,0,2
431040,"2015",4,1,0,5
431040,"2018",1,0,2,3
431040,"2019",3,0,0,3
431040,"2020",1,0,3,4
431040,"2021",2,1,2,5
431040,"2022",0,0,2,2
431040,"2023",0,0,3,3
431041,"2017",1,0,0,1
431041,"2018",1,0,0,1
431041,"2020",1,0,1,2
431043,"2015",0,0,1,1
431043,"2016",1,0,1,2
431043,"2020",1,0,1,2
431043,"2021",1,0,0,1
431043,"2022",1,0,4,5
431043,"2023",2,0,1,3
431046,"2020",2,0,0,2
431050,"2018",1,0,0,1
431050,"2019",1,0,0,1
431050,"2021",0,0,1,1
431050,"2022",0,0,2,2
431050,"2023",2,1,4,7
431053,"2015",1,0,1,2
431053,"2017",0,2,1,3
431053,"2018",1,0,3,4
431053,"2019",1,0,0,1
431053,"2021",1,0,2,3
431055,"2015",1,0,0,1
431055,"2017",0,1,1,2
431055,"2018",0,0,2,2
431055,"2019",0,0,1,1
431055,"2022",1,0,1,2
431055,"2023",1,0,0,1
431057,"2016",2,0,0,2
431060,"2016",1,0,7,8
431060,"2017",6,3,7,16
431060,"2018",3,1,14,18
431060,"2019",10,2,13,25
431060,"2020",7,2,14,23
431060,"2021",10,3,12,25
431060,"2022",10,0,5,15
431060,"2023",5,1,6,12
431065,"2016",1,0,2,3
431065,"2018",0,0,1,1
431065,"2020",1,0,1,2
431070,"2016",1,0,0,1
431070,"2017",1,0,1,2
431070,"2020",0,0,1,1
431070,"2021",0,0,1,1
431075,"2016",0,0,1,1
431075,"2018",0,0,3,3
431075,"2021",0,1,1,2
431075,"2022",1,0,0,1
431080,"2015",2,0,0,2
431080,"2016",3,1,8,12
431080,"2017",5,0,3,8
431080,"2018",4,1,0,5
431080,"2019",2,0,1,3
431080,"2020",1,2,1,4
431080,"2021",1,0,2,3
431080,"2022",3,2,1,6
431080,"2023",1,0,1,2
431085,"2016",1,0,0,1
431085,"2017",0,0,1,1
431085,"2019",0,0,1,1
431085,"2023",0,2,1,3
431087,"2015",0,0,1,1
431087,"2019",0,0,1,1
431087,"2021",1,0,0,1
431087,"2023",1,1,0,2
431090,"2015",0,0,1,1
431090,"2016",0,0,1,1
431090,"2017",1,0,1,2
431100,"2015",6,1,8,15
431100,"2016",10,2,11,23
431100,"2017",5,2,7,14
431100,"2018",4,3,11,18
431100,"2019",13,8,14,35
431100,"2020",8,4,17,29
431100,"2021",7,1,6,14
431100,"2022",10,0,11,21
431100,"2023",5,3,12,20
431110,"2018",1,0,1,2
431110,"2019",0,0,1,1
431110,"2020",1,0,0,1
431110,"2021",1,0,0,1
431110,"2023",0,0,1,1
431112,"2016",0,0,3,3
431112,"2017",0,0,1,1
431112,"2018",1,0,2,3
431112,"2019",0,0,2,2
431112,"2020",1,0,4,5
431112,"2021",1,0,0,1
431112,"2022",1,1,1,3
431112,"2023",0,0,1,1
431113,"2015",0,0,1,1
431113,"2016",0,0,1,1
431113,"2018",1,0,0,1
431113,"2020",0,0,2,2
431113,"2022",1,0,0,1
431115,"2015",0,0,1,1
431115,"2016",0,0,1,1
431115,"2017",3,0,0,3
431115,"2020",1,0,0,1
431115,"2021",1,0,3,4
431115,"2022",0,0,1,1
431115,"2023",1,0,2,3
431120,"2015",3,2,1,6
431120,"2016",1,0,3,4
431120,"2017",0,1,1,2
431120,"2018",0,1,4,5
431120,"2019",0,0,2,2
431120,"2020",2,0,0,2
431120,"2021",1,1,0,2
431120,"2023",3,0,0,3
431123,"2015",1,0,0,1
431125,"2015",0,0,1,1
431125,"2016",0,1,0,1
431125,"2021",2,0,2,4
431125,"2022",1,0,1,2
431127,"2016",0,0,1,1
431130,"2015",10,1,8,19
431130,"2016",2,0,10,12
431130,"2017",1,1,0,2
431130,"2018",1,0,3,4
431130,"2019",0,1,2,3
431130,"2020",2,2,3,7
431130,"2021",5,1,14,20
431130,"2022",3,1,7,11
431130,"2023",3,0,3,6
431140,"2015",10,4,14,28
431140,"2016",11,3,15,29
431140,"2017",14,3,10,27
431140,"2018",20,4,13,37
431140,"2019",14,7,24,45
431140,"2020",16,4,22,42
431140,"2021",27,6,27,60
431140,"2022",26,4,24,54
431140,"2023",17,2,15,34
431142,"2016",0,0,1,1
431142,"2019",0,0,1,1
431150,"2015",1,0,2,3
431150,"2016",0,0,2,2
431150,"2017",1,1,2,4
431150,"2018",2,2,1,5
431150,"2019",1,0,2,3
431150,"2020",1,0,0,1
431150,"2021",1,0,1,2
431150,"2022",2,0,0,2
431150,"2023",0,0,1,1
431160,"2017",0,0,1,1
431160,"2018",0,1,0,1
431162,"2015",1,1,1,3
431162,"2016",3,1,1,5
431162,"2017",4,1,1,6
431162,"2018",2,1,2,5
431162,"2019",1,0,2,3
431162,"2020",0,0,1,1
431162,"2021",1,0,1,2
431162,"2022",0,0,3,3
431162,"2023",1,0,1,2
431164,"2021",1,0,0,1
431170,"2016",3,0,0,3
431170,"2017",0,0,1,1
431170,"2019",1,0,1,2
431170,"2020",0,0,1,1
431171,"2015",1,0,0,1
431171,"2016",1,0,0,1
431171,"2018",2,0,2,4
431171,"2019",0,0,2,2
431171,"2021",0,0,4,4
431171,"2022",1,2,3,6
431171,"2023",2,0,0,2
431173,"2016",1,0,0,1
431173,"2017",0,0,2,2
431173,"2019",2,1,0,3
431173,"2020",1,0,0,1
431173,"2021",0,0,2,2
431173,"2023",0,1,0,1
431177,"2015",1,0,1,2
431177,"2016",1,0,0,1
431177,"2017",1,0,0,1
431177,"2018",2,0,1,3
431177,"2019",1,0,1,2
431177,"2020",2,1,0,3
431179,"2016",1,0,0,1
431179,"2017",1,0,0,1
431179,"2018",0,1,0,1
431179,"2019",0,0,2,2
431179,"2022",1,0,0,1
431180,"2015",15,6,13,34
431180,"2016",10,3,17,30
431180,"2017",14,4,27,45
431180,"2018",17,3,24,44
431180,"2019",3,6,15,24
431180,"2020",13,6,23,42
431180,"2021",11,7,13,31
431180,"2022",15,5,19,39
431180,"2023",9,2,9,20
431190,"2015",0,0,1,1
431190,"2016",0,0,1,1
431190,"2017",0,0,1,1
431190,"2021",1,0,1,2
431190,"2022",0,1,0,1
431198,"2017",2,0,0,2
431198,"2020",2,0,0,2
431198,"2021",0,0,1,1
431198,"2022",0,0,1,1
431198,"2023",2,0,0,2
431200,"2016",1,0,1,2
431200,"2019",0,1,0,1
431205,"2018",1,0,0,1
431205,"2019",0,0,1,1
431205,"2020",2,0,1,3
431205,"2021",1,0,0,1
431205,"2022",0,1,0,1
431210,"2015",1,0,0,1
431210,"2016",0,0,1,1
431210,"2017",0,0,2,2
431210,"2022",0,0,1,1
431210,"2023",1,0,0,1
431213,"2017",1,0,0,1
431213,"2018",0,0,1,1
431213,"2019",0,1,0,1
431213,"2020",2,0,0,2
431213,"2021",1,0,0,1
431213,"2023",0,0,1,1
431215,"2018",0,0,1,1
431215,"2019",0,1,0,1
431215,"2021",1,0,0,1
431215,"2022",1,0,0,1
431217,"2021",0,0,1,1
431220,"2019",0,0,1,1
431225,"2015",1,0,0,1
431225,"2017",1,0,0,1
431225,"2018",2,1,1,4
431225,"2019",2,1,1,4
431225,"2020",0,1,3,4
431225,"2021",2,1,4,7
431225,"2022",3,0,3,6
431230,"2015",1,0,0,1
431230,"2019",1,0,0,1
431230,"2020",0,1,2,3
431230,"2021",1,0,0,1
431230,"2022",0,0,2,2
431230,"2023",0,1,0,1
431235,"2016",1,0,0,1
431235,"2017",1,0,0,1
431237,"2015",1,0,1,2
431237,"2016",1,0,0,1
431237,"2017",1,0,1,2
431237,"2018",2,0,0,2
431237,"2019",0,1,1,2
431237,"2020",0,1,0,1
431237,"2021",1,0,0,1
431238,"2015",0,0,1,1
431238,"2018",0,0,1,1
431240,"2015",9,1,12,22
431240,"2016",15,1,24,40
431240,"2017",10,5,22,37
431240,"2018",8,4,19,31
431240,"2019",7,3,14,24
431240,"2020",5,8,18,31
431240,"2021",7,4,13,24
431240,"2022",11,1,9,21
431240,"2023",6,3,6,15
431242,"2020",1,0,0,1
431244,"2015",1,0,0,1
431244,"2017",1,0,0,1
431244,"2018",0,1,0,1
431244,"2020",0,0,1,1
431245,"2015",0,0,1,1
431245,"2017",1,0,0,1
431245,"2019",0,0,1,1
431245,"2020",1,0,0,1
431245,"2021",0,0,1,1
431245,"2022",1,0,1,2
431247,"2015",1,0,3,4
431247,"2016",1,0,2,3
431247,"2018",2,0,0,2
431247,"2020",0,0,1,1
431247,"2023",0,1,0,1
431250,"2015",0,0,1,1
431250,"2016",0,0,1,1
431250,"2017",0,1,0,1
431250,"2018",0,0,1,1
431250,"2019",0,0,1,1
431250,"2020",1,2,1,4
431250,"2021",0,0,1,1
431250,"2023",0,0,2,2
431260,"2015",2,0,0,2
431260,"2018",1,0,0,1
431260,"2019",1,0,1,2
431260,"2020",2,1,0,3
431260,"2021",2,0,0,2
431260,"2022",2,0,0,2
431261,"2015",0,3,1,4
431261,"2016",1,0,0,1
431261,"2017",2,0,0,2
431261,"2019",0,0,1,1
431261,"2020",0,0,1,1
431262,"2017",1,0,0,1
431262,"2023",0,0,1,1
431265,"2015",0,2,1,3
431265,"2016",2,1,6,9
431265,"2017",5,1,2,8
431265,"2018",5,1,2,8
431265,"2019",4,3,5,12
431265,"2020",4,0,7,11
431265,"2021",4,3,1,8
431265,"2022",5,1,1,7
431265,"2023",2,0,3,5
431267,"2017",1,0,0,1
431267,"2019",0,0,1,1
431267,"2022",0,1,0,1
431267,"2023",0,1,0,1
431270,"2015",0,0,2,2
431270,"2016",1,0,3,4
431270,"2017",0,0,2,2
431270,"2018",0,0,1,1
431270,"2019",0,0,3,3
431270,"2020",1,0,3,4
431270,"2021",1,0,5,6
431270,"2022",0,0,2,2
431270,"2023",2,0,4,6
431275,"2020",1,0,2,3
431280,"2015",0,0,2,2
431280,"2016",0,0,2,2
431280,"2017",1,0,1,2
431280,"2018",2,0,3,5
431280,"2019",0,0,3,3
431280,"2020",1,2,2,5
431280,"2021",2,1,1,4
431280,"2022",1,0,3,4
431280,"2023",1,2,1,4
431290,"2015",0,1,1,2
431290,"2018",0,0,1,1
431290,"2019",0,0,1,1
431290,"2020",0,1,2,3
431290,"2021",1,0,1,2
431290,"2022",3,0,1,4
431300,"2017",1,0,0,1
431300,"2018",2,0,0,2
431300,"2023",1,0,0,1
431301,"2015",1,0,0,1
431301,"2017",1,0,0,1
431301,"2018",1,0,0,1
431301,"2020",1,0,1,2
431301,"2021",2,1,1,4
431301,"2022",0,0,1,1
431301,"2023",0,0,1,1
431303,"2015",1,1,2,4
431303,"2016",0,0,1,1
431303,"2018",0,0,1,1
431303,"2019",4,0,0,4
431303,"2021",1,0,0,1
431303,"2023",0,1,0,1
431306,"2015",5,0,4,9
431306,"2016",5,0,7,12
431306,"2017",4,1,10,15
431306,"2018",6,0,8,14
431306,"2019",8,4,10,22
431306,"2020",7,1,7,15
431306,"2021",10,1,10,21
431306,"2022",2,3,7,12
431306,"2023",2,1,8,11
431308,"2019",0,0,1,1
431308,"2021",1,0,0,1
431308,"2023",1,1,0,2
431310,"2016",0,0,2,2
431310,"2017",0,0,1,1
431310,"2019",1,0,0,1
431310,"2020",1,0,0,1
431310,"2023",1,0,1,2
431320,"2015",1,1,1,3
431320,"2016",4,1,0,5
431320,"2017",7,3,6,16
431320,"2018",7,0,5,12
431320,"2020",2,0,0,2
431320,"2021",1,0,1,2
431320,"2022",1,0,0,1
431330,"2015",2,3,9,14
431330,"2016",2,3,4,9
431330,"2017",4,3,5,12
431330,"2018",4,0,4,8
431330,"2019",1,0,4,5
431330,"2020",6,1,9,16
431330,"2021",1,3,6,10
431330,"2022",5,0,6,11
431330,"2023",6,2,5,13
431335,"2020",1,0,1,2
431335,"2022",0,1,1,2
431337,"2015",4,3,11,18
431337,"2016",9,3,12,24
431337,"2017",8,1,6,15
431337,"2018",4,1,7,12
431337,"2019",4,2,9,15
431337,"2020",3,1,6,10
431337,"2021",4,2,4,10
431337,"2022",6,0,6,12
431337,"2023",2,0,5,7
431339,"2015",0,0,2,2
431339,"2016",0,0,2,2
431339,"2017",2,0,2,4
431339,"2018",1,0,1,2
431339,"2020",1,0,0,1
431339,"2022",1,0,0,1
431340,"2015",62,20,93,175
431340,"2016",70,16,74,160
431340,"2017",60,19,96,175
431340,"2018",70,21,75,166
431340,"2019",44,11,52,107
431340,"2020",17,8,39,64
431340,"2021",32,15,26,73
431340,"2022",26,5,36,67
431340,"2023",28,12,37,77
431342,"2019",1,0,0,1
431342,"2021",0,0,1,1
431342,"2022",0,0,1,1
431344,"2015",0,0,1,1
431344,"2017",1,0,0,1
431344,"2018",2,0,0,2
431344,"2020",0,0,1,1
431349,"2015",0,0,1,1
431349,"2018",0,0,1,1
431349,"2019",1,0,0,1
431349,"2020",0,0,1,1
431350,"2015",5,3,8,16
431350,"2016",1,2,5,8
431350,"2017",3,0,3,6
431350,"2018",2,0,2,4
431350,"2019",1,1,2,4
431350,"2020",3,1,3,7
431350,"2021",4,0,5,9
431350,"2022",2,0,3,5
431350,"2023",0,0,1,1
431360,"2020",1,0,1,2
431365,"2015",2,0,2,4
431365,"2016",0,0,1,1
431365,"2017",0,0,1,1
431365,"2018",0,2,1,3
431365,"2019",0,1,0,1
431365,"2020",0,0,1,1
431365,"2022",0,0,2,2
431365,"2023",1,0,0,1
431370,"2015",5,0,3,8
431370,"2016",1,0,3,4
431370,"2017",0,1,1,2
431370,"2018",4,3,1,8
431370,"2019",8,3,9,20
431370,"2020",0,0,3,3
431370,"2022",0,1,0,1
431370,"2023",1,0,5,6
431380,"2016",0,0,1,1
431380,"2019",0,0,1,1
431380,"2020",0,1,0,1
431380,"2021",2,0,2,4
431380,"2022",1,1,1,3
431380,"2023",1,0,2,3
431390,"2015",3,3,6,12
431390,"2016",5,0,7,12
431390,"2017",4,1,12,17
431390,"2018",4,0,8,12
431390,"2019",5,0,6,11
431390,"2020",11,1,4,16
431390,"2021",6,5,14,25
431390,"2022",3,0,4,7
431390,"2023",0,2,3,5
431395,"2015",2,0,2,4
431395,"2016",1,0,1,2
431395,"2017",0,0,1,1
431395,"2019",1,0,1,2
431395,"2020",3,0,1,4
431395,"2022",4,1,3,8
431395,"2023",1,1,0,2
431400,"2015",0,1,0,1
431400,"2017",0,0,1,1
431400,"2019",0,0,1,1
431400,"2020",2,0,0,2
431400,"2021",0,0,1,1
431400,"2022",0,0,1,1
431402,"2015",0,0,3,3
431402,"2016",1,0,1,2
431402,"2017",1,0,0,1
431402,"2018",0,0,2,2
431402,"2019",2,0,0,2
431402,"2020",0,1,0,1
431402,"2022",1,0,0,1
431402,"2023",0,0,1,1
431403,"2015",0,0,1,1
431403,"2016",0,1,0,1
431403,"2017",0,0,3,3
431403,"2018",0,0,1,1
431403,"2019",1,0,1,2
431403,"2021",1,0,0,1
431403,"2023",1,0,0,1
431405,"2015",11,7,21,39
431405,"2016",22,2,16,40
431405,"2017",18,6,26,50
431405,"2018",16,4,26,46
431405,"2019",20,4,17,41
431405,"2020",10,3,21,34
431405,"2021",10,2,12,24
431405,"2022",10,2,26,38
431405,"2023",11,6,16,33
431406,"2015",1,0,1,2
431406,"2016",0,0,1,1
431407,"2022",0,0,1,1
431407,"2023",1,0,0,1
431410,"2015",9,1,22,32
431410,"2016",13,4,17,34
431410,"2017",24,14,29,67
431410,"2018",34,8,38,80
431410,"2019",35,10,43,88
431410,"2020",30,13,43,86
431410,"2021",34,7,32,73
431410,"2022",18,5,21,44
431410,"2023",22,9,29,60
431413,"2017",0,0,1,1
431413,"2021",0,1,0,1
431413,"2022",1,0,0,1
431415,"2015",2,1,5,8
431415,"2016",6,0,4,10
431415,"2017",1,0,7,8
431415,"2018",4,0,2,6
431415,"2019",3,0,4,7
431415,"2020",1,0,4,5
431415,"2021",4,1,1,6
431415,"2022",1,1,2,4
431415,"2023",0,0,1,1
431417,"2015",1,0,0,1
431417,"2016",1,0,2,3
431417,"2022",1,1,0,2
431417,"2023",0,1,0,1
431420,"2015",0,0,4,4
431420,"2016",0,0,5,5
431420,"2017",0,0,1,1
431420,"2018",2,0,2,4
431420,"2019",1,0,1,2
431420,"2020",0,1,0,1
431420,"2021",0,0,3,3
431420,"2022",1,0,3,4
431420,"2023",1,1,1,3
431430,"2015",1,0,0,1
431430,"2022",1,0,0,1
431430,"2023",1,0,0,1
431440,"2015",69,21,148,238
431440,"2016",86,14,131,231
431440,"2017",64,20,112,196
431440,"2018",56,20,97,173
431440,"2019",53,18,85,156
431440,"2020",43,13,75,131
431440,"2021",44,17,69,130
431440,"2022",46,10,37,93
431440,"2023",26,5,32,63
431442,"2016",1,0,1,2
431442,"2017",1,0,1,2
431442,"2019",0,0,1,1
431442,"2020",1,0,0,1
431442,"2021",0,0,1,1
431442,"2022",3,0,0,3
431445,"2015",0,0,1,1
431445,"2016",2,0,2,4
431445,"2019",0,0,1,1
431445,"2021",0,1,0,1
431445,"2023",0,0,1,1
431446,"2015",0,1,0,1
431446,"2016",0,0,1,1
431446,"2017",0,0,1,1
431446,"2018",1,0,1,2
431446,"2021",1,0,0,1
431447,"2018",0,0,1,1
431447,"2021",1,0,0,1
431449,"2015",0,0,1,1
431449,"2019",0,1,0,1
431449,"2021",0,1,0,1
431449,"2022",1,0,1,2
431450,"2015",1,1,3,5
431450,"2016",3,1,4,8
431450,"2017",3,0,5,8
431450,"2018",0,0,2,2
431450,"2019",4,1,2,7
431450,"2020",1,0,1,2
431450,"2021",1,0,2,3
431450,"2022",1,0,0,1
431450,"2023",2,1,0,3
431454,"2016",0,1,0,1
431460,"2015",0,1,5,6
431460,"2016",4,1,2,7
431460,"2017",0,1,3,4
431460,"2018",3,0,0,3
431460,"2019",2,1,0,3
431460,"2020",0,0,1,1
431460,"2021",0,0,3,3
431460,"2022",3,0,0,3
431470,"2017",0,0,1,1
431470,"2018",1,1,0,2
431470,"2019",0,0,2,2
431470,"2020",2,0,0,2
431470,"2021",2,0,0,2
431470,"2022",0,0,1,1
431475,"2015",1,1,2,4
431475,"2016",0,1,1,2
431475,"2017",4,0,1,5
431475,"2018",0,1,0,1
431475,"2019",2,0,1,3
431475,"2020",2,0,0,2
431475,"2022",1,0,0,1
431477,"2016",0,0,1,1
431477,"2018",0,0,1,1
431477,"2019",1,1,2,4
431477,"2020",0,0,1,1
431477,"2022",0,0,1,1
431478,"2016",0,0,1,1
431480,"2015",7,1,17,25
431480,"2016",5,1,7,13
431480,"2017",5,0,8,13
431480,"2018",5,1,9,15
431480,"2019",5,0,3,8
431480,"2020",4,2,4,10
431480,"2021",7,1,3,11
431480,"2022",6,1,10,17
431480,"2023",4,1,6,11
431490,"2015",286,68,432,786
431490,"2016",252,91,433,776
431490,"2017",250,82,378,710
431490,"2018",245,75,356,676
431490,"2019",312,100,430,842
431490,"2020",274,95,377,746
431490,"2021",269,80,351,700
431490,"2022",241,61,288,590
431490,"2023",136,55,227,418
431500,"2015",0,0,2,2
431510,"2015",0,0,1,1
431510,"2019",0,0,1,1
431510,"2020",3,0,2,5
431510,"2021",1,0,2,3
431513,"2019",0,0,1,1
431514,"2017",2,0,0,2
431514,"2020",1,0,0,1
431515,"2016",1,1,1,3
431515,"2019",0,2,0,2
431517,"2015",1,0,0,1
431517,"2022",0,1,0,1
431530,"2017",1,0,0,1
431530,"2018",1,0,0,1
431530,"2021",0,0,1,1
431530,"2023",0,1,0,1
431532,"2015",0,1,0,1
431532,"2018",0,0,1,1
431532,"2019",1,0,0,1
431535,"2023",1,0,0,1
431540,"2015",0,1,3,4
431540,"2016",1,1,4,6
431540,"2018",0,0,2,2
431540,"2019",0,0,5,5
431540,"2020",0,0,2,2
431540,"2021",1,0,7,8
431540,"2022",0,1,7,8
431540,"2023",0,0,5,5
431545,"2015",0,0,1,1
431545,"2021",0,0,2,2
431545,"2022",0,0,1,1
431550,"2015",1,1,2,4
431550,"2016",0,0,3,3
431550,"2018",3,0,0,3
431550,"2019",1,1,0,2
431550,"2020",0,0,1,1
431550,"2021",2,0,0,2
431555,"2015",0,1,1,2
431555,"2017",2,0,0,2
431555,"2018",1,1,0,2
431555,"2019",1,0,1,2
431555,"2021",1,1,1,3
431555,"2022",1,0,2,3
431560,"2015",23,5,32,60
431560,"2016",40,6,48,94
431560,"2017",41,14,79,134
431560,"2018",32,9,43,84
431560,"2019",23,6,41,70
431560,"2020",21,4,28,53
431560,"2021",44,11,45,100
431560,"2022",41,13,51,105
431560,"2023",37,12,38,87
431570,"2015",9,6,9,24
431570,"2016",2,1,9,12
431570,"2017",5,0,4,9
431570,"2018",1,1,11,13
431570,"2019",1,2,5,8
431570,"2020",2,2,5,9
431570,"2021",3,3,5,11
431570,"2022",3,1,5,9
431570,"2023",6,1,2,9
431575,"2016",1,0,2,3
431575,"2017",3,0,0,3
431575,"2018",2,0,0,2
431575,"2019",1,0,2,3
431575,"2020",0,0,2,2
431575,"2021",1,0,2,3
431575,"2022",0,0,2,2
431575,"2023",0,0,1,1
431580,"2015",0,0,2,2
431580,"2016",0,0,1,1
431580,"2017",1,0,2,3
431580,"2019",0,2,0,2
431580,"2020",0,0,1,1
431580,"2021",2,0,0,2
431580,"2022",0,1,2,3
431580,"2023",0,0,1,1
431590,"2015",0,0,2,2
431590,"2016",0,0,2,2
431590,"2017",0,1,0,1
431600,"2015",4,0,4,8
431600,"2016",2,1,3,6
431600,"2017",3,2,8,13
431600,"2018",5,2,13,20
431600,"2019",4,6,0,10
431600,"2020",1,2,4,7
431600,"2021",4,2,2,8
431600,"2022",3,0,5,8
431600,"2023",4,2,2,8
431610,"2019",0,1,0,1
431610,"2022",2,0,0,2
431610,"2023",0,0,1,1
431620,"2022",1,0,0,1
431630,"2020",0,1,0,1
431630,"2021",1,0,0,1
431630,"2023",1,0,0,1
431640,"2015",12,3,14,29
431640,"2016",5,2,6,13
431640,"2017",8,1,13,22
431640,"2018",7,3,21,31
431640,"2019",6,1,11,18
431640,"2020",5,1,10,16
431640,"2021",9,3,6,18
431640,"2022",7,1,6,14
431640,"2023",4,0,5,9
431642,"2016",0,0,1,1
431642,"2019",0,1,1,2
431643,"2015",1,0,2,3
431643,"2016",1,0,2,3
431643,"2017",0,0,2,2
431643,"2018",0,0,1,1
431643,"2019",2,1,0,3
431643,"2020",2,0,1,3
431643,"2021",1,0,0,1
431645,"2015",1,2,4,7
431645,"2016",0,1,5,6
431645,"2017",2,0,1,3
431645,"2018",1,0,0,1
431645,"2019",0,0,1,1
431645,"2020",1,0,0,1
431645,"2023",0,0,1,1
431647,"2020",1,0,0,1
431647,"2022",1,0,0,1
431650,"2015",0,0,1,1
431650,"2018",0,0,1,1
431650,"2019",0,1,0,1
431650,"2020",0,0,1,1
431650,"2021",2,0,0,2
431650,"2022",0,2,1,3
431650,"2023",0,1,1,2
431660,"2015",0,2,0,2
431660,"2016",0,0,1,1
431660,"2017",1,1,0,2
431660,"2018",2,0,2,4
431660,"2019",0,0,1,1
431660,"2023",1,0,1,2
431670,"2015",2,1,3,6
431670,"2016",2,2,4,8
431670,"2017",1,0,6,7
431670,"2018",2,0,2,4
431670,"2019",3,2,1,6
431670,"2020",3,3,0,6
431670,"2021",1,1,3,5
431670,"2022",0,1,2,3
431670,"2023",3,1,5,9
431673,"2016",1,0,0,1
431673,"2019",0,1,0,1
431673,"2020",1,0,0,1
431673,"2021",0,0,1,1
431673,"2022",1,0,0,1
431675,"2015",1,0,1,2
431675,"2018",0,0,1,1
431675,"2019",2,0,1,3
431675,"2020",3,0,2,5
431675,"2021",1,1,1,3
431675,"2022",1,1,0,2
431675,"2023",0,1,1,2
431680,"2015",9,3,18,30
431680,"2016",13,3,11,27
431680,"2017",2,2,8,12
431680,"2018",2,0,8,10
431680,"2019",16,2,13,31
431680,"2020",14,8,16,38
431680,"2021",10,0,11,21
431680,"2022",14,6,17,37
431680,"2023",11,2,11,24
431690,"2015",43,10,52,105
431690,"2016",32,8,57,97
431690,"2017",26,10,43,79
431690,"2018",38,8,43,89
431690,"2019",31,8,37,76
431690,"2020",26,5,24,55
431690,"2021",14,4,26,44
431690,"2022",19,9,22,50
431690,"2023",11,9,17,37
431695,"2015",1,0,0,1
431695,"2016",3,0,1,4
431695,"2021",1,0,0,1
431700,"2015",1,1,2,4
431700,"2016",0,0,1,1
431700,"2017",3,0,1,4
431700,"2018",0,1,0,1
431700,"2019",0,0,1,1
431700,"2020",0,0,1,1
431700,"2021",1,0,0,1
431700,"2022",0,0,1,1
431710,"2015",7,5,20,32
431710,"2016",17,5,33,55
431710,"2017",20,5,34,59
431710,"2018",20,9,34,63
431710,"2019",15,15,36,66
431710,"2020",13,7,30,50
431710,"2021",19,5,32,56
431710,"2022",18,15,32,65
431710,"2023",10,5,31,46
431720,"2015",0,0,2,2
431720,"2017",0,0,1,1
431720,"2018",0,3,2,5
431720,"2020",6,1,7,14
431720,"2021",6,2,11,19
431720,"2022",5,1,2,8
431720,"2023",3,3,4,10
431725,"2022",0,0,1,1
431730,"2015",8,2,7,17
431730,"2016",7,3,5,15
431730,"2017",15,2,9,26
431730,"2018",3,2,4,9
431730,"2019",8,1,5,14
431730,"2020",9,1,7,17
431730,"2021",4,2,8,14
431730,"2022",8,0,7,15
431730,"2023",5,2,11,18
431740,"2015",3,3,15,21
431740,"2016",2,0,3,5
431740,"2017",3,0,4,7
431740,"2018",4,1,9,14
431740,"2019",4,2,4,10
431740,"2020",2,2,5,9
431740,"2021",3,1,5,9
431740,"2022",2,0,5,7
431740,"2023",5,0,3,8
431750,"2015",6,1,8,15
431750,"2016",2,0,2,4
431750,"2017",1,1,3,5
431750,"2018",4,1,5,10
431750,"2019",7,5,10,22
431750,"2020",15,4,8,27
431750,"2021",10,6,20,36
431750,"2022",18,3,20,41
431750,"2023",6,3,13,22
431755,"2021",1,0,0,1
431755,"2022",0,1,0,1
431760,"2015",4,2,3,9
431760,"2016",3,1,4,8
431760,"2017",0,1,0,1
431760,"2018",1,0,4,5
431760,"2019",5,2,2,9
431760,"2020",3,0,0,3
431760,"2021",2,0,2,4
431760,"2022",0,0,2,2
431760,"2023",1,0,1,2
431770,"2015",0,0,1,1
431770,"2021",0,0,1,1
431770,"2023",1,0,0,1
431775,"2015",0,1,0,1
431775,"2017",0,1,0,1
431775,"2018",0,1,1,2
431775,"2019",0,0,1,1
431775,"2020",0,1,0,1
431780,"2017",0,1,0,1
431780,"2020",0,0,1,1
431790,"2015",0,0,1,1
431790,"2022",1,0,0,1
431795,"2016",1,0,0,1
431795,"2017",1,0,0,1
431795,"2019",1,0,0,1
431795,"2020",1,0,0,1
431800,"2015",4,0,12,16
431800,"2016",13,2,20,35
431800,"2017",9,0,31,40
431800,"2018",14,4,24,42
431800,"2019",6,2,11,19
431800,"2020",4,0,4,8
431800,"2021",6,2,13,21
431800,"2022",9,5,18,32
431800,"2023",11,8,6,25
431805,"2022",1,0,0,1
431810,"2016",2,0,1,3
431810,"2017",1,1,2,4
431810,"2018",0,1,3,4
431810,"2019",1,0,2,3
431810,"2020",2,0,0,2
431810,"2022",4,0,1,5
431810,"2023",1,0,0,1
431820,"2015",2,0,4,6
431820,"2016",2,0,6,8
431820,"2017",0,0,5,5
431820,"2018",3,0,1,4
431820,"2019",3,1,7,11
431820,"2020",0,1,4,5
431820,"2021",2,1,3,6
431820,"2022",2,1,8,11
431820,"2023",0,0,2,2
431830,"2015",0,0,1,1
431830,"2016",0,0,1,1
431830,"2019",1,0,0,1
431830,"2020",0,0,1,1
431830,"2021",2,0,3,5
431830,"2022",5,0,5,10
431830,"2023",6,1,7,14
431840,"2015",4,0,3,7
431840,"2016",4,1,3,8
431840,"2017",2,1,3,6
431840,"2018",4,2,7,13
431840,"2019",4,2,7,13
431840,"2020",2,2,4,8
431840,"2021",5,2,4,11
431840,"2022",12,0,3,15
431840,"2023",3,1,1,5
431842,"2015",0,0,1,1
431843,"2015",1,0,0,1
431843,"2016",1,0,1,2
431844,"2015",1,0,0,1
431844,"2016",1,0,0,1
431844,"2020",2,0,0,2
431844,"2021",0,0,1,1
431845,"2019",1,0,0,1
431846,"2016",0,0,1,1
431846,"2020",1,0,0,1
431846,"2021",0,0,1,1
431848,"2015",0,0,1,1
431848,"2016",0,1,0,1
431848,"2017",1,0,0,1
431849,"2017",1,0,0,1
431849,"2018",1,0,0,1
431849,"2022",2,1,0,3
431850,"2015",0,2,3,5
431850,"2016",1,0,5,6
431850,"2017",3,3,5,11
431850,"2018",3,0,6,9
431850,"2019",1,1,1,3
431850,"2020",1,0,5,6
431850,"2021",5,0,5,10
431850,"2022",3,2,9,14
431850,"2023",2,1,5,8
431860,"2016",0,0,1,1
431860,"2020",0,0,1,1
431860,"2021",1,0,0,1
431861,"2017",0,1,0,1
431861,"2021",1,0,1,2
431862,"2015",0,0,1,1
431862,"2016",2,0,3,5
431862,"2017",1,0,2,3
431862,"2019",0,0,1,1
431862,"2020",1,0,0,1
431862,"2022",1,0,1,2
431870,"2015",33,9,67,109
431870,"2016",27,7,52,86
431870,"2017",38,7,47,92
431870,"2018",26,8,47,81
431870,"2019",40,6,41,87
431870,"2020",33,8,47,88
431870,"2021",45,9,64,118
431870,"2022",55,14,58,127
431870,"2023",25,3,37,65
431880,"2015",1,0,4,5
431880,"2016",0,1,1,2
431880,"2018",2,1,2,5
431880,"2019",3,3,1,7
431880,"2020",1,5,2,8
431880,"2021",1,0,3,4
431880,"2022",6,2,2,10
431890,"2015",1,0,0,1
431890,"2020",1,0,0,1
431890,"2022",1,0,0,1
431900,"2015",4,0,5,9
431900,"2016",2,0,6,8
431900,"2017",3,0,2,5
431900,"2018",1,2,2,5
431900,"2019",2,1,6,9
431900,"2020",0,0,5,5
431900,"2022",0,2,4,6
431900,"2023",0,0,4,4
431910,"2016",1,0,0,1
431910,"2017",1,0,0,1
431912,"2015",0,0,1,1
431912,"2017",0,0,1,1
431912,"2018",1,0,0,1
431912,"2020",1,0,0,1
431912,"2022",1,0,0,1
431915,"2015",1,0,0,1
431915,"2017",1,0,1,2
431915,"2019",1,0,0,1
431915,"2020",1,0,0,1
431915,"2021",1,0,2,3
431915,"2023",3,0,1,4
431920,"2023",0,0,1,1
431930,"2016",1,0,0,1
431930,"2017",0,0,1,1
431930,"2018",0,0,1,1
431930,"2019",1,0,1,2
431930,"2020",1,0,0,1
431930,"2022",1,0,2,3
431935,"2016",0,0,1,1
431935,"2017",1,0,0,1
431935,"2018",0,1,0,1
431935,"2019",0,0,1,1
431935,"2020",2,1,0,3
431935,"2023",1,0,1,2
431936,"2016",1,0,1,2
431936,"2017",0,0,1,1
431936,"2019",0,0,1,1
431936,"2020",0,0,1,1
431937,"2015",1,0,0,1
431937,"2023",2,0,0,2
431940,"2015",2,1,6,9
431940,"2016",0,0,2,2
431940,"2017",1,0,0,1
431940,"2018",1,1,1,3
431940,"2019",0,0,3,3
431940,"2021",1,1,0,2
431950,"2015",2,0,4,6
431950,"2016",6,1,7,14
431950,"2017",4,0,3,7
431950,"2018",3,2,4,9
431950,"2019",3,0,1,4
431950,"2020",4,1,6,11
431950,"2021",1,2,2,5
431950,"2022",8,0,5,13
431950,"2023",1,1,3,5
431960,"2015",3,0,2,5
431960,"2016",1,1,3,5
431960,"2017",2,0,1,3
431960,"2018",3,0,4,7
431960,"2019",0,1,4,5
431960,"2020",4,0,3,7
431960,"2021",0,0,2,2
431960,"2022",1,0,1,2
431960,"2023",0,1,1,2
431970,"2017",0,1,0,1
431970,"2021",0,1,0,1
431970,"2022",0,0,1,1
431971,"2018",0,0,1,1
431971,"2020",0,1,1,2
431971,"2022",1,0,1,2
431973,"2023",1,0,0,1
431975,"2015",0,0,1,1
431975,"2017",1,0,1,2
431975,"2019",0,0,1,1
431975,"2020",1,0,0,1
431975,"2021",2,0,0,2
431975,"2022",0,1,0,1
431975,"2023",0,1,0,1
431980,"2015",1,0,3,4
431980,"2017",1,0,0,1
431980,"2019",0,0,2,2
431980,"2020",1,0,0,1
431980,"2022",0,1,0,1
431990,"2015",24,6,36,66
431990,"2016",19,11,34,64
431990,"2017",26,10,43,79
431990,"2018",27,13,40,80
431990,"2019",23,10,47,80
431990,"2020",41,5,36,82
431990,"2021",21,7,48,76
431990,"2022",21,14,35,70
431990,"2023",21,6,19,46
432000,"2015",39,6,74,119
432000,"2016",22,7,56,85
432000,"2017",37,7,47,91
432000,"2018",31,8,33,72
432000,"2019",18,16,41,75
432000,"2020",20,9,22,51
432000,"2021",19,6,26,51
432000,"2022",23,3,31,57
432000,"2023",18,6,22,46
432010,"2015",2,0,3,5
432010,"2016",4,2,4,10
432010,"2017",2,0,0,2
432010,"2018",5,1,5,11
432010,"2019",1,0,1,2
432010,"2020",0,0,3,3
432010,"2021",1,1,4,6
432010,"2022",0,0,3,3
432010,"2023",1,0,0,1
432020,"2015",2,1,2,5
432020,"2016",1,0,2,3
432020,"2017",1,0,2,3
432020,"2018",2,0,2,4
432020,"2019",0,0,1,1
432020,"2020",3,1,0,4
432020,"2021",1,0,2,3
432020,"2022",1,0,0,1
432020,"2023",2,0,4,6
432023,"2020",1,0,2,3
432023,"2021",0,0,2,2
432026,"2015",2,0,0,2
432026,"2018",0,0,1,1
432026,"2019",0,0,1,1
432026,"2022",0,1,0,1
432030,"2016",0,0,1,1
432030,"2020",1,0,1,2
432032,"2020",0,0,1,1
432032,"2021",0,0,1,1
432035,"2016",0,0,2,2
432035,"2018",0,1,0,1
432035,"2019",0,2,1,3
432035,"2020",0,0,1,1
432035,"2021",1,0,0,1
432035,"2022",0,0,1,1
432040,"2015",4,2,3,9
432040,"2016",2,0,3,5
432040,"2017",4,0,2,6
432040,"2018",3,0,2,5
432040,"2019",2,0,4,6
432040,"2020",0,1,5,6
432040,"2021",2,1,2,5
432040,"2022",0,1,2,3
432045,"2018",2,0,0,2
432045,"2022",0,0,1,1
432045,"2023",0,0,1,1
432050,"2017",1,0,2,3
432050,"2018",0,0,1,1
432050,"2021",0,0,4,4
432050,"2023",0,0,2,2
432055,"2018",0,0,1,1
432055,"2019",1,0,0,1
432055,"2021",0,0,1,1
432055,"2022",1,0,0,1
432055,"2023",1,0,2,3
432057,"2020",0,0,1,1
432057,"2021",1,0,1,2
432057,"2023",1,0,0,1
432060,"2015",0,0,1,1
432060,"2016",1,0,0,1
432060,"2020",0,0,1,1
432060,"2022",0,0,1,1
432065,"2015",0,0,1,1
432065,"2016",0,0,2,2
432065,"2018",0,1,0,1
432067,"2015",0,0,1,1
432067,"2017",0,1,0,1
432067,"2019",1,0,3,4
432067,"2021",0,0,2,2
432067,"2022",1,0,0,1
432070,"2015",0,0,1,1
432070,"2018",0,0,1,1
432070,"2019",0,0,1,1
432070,"2020",1,0,0,1
432070,"2021",2,0,2,4
432080,"2015",1,1,3,5
432080,"2017",0,0,2,2
432080,"2018",2,1,0,3
432080,"2019",1,2,3,6
432080,"2020",4,1,1,6
432080,"2021",2,1,1,4
432080,"2022",0,1,3,4
432080,"2023",1,0,1,2
432085,"2015",0,0,1,1
432085,"2016",1,1,0,2
432085,"2018",1,0,0,1
432085,"2019",0,0,1,1
432085,"2020",1,1,2,4
432085,"2021",1,0,0,1
432085,"2022",0,0,2,2
432090,"2015",3,0,4,7
432090,"2016",1,1,1,3
432090,"2017",1,0,1,2
432090,"2018",1,0,4,5
432090,"2019",2,1,0,3
432090,"2020",3,1,3,7
432090,"2021",2,0,3,5
432090,"2022",0,2,5,7
432090,"2023",5,1,4,10
432100,"2015",1,0,0,1
432100,"2017",1,0,0,1
432100,"2018",0,0,2,2
432100,"2020",1,1,3,5
432100,"2021",1,0,0,1
432100,"2022",1,1,1,3
432100,"2023",3,0,0,3
432110,"2015",0,1,2,3
432110,"2016",1,0,3,4
432110,"2017",3,0,4,7
432110,"2018",0,1,2,3
432110,"2019",3,1,1,5
432110,"2020",1,0,3,4
432110,"2021",1,1,2,4
432110,"2022",1,1,3,5
432110,"2023",0,0,1,1
432120,"2015",14,4,14,32
432120,"2016",10,1,14,25
432120,"2017",3,2,19,24
432120,"2018",4,4,10,18
432120,"2019",11,3,14,28
432120,"2020",9,2,11,22
432120,"2021",6,3,16,25
432120,"2022",9,5,7,21
432120,"2023",7,1,11,19
432130,"2015",3,2,4,9
432130,"2016",3,0,1,4
432130,"2017",1,1,1,3
432130,"2018",3,0,4,7
432130,"2019",9,0,4,13
432130,"2020",3,1,7,11
432130,"2021",5,1,9,15
432130,"2022",5,5,6,16
432130,"2023",6,1,5,12
432132,"2018",0,0,1,1
432132,"2020",1,0,0,1
432135,"2015",1,0,0,1
432135,"2017",1,0,1,2
432135,"2018",1,0,0,1
432135,"2022",1,0,0,1
432140,"2015",2,0,0,2
432140,"2016",2,1,0,3
432140,"2017",0,0,3,3
432140,"2018",1,2,2,5
432140,"2019",0,1,0,1
432140,"2020",0,1,2,3
432140,"2021",1,0,3,4
432140,"2022",4,1,5,10
432140,"2023",1,1,5,7
432143,"2015",1,1,2,4
432143,"2016",2,1,2,5
432143,"2017",0,0,3,3
432143,"2018",0,1,1,2
432143,"2019",1,0,1,2
432143,"2020",1,0,1,2
432143,"2021",0,0,1,1
432143,"2022",0,0,1,1
432143,"2023",1,0,2,3
432145,"2015",13,2,21,36
432145,"2016",18,5,16,39
432145,"2017",9,2,12,23
432145,"2018",9,0,15,24
432145,"2019",6,4,13,23
432145,"2020",7,2,7,16
432145,"2021",5,4,9,18
432145,"2022",13,2,10,25
432145,"2023",4,0,11,15
432146,"2016",0,0,1,1
432146,"2017",0,0,1,1
432146,"2019",0,0,2,2
432146,"2020",0,1,2,3
432146,"2021",0,2,0,2
432146,"2023",0,0,1,1
432147,"2015",0,0,1,1
432147,"2017",0,0,1,1
432147,"2019",0,0,2,2
432147,"2020",1,0,2,3
432147,"2021",1,0,0,1
432147,"2022",1,0,0,1
432147,"2023",0,0,2,2
432149,"2023",1,0,0,1
432150,"2015",8,1,7,16
432150,"2016",1,0,5,6
432150,"2017",5,1,4,10
432150,"2018",3,1,5,9
432150,"2019",5,1,4,10
432150,"2020",5,1,3,9
432150,"2021",5,1,2,8
432150,"2022",1,1,4,6
432150,"2023",4,3,6,13
432160,"2015",18,2,8,28
432160,"2016",17,6,18,41
432160,"2017",15,1,10,26
432160,"2018",13,3,16,32
432160,"2019",5,1,17,23
432160,"2020",3,0,12,15
432160,"2021",11,5,13,29
432160,"2022",7,2,13,22
432160,"2023",9,0,6,15
432166,"2015",0,0,2,2
432166,"2016",1,0,1,2
432166,"2017",1,0,1,2
432166,"2018",1,0,0,1
432166,"2019",0,0,1,1
432166,"2021",0,1,0,1
432166,"2022",1,0,0,1
432166,"2023",2,1,0,3
432170,"2015",4,1,12,17
432170,"2016",3,1,4,8
432170,"2017",6,1,15,22
432170,"2018",4,1,8,13
432170,"2019",4,0,10,14
432170,"2020",2,2,6,10
432170,"2021",1,2,5,8
432170,"2022",3,3,1,7
432170,"2023",2,1,4,7
432180,"2015",5,3,6,14
432180,"2016",0,1,1,2
432180,"2017",2,1,4,7
432180,"2018",4,2,1,7
432180,"2019",5,3,7,15
432180,"2020",4,1,6,11
432180,"2021",4,2,3,9
432180,"2022",5,3,0,8
432180,"2023",4,0,0,4
432183,"2016",1,0,0,1
432183,"2019",0,1,0,1
432183,"2021",1,0,0,1
432185,"2015",1,0,0,1
432185,"2016",0,0,1,1
432185,"2018",1,0,0,1
432185,"2022",2,0,1,3
432190,"2015",5,2,0,7
432190,"2016",0,2,2,4
432190,"2017",0,0,9,9
432190,"2018",1,1,1,3
432190,"2019",2,1,7,10
432190,"2020",5,0,7,12
432190,"2021",9,3,10,22
432190,"2022",2,4,14,20
432190,"2023",4,1,5,10
432195,"2016",0,0,1,1
432195,"2017",1,0,0,1
432195,"2018",1,0,0,1
432195,"2020",1,0,0,1
432195,"2022",0,0,1,1
432200,"2015",4,2,9,15
432200,"2016",8,3,14,25
432200,"2017",3,2,14,19
432200,"2018",7,0,5,12
432200,"2019",2,1,9,12
432200,"2020",2,2,12,16
432200,"2021",8,0,6,14
432200,"2022",7,3,7,17
432200,"2023",1,1,4,6
432210,"2016",1,0,0,1
432210,"2017",2,0,0,2
432210,"2020",2,0,1,3
432210,"2021",1,0,0,1
432215,"2015",0,1,0,1
432215,"2017",1,0,0,1
432215,"2019",1,0,1,2
432215,"2021",1,0,0,1
432215,"2022",0,0,1,1
432218,"2017",0,0,1,1
432218,"2021",1,0,1,2
432218,"2022",0,0,1,1
432220,"2015",2,0,5,7
432220,"2016",2,0,2,4
432220,"2017",2,0,2,4
432220,"2018",0,1,3,4
432220,"2019",2,1,3,6
432220,"2020",2,0,4,6
432220,"2021",3,0,2,5
432220,"2022",2,1,0,3
432220,"2023",1,0,3,4
432225,"2015",0,0,1,1
432225,"2016",1,0,1,2
432225,"2017",1,0,2,3
432225,"2019",0,0,1,1
432225,"2020",1,0,1,2
432225,"2021",1,0,1,2
432225,"2022",2,0,0,2
432225,"2023",2,0,2,4
432232,"2015",1,0,0,1
432232,"2016",0,1,1,2
432232,"2017",0,0,2,2
432232,"2019",1,0,0,1
432232,"2020",0,0,2,2
432232,"2022",0,0,1,1
432234,"2021",1,0,0,1
432235,"2015",0,1,0,1
432235,"2017",0,0,1,1
432237,"2015",0,0,2,2
432237,"2017",0,1,0,1
432237,"2018",0,0,1,1
432237,"2019",1,0,0,1
432237,"2020",0,0,2,2
432237,"2021",0,0,1,1
432237,"2022",0,0,1,1
432240,"2015",6,0,7,13
432240,"2016",4,0,9,13
432240,"2017",2,0,10,12
432240,"2018",5,0,5,10
432240,"2019",14,5,24,43
432240,"2020",4,3,6,13
432240,"2021",22,12,42,76
432240,"2022",35,13,50,98
432240,"2023",19,5,40,64
432250,"2015",15,7,24,46
432250,"2016",21,3,29,53
432250,"2017",12,6,25,43
432250,"2018",19,8,30,57
432250,"2019",11,5,28,44
432250,"2020",14,3,16,33
432250,"2021",13,6,26,45
432250,"2022",6,1,6,13
432250,"2023",4,1,6,11
432252,"2017",0,0,1,1
432252,"2022",0,1,0,1
432253,"2015",1,1,1,3
432253,"2016",0,1,1,2
432253,"2017",1,0,1,2
432253,"2018",0,0,1,1
432253,"2019",0,1,0,1
432253,"2020",1,0,1,2
432254,"2015",1,0,0,1
432254,"2016",0,0,1,1
432254,"2018",1,0,0,1
432254,"2019",0,0,1,1
432255,"2021",1,0,0,1
432260,"2015",0,0,1,1
432260,"2016",2,0,1,3
432260,"2017",0,0,1,1
432260,"2018",0,0,2,2
432260,"2019",1,2,1,4
432260,"2020",1,1,3,5
432260,"2021",3,2,2,7
432260,"2022",1,1,4,6
432260,"2023",4,0,5,9
432270,"2015",3,0,6,9
432270,"2016",3,2,14,19
432270,"2017",2,6,6,14
432270,"2018",1,0,0,1
432270,"2019",2,0,2,4
432270,"2020",2,1,2,5
432270,"2021",2,2,6,10
432270,"2022",1,0,4,5
432270,"2023",1,1,1,3
432280,"2015",4,1,3,8
432280,"2016",2,0,3,5
432280,"2017",0,1,7,8
432280,"2018",3,0,6,9
432280,"2019",4,2,4,10
432280,"2020",2,1,4,7
432280,"2021",2,0,3,5
432280,"2022",0,3,5,8
432280,"2023",0,1,2,3
432285,"2018",0,0,1,1
432285,"2020",0,1,0,1
432285,"2021",0,0,1,1
432285,"2022",1,0,0,1
432290,"2017",1,0,0,1
432290,"2020",0,0,1,1
432290,"2021",0,1,0,1
432300,"2015",45,20,89,154
432300,"2016",51,12,78,141
432300,"2017",51,9,73,133
432300,"2018",47,11,70,128
432300,"2019",47,18,72,137
432300,"2020",50,17,70,137
432300,"2021",26,5,36,67
432300,"2022",18,5,23,46
432300,"2023",17,7,21,45
432310,"2015",1,0,0,1
432310,"2018",1,0,0,1
432310,"2019",3,0,0,3
432310,"2020",0,1,0,1
432310,"2021",0,0,1,1
432310,"2022",4,1,1,6
432320,"2017",1,0,0,1
432320,"2019",0,0,1,1
432320,"2021",1,1,0,2
432320,"2022",1,0,0,1
432330,"2016",0,0,1,1
432330,"2020",1,0,0,1
432330,"2023",0,0,1,1
432335,"2019",1,0,0,1
432340,"2015",0,2,0,2
432340,"2019",0,1,0,1
432345,"2018",1,0,0,1
432350,"2019",1,0,0,1
432350,"2021",0,0,1,1
432350,"2022",1,0,1,2
432360,"2015",0,0,1,1
432360,"2017",1,1,0,2
432370,"2017",0,1,0,1
432370,"2018",0,0,1,1
432370,"2021",0,0,1,1
432370,"2023",1,0,0,1
432375,"2018",0,1,1,2
432375,"2020",0,0,1,1
432375,"2022",0,0,2,2
432377,"2015",1,0,1,2
432377,"2016",3,0,0,3
432377,"2017",0,0,1,1
432377,"2019",3,0,1,4
432377,"2020",1,1,3,5
432377,"2021",1,1,1,3
432377,"2022",1,1,1,3
432380,"2015",2,2,9,13
432380,"2016",3,1,4,8
432380,"2017",4,0,1,5
432380,"2018",2,0,3,5
432380,"2019",2,0,4,6
432380,"2020",0,0,2,2
432380,"2021",2,1,1,4
432380,"2022",1,0,2,3
432380,"2023",0,1,4,5
500020,"2015",0,0,2,2
500020,"2016",0,0,1,1
500020,"2017",2,0,4,6
500020,"2018",0,0,1,1
500020,"2019",2,0,4,6
500020,"2020",0,1,4,5
500020,"2021",2,0,6,8
500020,"2022",5,0,6,11
500025,"2015",1,0,0,1
500025,"2017",1,0,1,2
500025,"2018",0,0,1,1
500025,"2019",1,0,2,3
500025,"2020",0,0,2,2
500025,"2022",0,1,0,1
500060,"2015",5,3,11,19
500060,"2016",4,1,15,20
500060,"2017",8,0,10,18
500060,"2018",4,2,7,13
500060,"2019",1,1,9,11
500060,"2020",3,1,17,21
500060,"2021",2,1,8,11
500060,"2022",4,2,5,11
500060,"2023",5,1,11,17
500070,"2015",10,1,19,30
500070,"2016",7,4,19,30
500070,"2017",6,5,27,38
500070,"2018",13,3,20,36
500070,"2019",7,7,14,28
500070,"2020",13,2,26,41
500070,"2021",17,1,22,40
500070,"2022",8,1,7,16
500070,"2023",3,1,9,13
500080,"2015",0,2,5,7
500080,"2016",2,1,5,8
500080,"2017",3,1,2,6
500080,"2018",2,1,4,7
500080,"2019",3,0,4,7
500080,"2020",2,0,1,3
500080,"2021",1,0,4,5
500080,"2022",2,1,2,5
500080,"2023",0,1,0,1
500085,"2015",1,0,0,1
500085,"2016",0,0,3,3
500085,"2017",0,0,1,1
500085,"2018",2,0,0,2
500085,"2019",1,1,3,5
500085,"2020",1,0,0,1
500085,"2021",3,0,0,3
500085,"2022",1,0,1,2
500090,"2015",0,0,2,2
500090,"2016",1,0,1,2
500090,"2017",0,1,0,1
500090,"2018",1,0,5,6
500090,"2019",1,0,3,4
500090,"2020",1,2,3,6
500090,"2021",2,1,5,8
500090,"2022",3,1,4,8
500090,"2023",3,0,2,5
500100,"2015",1,0,5,6
500100,"2016",1,0,2,3
500100,"2017",2,0,6,8
500100,"2018",3,0,8,11
500100,"2019",5,2,9,16
500100,"2020",9,1,12,22
500100,"2021",5,1,20,26
500100,"2022",5,1,12,18
500100,"2023",3,2,4,9
500110,"2015",17,3,43,63
500110,"2016",22,3,37,62
500110,"2017",20,5,38,63
500110,"2018",21,3,39,63
500110,"2019",17,3,38,58
500110,"2020",16,5,32,53
500110,"2021",13,2,27,42
500110,"2022",11,2,23,36
500110,"2023",4,0,11,15
500124,"2015",1,0,5,6
500124,"2016",1,1,3,5
500124,"2017",1,2,3,6
500124,"2018",2,0,4,6
500124,"2019",1,0,3,4
500124,"2020",1,1,2,4
500124,"2021",1,1,1,3
500124,"2022",5,0,4,9
500124,"2023",4,1,1,6
500150,"2015",2,1,2,5
500150,"2016",1,1,0,2
500150,"2017",0,0,3,3
500150,"2018",2,0,2,4
500150,"2019",1,1,2,4
500150,"2020",1,0,2,3
500150,"2021",2,0,1,3
500150,"2022",0,0,1,1
500150,"2023",0,1,2,3
500190,"2015",3,0,11,14
500190,"2016",4,0,4,8
500190,"2017",2,0,8,10
500190,"2018",5,0,9,14
500190,"2019",6,1,11,18
500190,"2020",5,2,6,13
500190,"2021",0,2,1,3
500200,"2015",2,0,1,3
500200,"2016",2,0,6,8
500200,"2017",0,0,3,3
500200,"2018",3,1,0,4
500200,"2019",2,0,0,2
500200,"2020",2,0,2,4
500200,"2021",1,0,2,3
500200,"2022",2,0,1,3
500210,"2015",3,2,9,14
500210,"2016",7,2,8,17
500210,"2017",6,3,11,20
500210,"2018",7,2,11,20
500210,"2019",11,3,5,19
500210,"2020",5,2,11,18
500210,"2021",7,2,8,17
500210,"2022",4,0,8,12
500210,"2023",3,2,1,6
500215,"2015",0,0,1,1
500215,"2016",1,1,1,3
500215,"2017",0,0,1,1
500215,"2018",0,0,2,2
500215,"2019",2,1,0,3
500215,"2020",3,0,1,4
500215,"2021",0,0,1,1
500215,"2022",0,0,5,5
500215,"2023",1,0,2,3
500220,"2015",7,3,9,19
500220,"2016",3,0,5,8
500220,"2017",0,0,6,6
500220,"2018",1,0,6,7
500220,"2019",2,0,4,6
500220,"2020",0,0,2,2
500220,"2021",2,0,5,7
500220,"2022",0,1,2,3
500220,"2023",0,0,2,2
500230,"2015",0,0,2,2
500230,"2016",3,0,3,6
500230,"2017",2,0,3,5
500230,"2018",1,0,3,4
500230,"2019",5,0,4,9
500230,"2020",0,0,2,2
500230,"2021",0,0,3,3
500230,"2022",1,0,0,1
500240,"2015",0,0,1,1
500240,"2016",1,0,2,3
500240,"2019",0,1,1,2
500240,"2020",1,0,1,2
500240,"2021",0,0,1,1
500240,"2022",1,1,0,2
500240,"2023",0,0,2,2
500260,"2015",3,0,2,5
500260,"2016",1,0,2,3
500260,"2017",0,0,4,4
500260,"2018",1,0,1,2
500260,"2019",2,0,2,4
500260,"2020",1,0,0,1
500260,"2021",0,0,3,3
500260,"2022",0,0,4,4
500260,"2023",1,0,3,4
500270,"2015",151,22,315,488
500270,"2016",152,20,285,457
500270,"2017",156,38,286,480
500270,"2018",146,28,258,432
500270,"2019",141,36,240,417
500270,"2020",124,35,242,401
500270,"2021",114,28,196,338
500270,"2022",145,36,215,396
500270,"2023",95,24,159,278
500280,"2016",0,0,1,1
500280,"2017",0,1,2,3
500280,"2018",3,0,0,3
500280,"2020",2,1,1,4
500280,"2021",0,0,1,1
500280,"2022",2,0,5,7
500290,"2015",1,0,1,2
500290,"2017",1,0,0,1
500290,"2019",2,0,3,5
500290,"2021",1,0,3,4
500290,"2022",1,0,5,6
500290,"2023",0,0,3,3
500295,"2015",3,0,3,6
500295,"2016",2,0,8,10
500295,"2017",2,0,7,9
500295,"2018",6,1,17,24
500295,"2019",8,1,17,26
500295,"2020",4,3,13,20
500295,"2021",8,2,10,20
500295,"2022",7,0,15,22
500295,"2023",5,2,8,15
500310,"2015",1,0,0,1
500310,"2017",0,0,1,1
500310,"2018",1,0,1,2
500310,"2019",1,0,1,2
500310,"2020",0,1,0,1
500310,"2022",2,0,0,2
500315,"2015",0,0,1,1
500315,"2016",2,0,0,2
500315,"2017",1,0,1,2
500315,"2019",0,0,3,3
500315,"2020",0,0,1,1
500315,"2021",0,0,1,1
500315,"2022",2,0,0,2
500315,"2023",0,0,3,3
500320,"2015",21,5,57,83
500320,"2016",29,10,51,90
500320,"2017",11,6,56,73
500320,"2018",21,2,45,68
500320,"2019",28,7,51,86
500320,"2020",13,4,58,75
500320,"2021",24,6,62,92
500320,"2022",41,10,84,135
500320,"2023",12,6,37,55
500325,"2015",1,0,3,4
500325,"2016",6,0,5,11
500325,"2017",4,0,1,5
500325,"2018",1,1,3,5
500325,"2019",3,0,7,10
500325,"2020",3,0,7,10
500325,"2021",1,0,6,7
500325,"2022",4,1,7,12
500325,"2023",3,0,1,4
500330,"2015",9,1,10,20
500330,"2016",10,0,11,21
500330,"2017",4,2,12,18
500330,"2018",7,0,29,36
500330,"2019",7,2,15,24
500330,"2020",7,0,13,20
500330,"2021",5,1,12,18
500330,"2022",5,2,11,18
500330,"2023",1,1,2,4
500345,"2015",2,0,0,2
500345,"2016",0,0,1,1
500345,"2017",0,0,2,2
500345,"2018",1,1,2,4
500345,"2019",1,0,1,2
500345,"2020",0,0,3,3
500345,"2021",1,0,1,2
500345,"2022",1,0,1,2
500345,"2023",3,1,2,6
500348,"2015",1,0,2,3
500348,"2016",0,0,6,6
500348,"2017",1,0,4,5
500348,"2018",1,1,4,6
500348,"2019",1,0,4,5
500348,"2020",0,1,6,7
500348,"2021",1,0,3,4
500348,"2022",2,0,4,6
500348,"2023",1,0,3,4
500350,"2015",2,0,1,3
500350,"2016",0,0,3,3
500350,"2017",1,1,3,5
500350,"2018",1,0,2,3
500350,"2019",4,1,3,8
500350,"2020",3,0,2,5
500350,"2021",0,0,1,1
500350,"2022",2,0,1,3
500350,"2023",1,0,1,2
500370,"2015",46,12,124,182
500370,"2016",42,10,93,145
500370,"2017",50,11,83,144
500370,"2018",45,7,84,136
500370,"2019",28,8,73,109
500370,"2020",45,15,57,117
500370,"2021",27,7,53,87
500370,"2022",31,6,52,89
500370,"2023",23,6,24,53
500375,"2015",0,0,5,5
500375,"2017",0,1,0,1
500375,"2018",0,1,1,2
500375,"2021",0,1,3,4
500375,"2022",3,0,2,5
500375,"2023",0,1,5,6
500380,"2015",2,0,1,3
500380,"2016",2,1,2,5
500380,"2017",0,1,0,1
500380,"2018",2,0,2,4
500380,"2019",1,0,3,4
500380,"2020",7,1,5,13
500380,"2021",0,0,4,4
500380,"2022",1,0,7,8
500380,"2023",0,0,2,2
500390,"2022",1,0,1,2
500390,"2023",1,0,0,1
500400,"2015",1,0,1,2
500400,"2016",3,0,2,5
500400,"2017",0,0,1,1
500400,"2018",1,0,0,1
500400,"2019",0,0,3,3
500400,"2020",2,1,3,6
500400,"2021",0,0,1,1
500410,"2016",0,0,4,4
500410,"2017",0,0,3,3
500410,"2018",0,0,1,1
500410,"2020",1,0,4,5
500410,"2021",1,0,2,3
500410,"2022",2,0,3,5
500410,"2023",1,1,1,3
500430,"2016",2,0,2,4
500430,"2021",1,0,0,1
500440,"2016",0,0,1,1
500440,"2017",0,0,1,1
500440,"2018",0,0,2,2
500440,"2019",0,0,1,1
500440,"2020",0,0,2,2
500440,"2021",0,0,1,1
500440,"2022",0,0,3,3
500440,"2023",1,0,0,1
500450,"2015",2,0,4,6
500450,"2016",3,0,2,5
500450,"2017",0,0,5,5
500450,"2018",0,0,5,5
500450,"2019",1,0,3,4
500450,"2020",1,1,1,3
500450,"2021",1,0,1,2
500450,"2022",2,1,3,6
500450,"2023",1,0,2,3
500460,"2015",4,0,10,14
500460,"2016",1,0,4,5
500460,"2017",5,1,8,14
500460,"2018",2,1,10,13
500460,"2019",1,0,6,7
500460,"2020",4,0,6,10
500460,"2021",2,1,4,7
500460,"2022",2,0,3,5
500460,"2023",3,0,4,7
500470,"2015",3,0,4,7
500470,"2016",3,0,3,6
500470,"2017",2,2,6,10
500470,"2018",3,0,4,7
500470,"2019",2,0,2,4
500470,"2020",0,1,0,1
500470,"2021",0,0,3,3
500470,"2022",4,0,2,6
500470,"2023",2,0,2,4
500480,"2015",2,0,3,5
500480,"2023",0,0,2,2
500490,"2015",0,0,2,2
500490,"2016",2,0,2,4
500490,"2017",2,0,1,3
500490,"2019",1,0,1,2
500500,"2015",3,0,3,6
500500,"2016",0,0,1,1
500500,"2017",0,0,3,3
500500,"2018",2,1,4,7
500500,"2020",1,0,1,2
500500,"2021",1,0,1,2
500500,"2022",0,0,1,1
500510,"2015",0,0,1,1
500510,"2016",0,0,1,1
500510,"2017",1,0,2,3
500510,"2019",1,0,0,1
500510,"2020",0,0,1,1
500510,"2021",0,1,0,1
500510,"2022",0,0,1,1
500510,"2023",1,0,0,1
500515,"2015",1,0,2,3
500515,"2017",2,0,3,5
500515,"2018",1,0,1,2
500515,"2019",0,0,1,1
500515,"2020",0,0,1,1
500515,"2021",0,1,1,2
500515,"2022",0,1,1,2
500515,"2023",0,0,1,1
500520,"2015",6,4,8,18
500520,"2016",4,1,8,13
500520,"2017",0,0,4,4
500520,"2018",3,0,11,14
500520,"2019",5,1,9,15
500520,"2020",7,0,9,16
500520,"2021",7,0,7,14
500520,"2022",7,0,15,22
500520,"2023",2,0,6,8
500525,"2015",1,0,2,3
500525,"2016",1,0,3,4
500525,"2017",0,1,2,3
500525,"2018",0,0,4,4
500525,"2019",2,0,0,2
500525,"2020",1,0,4,5
500525,"2021",1,0,3,4
500525,"2022",0,0,2,2
500525,"2023",1,0,0,1
500540,"2015",0,0,1,1
500540,"2016",2,0,1,3
500540,"2017",1,0,0,1
500540,"2019",1,0,1,2
500540,"2021",1,1,1,3
500540,"2022",6,1,9,16
500540,"2023",6,0,4,10
500560,"2015",2,0,4,6
500560,"2016",3,1,10,14
500560,"2017",7,1,8,16
500560,"2018",3,1,11,15
500560,"2019",2,0,6,8
500560,"2020",4,1,9,14
500560,"2021",2,0,10,12
500560,"2022",3,0,3,6
500560,"2023",1,1,4,6
500568,"2015",2,0,8,10
500568,"2017",1,0,0,1
500568,"2018",1,0,0,1
500568,"2019",0,0,1,1
500568,"2020",0,0,1,1
500570,"2015",4,1,9,14
500570,"2016",8,0,27,35
500570,"2017",17,1,30,48
500570,"2018",3,4,12,19
500570,"2020",6,2,2,10
500570,"2021",6,2,17,25
500570,"2022",8,1,16,25
500570,"2023",13,0,21,34
500580,"2015",3,0,5,8
500580,"2016",6,3,6,15
500580,"2017",3,1,11,15
500580,"2018",2,0,11,13
500580,"2019",2,0,10,12
500580,"2020",4,0,1,5
500580,"2021",2,1,10,13
500580,"2022",4,0,7,11
500600,"2015",1,0,0,1
500600,"2016",1,0,3,4
500600,"2017",1,1,3,5
500600,"2018",0,0,1,1
500600,"2019",5,1,8,14
500600,"2020",1,1,8,10
500600,"2021",1,2,4,7
500600,"2022",3,2,6,11
500600,"2023",1,1,2,4
500620,"2015",14,1,16,31
500620,"2016",10,4,16,30
500620,"2017",10,2,10,22
500620,"2018",3,2,13,18
500620,"2019",10,1,16,27
500620,"2020",8,0,14,22
500620,"2021",8,3,8,19
500620,"2022",3,1,6,10
500620,"2023",1,1,0,2
500625,"2016",0,0,1,1
500625,"2018",1,0,0,1
500625,"2019",0,0,2,2
500625,"2020",0,0,1,1
500627,"2018",0,0,2,2
500627,"2020",0,1,0,1
500627,"2022",1,0,0,1
500627,"2023",0,1,0,1
500630,"2015",4,0,15,19
500630,"2016",5,2,12,19
500630,"2017",7,5,10,22
500630,"2018",15,2,17,34
500630,"2019",11,1,13,25
500630,"2020",8,0,18,26
500630,"2021",7,0,8,15
500630,"2022",8,1,11,20
500630,"2023",0,0,6,6
500635,"2015",0,0,3,3
500635,"2016",1,0,1,2
500635,"2017",1,0,0,1
500635,"2018",0,0,2,2
500635,"2019",0,0,1,1
500635,"2020",1,0,1,2
500635,"2022",3,0,5,8
500640,"2016",0,0,3,3
500640,"2017",3,0,1,4
500640,"2018",0,0,3,3
500640,"2019",1,0,2,3
500640,"2020",4,0,1,5
500640,"2021",0,0,1,1
500640,"2022",0,0,1,1
500640,"2023",1,0,0,1
500660,"2015",33,9,60,102
500660,"2016",26,3,38,67
500660,"2017",16,3,51,70
500660,"2018",22,11,68,101
500660,"2019",18,8,44,70
500660,"2020",26,14,44,84
500660,"2021",28,8,61,97
500660,"2022",30,8,37,75
500660,"2023",14,5,30,49
500690,"2015",3,3,6,12
500690,"2016",8,1,8,17
500690,"2017",3,0,0,3
500690,"2018",0,0,3,3
500690,"2019",5,0,6,11
500690,"2020",1,0,5,6
500690,"2021",3,0,3,6
500690,"2022",0,0,2,2
500690,"2023",1,0,0,1
500710,"2015",0,0,2,2
500710,"2016",0,1,4,5
500710,"2017",1,0,0,1
500710,"2018",3,1,2,6
500710,"2019",1,0,1,2
500710,"2020",1,1,4,6
500710,"2021",1,1,1,3
500710,"2022",0,0,3,3
500710,"2023",2,0,3,5
500720,"2016",0,0,2,2
500720,"2018",1,0,2,3
500720,"2019",1,0,9,10
500720,"2020",1,0,4,5
500720,"2021",2,1,4,7
500720,"2022",5,1,7,13
500720,"2023",3,0,6,9
500730,"2016",0,0,1,1
500730,"2017",0,0,1,1
500730,"2018",0,0,2,2
500730,"2020",1,0,1,2
500730,"2021",1,1,0,2
500730,"2022",0,0,2,2
500740,"2015",4,0,16,20
500740,"2016",1,1,10,12
500740,"2017",12,1,11,24
500740,"2018",6,2,14,22
500740,"2019",4,0,3,7
500740,"2020",0,0,1,1
500740,"2021",0,1,3,4
500740,"2022",0,0,3,3
500740,"2023",1,1,4,6
500750,"2015",2,0,2,4
500750,"2016",1,0,0,1
500750,"2017",0,0,6,6
500750,"2019",0,0,3,3
500750,"2021",1,0,2,3
500750,"2022",0,0,3,3
500750,"2023",1,0,0,1
500755,"2017",0,0,1,1
500755,"2018",0,0,1,1
500755,"2019",1,0,2,3
500755,"2020",0,0,1,1
500755,"2022",0,0,1,1
500769,"2015",6,0,11,17
500769,"2016",6,0,12,18
500769,"2017",14,2,14,30
500769,"2018",6,1,27,34
500769,"2019",5,1,10,16
500769,"2020",6,2,13,21
500769,"2021",4,1,7,12
500769,"2022",8,0,9,17
500769,"2023",4,1,11,16
500770,"2016",0,0,2,2
500770,"2017",0,0,1,1
500770,"2019",1,0,1,2
500770,"2020",1,0,0,1
500770,"2022",1,0,1,2
500770,"2023",0,1,0,1
500780,"2015",1,0,1,2
500780,"2016",1,0,3,4
500780,"2018",0,0,1,1
500780,"2019",0,0,4,4
500780,"2020",0,1,1,2
500780,"2021",0,0,1,1
500780,"2023",0,1,0,1
500790,"2015",6,1,15,22
500790,"2016",5,1,16,22
500790,"2017",5,0,14,19
500790,"2018",6,1,14,21
500790,"2019",6,1,17,24
500790,"2020",2,2,18,22
500790,"2021",6,1,12,19
500790,"2022",0,1,7,8
500790,"2023",0,1,7,8
500793,"2015",0,0,2,2
500793,"2016",4,1,6,11
500793,"2017",1,2,5,8
500793,"2018",4,2,8,14
500793,"2019",3,0,8,11
500793,"2020",4,2,10,16
500793,"2021",1,1,3,5
500793,"2022",3,2,4,9
500793,"2023",2,0,3,5
500795,"2017",0,0,2,2
500795,"2018",0,0,1,1
500795,"2019",1,0,0,1
500795,"2020",1,0,0,1
500795,"2021",1,1,1,3
500797,"2015",1,0,0,1
500797,"2016",1,0,2,3
500797,"2017",0,0,1,1
500797,"2019",1,0,2,3
500797,"2021",0,0,3,3
500800,"2015",0,0,3,3
500800,"2016",1,0,4,5
500800,"2017",1,0,5,6
500800,"2018",2,1,5,8
500800,"2019",2,0,7,9
500800,"2020",3,0,4,7
500800,"2021",0,0,2,2
500800,"2022",1,1,5,7
500800,"2023",2,1,2,5
500830,"2015",11,4,30,45
500830,"2016",21,1,49,71
500830,"2017",16,1,38,55
500830,"2018",14,3,30,47
500830,"2019",12,3,22,37
500830,"2020",10,2,17,29
500830,"2021",4,6,23,33
500830,"2022",19,7,20,46
500830,"2023",13,5,21,39
500840,"2015",1,0,0,1
500840,"2016",1,0,2,3
500840,"2017",0,1,0,1
500840,"2018",0,0,2,2
500840,"2020",1,0,0,1
500840,"2022",0,0,1,1
510010,"2015",2,0,2,4
510010,"2017",1,0,2,3
510010,"2020",1,1,0,2
510010,"2021",0,0,2,2
510010,"2022",2,0,0,2
510010,"2023",2,0,0,2
510020,"2015",0,0,1,1
510020,"2016",4,0,2,6
510020,"2017",0,0,3,3
510020,"2018",1,0,2,3
510020,"2019",6,0,10,16
510020,"2020",6,0,12,18
510020,"2021",11,1,31,43
510020,"2022",3,1,15,19
510020,"2023",0,0,4,4
510025,"2015",6,5,34,45
510025,"2016",14,2,20,36
510025,"2017",11,1,30,42
510025,"2018",9,3,23,35
510025,"2019",10,2,18,30
510025,"2020",9,5,17,31
510025,"2021",10,1,21,32
510025,"2022",16,2,19,37
510025,"2023",5,2,23,30
510030,"2015",3,2,20,25
510030,"2016",1,1,3,5
510030,"2017",2,0,6,8
510030,"2018",2,0,4,6
510030,"2019",4,0,11,15
510030,"2020",2,0,3,5
510030,"2021",2,1,8,11
510030,"2022",4,1,11,16
510030,"2023",2,0,6,8
510035,"2016",1,0,1,2
510035,"2017",1,0,0,1
510035,"2018",0,0,1,1
510035,"2020",3,0,2,5
510035,"2022",0,0,1,1
510035,"2023",1,0,3,4
510040,"2015",0,0,1,1
510040,"2016",0,0,4,4
510040,"2017",1,0,1,2
510040,"2018",4,0,2,6
510040,"2019",0,0,2,2
510040,"2020",0,0,3,3
510040,"2021",1,0,2,3
510040,"2022",1,0,3,4
510040,"2023",2,0,1,3
510050,"2015",0,0,3,3
510050,"2016",0,0,1,1
510050,"2017",0,1,2,3
510050,"2018",2,0,3,5
510050,"2019",2,0,5,7
510050,"2020",1,0,0,1
510050,"2021",1,0,0,1
510050,"2022",1,0,3,4
510050,"2023",0,0,4,4
510060,"2015",0,1,2,3
510060,"2016",3,0,5,8
510060,"2017",2,2,2,6
510060,"2018",5,2,9,16
510060,"2019",2,0,5,7
510060,"2020",4,0,2,6
510060,"2021",1,0,4,5
510060,"2022",1,2,7,10
510060,"2023",1,0,0,1
510080,"2015",0,0,1,1
510080,"2017",1,0,3,4
510080,"2019",0,1,2,3
510080,"2020",1,1,1,3
510080,"2021",1,0,3,4
510080,"2022",2,0,1,3
510100,"2015",1,0,0,1
510100,"2016",1,0,0,1
510100,"2017",0,0,1,1
510100,"2018",1,1,0,2
510100,"2019",1,0,0,1
510120,"2015",2,0,0,2
510120,"2020",1,0,0,1
510120,"2021",0,0,1,1
510120,"2023",0,0,1,1
510125,"2015",0,0,1,1
510125,"2017",1,1,0,2
510125,"2018",0,0,1,1
510125,"2019",0,0,1,1
510125,"2020",0,0,1,1
510125,"2023",0,0,2,2
510130,"2015",2,1,1,4
510130,"2016",1,0,4,5
510130,"2017",2,0,5,7
510130,"2018",1,0,3,4
510130,"2019",0,0,3,3
510130,"2020",1,0,1,2
510130,"2021",0,2,1,3
510130,"2022",3,0,1,4
510130,"2023",2,0,2,4
510140,"2015",1,0,5,6
510140,"2016",0,0,2,2
510140,"2017",0,0,1,1
510140,"2018",0,0,2,2
510140,"2019",0,0,2,2
510140,"2020",3,1,5,9
510140,"2021",2,1,12,15
510140,"2022",5,3,26,34
510140,"2023",2,0,10,12
510160,"2015",0,0,1,1
510160,"2016",1,0,2,3
510160,"2017",0,0,1,1
510160,"2018",1,0,0,1
510160,"2019",1,0,1,2
510160,"2020",0,0,1,1
510160,"2021",0,0,1,1
510160,"2022",1,1,0,2
510160,"2023",0,0,1,1
510170,"2015",6,1,12,19
510170,"2016",14,2,14,30
510170,"2017",8,1,10,19
510170,"2018",5,1,12,18
510170,"2019",11,1,15,27
510170,"2020",1,0,8,9
510170,"2021",1,0,6,7
510170,"2022",4,0,15,19
510170,"2023",2,1,7,10
510180,"2015",17,2,34,53
510180,"2016",6,6,36,48
510180,"2017",13,1,19,33
510180,"2018",11,3,19,33
510180,"2019",16,2,26,44
510180,"2020",6,1,6,13
510180,"2021",4,1,8,13
510180,"2022",1,3,9,13
510180,"2023",3,0,5,8
510185,"2016",2,0,0,2
510185,"2019",1,0,1,2
510185,"2020",0,0,1,1
510185,"2021",0,0,3,3
510190,"2015",1,0,9,10
510190,"2016",7,3,7,17
510190,"2017",3,0,8,11
510190,"2018",8,0,8,16
510190,"2019",2,0,4,6
510190,"2020",2,0,3,5
510190,"2021",6,0,12,18
510190,"2022",2,3,20,25
510190,"2023",6,1,16,23
510250,"2015",1,0,2,3
510250,"2016",1,0,0,1
510250,"2017",0,1,5,6
510250,"2018",7,2,11,20
510250,"2019",9,2,8,19
510250,"2020",3,3,6,12
510250,"2021",2,2,9,13
510250,"2022",3,1,5,9
510250,"2023",5,0,4,9
510260,"2015",1,1,3,5
510260,"2016",0,1,3,4
510260,"2017",3,0,4,7
510260,"2018",2,1,1,4
510260,"2019",2,0,5,7
510260,"2020",1,0,5,6
510260,"2021",5,1,7,13
510260,"2022",1,0,11,12
510260,"2023",3,0,1,4
510263,"2015",3,0,11,14
510263,"2016",7,0,17,24
510263,"2017",9,0,7,16
510263,"2018",3,1,3,7
510263,"2019",4,2,13,19
510263,"2020",2,1,11,14
510263,"2021",20,2,22,44
510263,"2022",11,4,22,37
510263,"2023",3,1,20,24
510267,"2015",26,1,39,66
510267,"2016",17,1,29,47
510267,"2017",23,5,43,71
510267,"2018",22,5,32,59
510267,"2019",16,3,33,52
510267,"2020",15,4,20,39
510267,"2021",10,3,12,25
510267,"2022",10,2,20,32
510267,"2023",7,4,17,28
510268,"2015",0,0,2,2
510268,"2018",0,0,1,1
510268,"2021",0,0,2,2
510268,"2022",0,0,2,2
510269,"2021",0,0,1,1
510269,"2022",1,0,0,1
510269,"2023",1,0,1,2
510270,"2016",1,0,1,2
510270,"2017",0,0,4,4
510270,"2018",1,0,0,1
510270,"2019",1,0,6,7
510270,"2020",2,0,4,6
510270,"2021",2,0,8,10
510270,"2022",1,0,2,3
510270,"2023",2,0,2,4
510279,"2015",0,0,2,2
510279,"2016",1,0,2,3
510279,"2017",1,0,7,8
510279,"2018",2,0,3,5
510279,"2019",1,0,0,1
510279,"2020",1,0,0,1
510279,"2021",0,0,1,1
510279,"2022",3,0,2,5
510279,"2023",3,0,1,4
510285,"2015",0,0,4,4
510285,"2016",0,0,2,2
510285,"2017",0,0,2,2
510285,"2018",0,0,3,3
510285,"2019",1,0,2,3
510285,"2020",1,0,4,5
510285,"2021",0,0,1,1
510285,"2022",2,0,1,3
510300,"2015",2,0,4,6
510300,"2016",1,0,1,2
510300,"2017",3,0,2,5
510300,"2018",0,0,2,2
510300,"2019",1,0,2,3
510300,"2020",3,1,3,7
510300,"2021",4,2,3,9
510300,"2022",0,0,1,1
510300,"2023",1,0,5,6
510305,"2016",1,0,5,6
510305,"2018",0,1,1,2
510305,"2020",1,0,0,1
510305,"2022",1,0,0,1
510305,"2023",0,0,1,1
510310,"2018",0,0,1,1
510310,"2019",1,0,1,2
510310,"2020",0,0,2,2
510310,"2021",0,0,2,2
510310,"2022",2,1,1,4
510310,"2023",1,1,1,3
510320,"2015",8,3,30,41
510320,"2016",3,2,14,19
510320,"2017",2,0,6,8
510320,"2018",1,2,6,9
510320,"2020",0,0,2,2
510320,"2021",4,0,2,6
510320,"2022",1,0,8,9
510320,"2023",3,0,1,4
510325,"2015",4,1,10,15
510325,"2016",0,0,3,3
510325,"2018",7,0,10,17
510325,"2019",10,3,23,36
510325,"2020",6,0,9,15
510325,"2021",2,2,16,20
510325,"2022",5,0,8,13
510325,"2023",5,1,8,14
510330,"2015",1,0,3,4
510330,"2016",2,0,1,3
510330,"2017",1,0,0,1
510330,"2018",3,0,2,5
510330,"2019",1,0,1,2
510330,"2020",0,0,1,1
510330,"2021",0,0,1,1
510330,"2022",0,0,1,1
510335,"2015",0,0,3,3
510335,"2017",3,0,6,9
510335,"2018",0,0,1,1
510335,"2019",1,0,1,2
510335,"2021",1,0,3,4
510335,"2022",7,1,16,24
510335,"2023",5,1,4,10
510336,"2015",1,0,3,4
510336,"2018",0,0,1,1
510336,"2021",0,0,1,1
510337,"2015",1,4,1,6
510337,"2016",2,0,9,11
510337,"2017",2,0,3,5
510337,"2018",3,0,3,6
510337,"2019",1,1,3,5
510337,"2020",3,0,10,13
510337,"2021",1,0,5,6
510337,"2022",2,1,6,9
510337,"2023",2,0,10,12
510340,"2015",109,18,206,333
510340,"2016",76,15,145,236
510340,"2017",77,17,141,235
510340,"2018",79,18,135,232
510340,"2019",67,12,138,217
510340,"2020",54,23,130,207
510340,"2021",94,24,144,262
510340,"2022",107,22,179,308
510340,"2023",83,26,154,263
510343,"2018",0,0,1,1
510343,"2019",0,0,2,2
510343,"2023",0,1,1,2
510345,"2016",1,0,3,4
510345,"2017",0,0,2,2
510345,"2018",1,0,0,1
510345,"2020",0,0,2,2
510345,"2021",1,0,1,2
510345,"2022",0,0,1,1
510345,"2023",1,0,1,2
510350,"2015",5,2,5,12
510350,"2016",2,0,7,9
510350,"2017",3,1,8,12
510350,"2018",3,1,13,17
510350,"2019",4,2,7,13
510350,"2020",8,0,13,21
510350,"2021",7,1,5,13
510350,"2022",6,0,6,12
510350,"2023",5,0,11,16
510360,"2015",1,0,2,3
510360,"2016",1,0,0,1
510360,"2017",0,1,1,2
510360,"2018",0,0,2,2
510360,"2019",0,0,1,1
510360,"2020",1,0,1,2
510360,"2021",0,0,1,1
510360,"2022",0,1,0,1
510360,"2023",0,0,3,3
510370,"2015",2,0,2,4
510370,"2016",0,0,3,3
510370,"2018",2,0,3,5
510370,"2019",2,0,5,7
510370,"2020",3,1,2,6
510370,"2021",1,1,7,9
510370,"2022",1,0,5,6
510370,"2023",1,0,0,1
510380,"2015",0,0,1,1
510380,"2019",0,0,1,1
510380,"2021",0,0,1,1
510385,"2018",0,0,1,1
510385,"2019",0,0,2,2
510385,"2020",2,1,1,4
510385,"2021",2,1,1,4
510385,"2022",1,0,2,3
510385,"2023",3,0,2,5
510390,"2015",0,0,2,2
510390,"2016",1,0,5,6
510390,"2017",1,0,4,5
510390,"2018",0,0,3,3
510390,"2019",0,0,2,2
510390,"2020",0,0,2,2
510390,"2021",0,0,3,3
510390,"2022",2,0,3,5
510390,"2023",1,0,0,1
510395,"2017",1,0,0,1
510395,"2022",0,0,1,1
510410,"2015",0,0,2,2
510410,"2016",1,0,6,7
510410,"2017",0,1,6,7
510410,"2018",1,0,2,3
510410,"2019",0,0,2,2
510410,"2020",0,0,2,2
510410,"2021",1,0,0,1
510410,"2022",2,0,3,5
510410,"2023",3,0,3,6
510420,"2015",1,0,4,5
510420,"2016",0,0,1,1
510420,"2017",1,1,0,2
510420,"2018",0,0,2,2
510420,"2019",0,1,1,2
510420,"2020",0,0,2,2
510420,"2021",2,1,4,7
510420,"2022",1,0,4,5
510420,"2023",3,0,2,5
510452,"2018",1,0,0,1
510452,"2019",0,0,1,1
510452,"2020",2,0,2,4
510452,"2021",2,0,4,6
510452,"2022",2,0,1,3
510452,"2023",0,0,2,2
510454,"2015",1,1,2,4
510454,"2018",0,1,4,5
510454,"2019",0,0,2,2
510454,"2020",1,0,4,5
510454,"2021",1,0,3,4
510454,"2022",1,1,2,4
510454,"2023",1,0,2,3
510455,"2015",1,1,5,7
510455,"2017",0,0,1,1
510455,"2018",1,0,2,3
510455,"2019",0,0,2,2
510455,"2022",0,0,1,1
510460,"2015",1,0,4,5
510460,"2016",1,1,4,6
510460,"2017",1,0,4,5
510460,"2018",3,1,8,12
510460,"2019",3,4,4,11
510460,"2020",2,0,2,4
510460,"2021",1,1,11,13
510460,"2022",3,0,6,9
510460,"2023",1,1,5,7
510480,"2015",7,3,14,24
510480,"2016",9,0,18,27
510480,"2017",7,2,31,40
510480,"2018",7,1,14,22
510480,"2019",4,0,4,8
510480,"2020",3,1,5,9
510480,"2021",3,0,8,11
510480,"2022",2,1,2,5
510480,"2023",1,0,1,2
510490,"2015",0,0,1,1
510490,"2016",0,0,2,2
510490,"2018",0,0,2,2
510490,"2019",0,0,3,3
510490,"2020",1,0,0,1
510490,"2021",0,0,2,2
510490,"2022",1,0,2,3
510490,"2023",2,0,0,2
510500,"2016",1,0,1,2
510500,"2017",1,0,2,3
510500,"2018",3,0,2,5
510500,"2019",1,0,0,1
510510,"2015",1,1,3,5
510510,"2016",7,0,7,14
510510,"2017",0,0,4,4
510510,"2018",1,2,3,6
510510,"2019",0,1,4,5
510510,"2020",3,0,2,5
510510,"2021",2,1,4,7
510510,"2022",0,3,2,5
510510,"2023",1,0,2,3
510515,"2015",11,3,37,51
510515,"2016",7,2,13,22
510515,"2017",5,1,22,28
510515,"2018",14,2,32,48
510515,"2019",12,4,30,46
510515,"2020",8,2,15,25
510515,"2021",10,6,22,38
510515,"2022",13,4,31,48
510515,"2023",9,2,15,26
510517,"2015",2,0,3,5
510517,"2016",0,0,3,3
510517,"2018",0,0,1,1
510517,"2019",0,0,3,3
510517,"2020",5,0,0,5
510517,"2021",2,1,2,5
510517,"2022",1,0,1,2
510517,"2023",1,0,1,2
510520,"2015",1,1,1,3
510520,"2016",2,0,2,4
510520,"2017",1,0,5,6
510520,"2018",0,1,2,3
510520,"2019",2,0,1,3
510520,"2020",1,0,1,2
510520,"2021",2,1,0,3
510520,"2022",1,0,2,3
510520,"2023",0,1,3,4
510523,"2015",2,0,2,4
510523,"2019",1,0,1,2
510523,"2022",1,0,0,1
510523,"2023",0,0,1,1
510525,"2015",5,1,19,25
510525,"2016",0,0,2,2
510525,"2017",2,0,9,11
510525,"2018",10,2,12,24
510525,"2019",6,2,13,21
510525,"2020",20,3,32,55
510525,"2021",12,3,35,50
510525,"2022",19,7,35,61
510525,"2023",7,3,12,22
510530,"2015",0,0,1,1
510530,"2018",1,0,1,2
510530,"2019",0,1,1,2
510530,"2020",1,0,1,2
510530,"2021",0,0,1,1
510530,"2022",1,0,0,1
510530,"2023",0,1,1,2
510550,"2015",1,0,0,1
510550,"2016",0,0,1,1
510550,"2017",1,0,4,5
510550,"2018",2,2,3,7
510550,"2020",1,0,4,5
510550,"2021",0,1,4,5
510550,"2022",0,0,3,3
510550,"2023",1,0,3,4
510558,"2015",0,0,3,3
510558,"2016",0,0,2,2
510558,"2017",1,0,0,1
510558,"2018",0,0,3,3
510558,"2019",0,1,2,3
510558,"2021",0,0,3,3
510558,"2022",1,0,3,4
510558,"2023",0,1,0,1
510560,"2015",3,1,12,16
510560,"2016",1,0,5,6
510560,"2017",2,0,6,8
510560,"2018",4,2,14,20
510560,"2019",5,1,9,15
510560,"2020",9,1,7,17
510560,"2021",3,3,5,11
510560,"2022",2,1,11,14
510560,"2023",1,0,3,4
510562,"2015",0,0,2,2
510562,"2016",0,0,1,1
510562,"2017",0,0,2,2
510562,"2018",0,0,3,3
510562,"2019",2,1,4,7
510562,"2020",1,1,2,4
510562,"2021",2,0,2,4
510562,"2022",1,0,3,4
510562,"2023",0,0,2,2
510590,"2015",2,0,3,5
510590,"2016",0,0,1,1
510590,"2017",2,0,0,2
510590,"2018",1,0,3,4
510590,"2019",3,0,0,3
510590,"2020",2,0,5,7
510590,"2021",0,0,2,2
510590,"2022",0,0,8,8
510590,"2023",1,0,4,5
510600,"2015",1,0,3,4
510600,"2016",0,0,1,1
510600,"2019",0,1,0,1
510600,"2020",0,0,1,1
510600,"2021",1,0,0,1
510600,"2022",2,0,0,2
510610,"2015",0,0,4,4
510610,"2016",0,0,1,1
510610,"2017",1,0,0,1
510610,"2018",0,0,1,1
510610,"2019",2,1,4,7
510610,"2020",1,0,4,5
510610,"2021",3,0,1,4
510610,"2022",2,0,1,3
510610,"2023",2,0,2,4
510615,"2015",2,0,3,5
510615,"2016",4,1,7,12
510615,"2017",1,0,1,2
510615,"2018",0,0,2,2
510615,"2019",3,0,4,7
510615,"2020",1,1,1,3
510615,"2021",0,0,2,2
510615,"2022",0,2,2,4
510615,"2023",1,0,2,3
510617,"2016",0,0,3,3
510617,"2017",0,0,1,1
510617,"2019",0,0,1,1
510617,"2020",1,0,0,1
510617,"2021",2,0,2,4
510617,"2023",1,0,1,2
510618,"2015",0,0,2,2
510618,"2016",0,2,6,8
510618,"2017",1,1,5,7
510618,"2018",3,1,3,7
510618,"2023",1,0,0,1
510619,"2015",0,0,2,2
510619,"2016",1,0,4,5
510619,"2017",0,0,3,3
510619,"2018",0,1,1,2
510619,"2021",0,0,1,1
510619,"2022",0,0,2,2
510620,"2015",0,0,1,1
510620,"2017",0,1,1,2
510620,"2018",0,0,1,1
510620,"2021",1,0,1,2
510620,"2022",0,0,1,1
510621,"2015",1,1,1,3
510621,"2016",3,1,1,5
510621,"2017",3,0,2,5
510621,"2018",2,1,0,3
510621,"2019",0,0,1,1
510621,"2021",1,1,0,2
510621,"2022",1,0,2,3
510622,"2015",7,0,12,19
510622,"2016",8,1,20,29
510622,"2017",3,0,12,15
510622,"2018",13,2,12,27
510622,"2019",7,1,8,16
510622,"2020",4,0,14,18
510622,"2021",12,4,11,27
510622,"2022",6,0,19,25
510622,"2023",13,0,12,25
510623,"2015",7,2,14,23
510623,"2016",5,1,15,21
510623,"2017",5,1,20,26
510623,"2018",7,1,10,18
510623,"2019",6,1,10,17
510623,"2020",4,2,14,20
510623,"2021",5,1,16,22
510623,"2022",7,0,15,22
510623,"2023",5,1,6,12
510624,"2015",2,3,2,7
510624,"2016",0,0,1,1
510624,"2017",0,0,2,2
510624,"2018",4,0,2,6
510624,"2019",2,0,3,5
510624,"2020",1,1,4,6
510624,"2021",2,2,4,8
510624,"2022",5,1,7,13
510624,"2023",2,0,6,8
510625,"2017",0,0,1,1
510625,"2018",0,0,1,1
510625,"2019",0,0,1,1
510625,"2020",2,0,12,14
510625,"2021",1,0,4,5
510625,"2022",2,0,2,4
510625,"2023",2,0,2,4
510626,"2016",1,1,1,3
510626,"2017",1,2,3,6
510626,"2018",2,0,5,7
510626,"2019",3,0,3,6
510626,"2020",0,1,1,2
510626,"2022",2,0,1,3
510626,"2023",2,0,1,3
510627,"2015",0,1,0,1
510627,"2016",1,0,0,1
510627,"2020",0,0,1,1
510628,"2017",0,0,1,1
510628,"2020",1,0,0,1
510628,"2021",0,0,2,2
510628,"2022",3,0,5,8
510628,"2023",0,0,2,2
510629,"2015",5,0,12,17
510629,"2016",0,1,4,5
510629,"2017",1,2,6,9
510629,"2018",2,0,4,6
510629,"2019",1,0,1,2
510629,"2021",2,0,4,6
510629,"2022",3,1,6,10
510629,"2023",2,1,3,6
510630,"2015",0,0,1,1
510630,"2016",1,0,3,4
510630,"2017",2,0,5,7
510630,"2018",1,1,5,7
510630,"2019",4,0,7,11
510630,"2020",1,2,12,15
510630,"2021",3,1,9,13
510630,"2022",11,2,11,24
510630,"2023",3,0,2,5
510631,"2016",1,0,1,2
510631,"2017",1,0,0,1
510631,"2019",0,0,1,1
510631,"2020",0,0,1,1
510631,"2021",0,0,2,2
510637,"2015",1,0,6,7
510637,"2016",2,0,4,6
510637,"2017",4,1,2,7
510637,"2018",4,0,6,10
510637,"2019",3,0,3,6
510637,"2020",4,0,3,7
510637,"2021",4,1,10,15
510637,"2022",4,1,5,10
510637,"2023",2,1,7,10
510642,"2015",3,0,5,8
510642,"2016",9,2,14,25
510642,"2017",4,0,17,21
510642,"2018",7,0,18,25
510642,"2019",12,2,27,41
510642,"2020",4,3,16,23
510642,"2021",8,0,24,32
510642,"2022",8,5,12,25
510642,"2023",12,0,10,22
510645,"2015",1,0,1,2
510645,"2018",1,0,2,3
510645,"2019",0,0,1,1
510645,"2020",2,0,0,2
510645,"2021",1,0,0,1
510645,"2022",1,0,2,3
510650,"2015",1,0,14,15
510650,"2016",0,0,5,5
510650,"2017",0,0,4,4
510650,"2018",3,0,8,11
510650,"2019",12,1,3,16
510650,"2020",4,1,17,22
510650,"2021",1,0,9,10
510650,"2022",4,1,13,18
510650,"2023",4,3,6,13
510665,"2015",0,0,2,2
510665,"2016",1,0,3,4
510665,"2018",2,0,2,4
510665,"2019",1,0,4,5
510665,"2021",0,0,1,1
510665,"2022",1,0,0,1
510665,"2023",0,1,0,1
510670,"2022",0,0,1,1
510675,"2015",11,3,17,31
510675,"2016",14,2,33,49
510675,"2017",10,4,27,41
510675,"2018",16,4,35,55
510675,"2019",1,1,2,4
510675,"2021",0,1,2,3
510675,"2023",0,1,1,2
510677,"2016",0,0,1,1
510677,"2017",0,0,1,1
510677,"2019",2,0,0,2
510677,"2021",0,0,1,1
510677,"2022",0,0,1,1
510677,"2023",0,0,3,3
510680,"2015",0,1,0,1
510680,"2019",0,0,1,1
510680,"2020",0,0,1,1
510680,"2022",1,0,0,1
510682,"2018",1,0,2,3
510682,"2019",0,0,2,2
510682,"2020",0,0,1,1
510682,"2021",1,0,2,3
510682,"2022",0,1,1,2
510682,"2023",3,0,0,3
510685,"2017",2,0,1,3
510685,"2018",1,0,0,1
510685,"2020",1,0,0,1
510685,"2021",1,0,0,1
510685,"2022",0,0,2,2
510685,"2023",1,1,1,3
510700,"2015",1,1,8,10
510700,"2016",0,0,4,4
510700,"2017",1,0,6,7
510700,"2018",1,1,0,2
510700,"2019",0,0,5,5
510700,"2020",0,0,6,6
510700,"2021",3,0,3,6
510700,"2022",2,2,4,8
510700,"2023",4,0,4,8
510704,"2015",18,4,36,58
510704,"2016",13,2,44,59
510704,"2017",21,1,41,63
510704,"2018",4,0,11,15
510704,"2019",3,0,7,10
510704,"2020",4,2,11,17
510704,"2021",5,1,12,18
510704,"2022",16,8,51,75
510704,"2023",12,1,32,45
510706,"2015",0,0,1,1
510706,"2016",1,0,3,4
510706,"2018",2,1,4,7
510706,"2019",0,1,1,2
510706,"2020",1,0,4,5
510706,"2021",7,0,4,11
510706,"2022",9,2,4,15
510706,"2023",2,2,15,19
510710,"2015",0,0,1,1
510710,"2016",2,0,0,2
510710,"2018",0,0,3,3
510710,"2019",1,0,0,1
510710,"2020",2,0,0,2
510710,"2021",0,1,2,3
510710,"2022",1,0,0,1
510715,"2017",0,0,1,1
510718,"2016",1,0,2,3
510718,"2017",0,0,2,2
510718,"2019",0,0,1,1
510718,"2020",0,0,1,1
510718,"2021",1,0,5,6
510718,"2022",1,0,3,4
510718,"2023",0,0,2,2
510719,"2016",1,0,0,1
510719,"2017",1,0,1,2
510719,"2020",0,0,1,1
510720,"2015",0,0,1,1
510724,"2015",0,0,1,1
510724,"2019",0,0,1,1
510724,"2021",1,0,0,1
510726,"2017",1,0,0,1
510726,"2022",1,0,1,2
510729,"2015",2,0,0,2
510729,"2017",0,0,3,3
510729,"2018",0,0,1,1
510729,"2019",0,0,1,1
510729,"2020",0,0,1,1
510729,"2023",0,0,1,1
510730,"2016",0,0,1,1
510730,"2017",2,0,4,6
510730,"2018",2,0,4,6
510730,"2019",2,0,5,7
510730,"2020",1,0,1,2
510730,"2021",2,1,0,3
510730,"2022",0,0,7,7
510730,"2023",3,0,2,5
510735,"2017",0,0,2,2
510735,"2018",0,0,2,2
510735,"2020",0,0,2,2
510735,"2021",1,0,0,1
510735,"2022",1,0,2,3
510735,"2023",1,0,4,5
510740,"2015",0,0,2,2
510740,"2016",2,0,2,4
510740,"2017",0,0,3,3
510740,"2021",0,0,3,3
510740,"2023",0,0,2,2
510757,"2015",0,0,2,2
510757,"2016",0,0,1,1
510757,"2018",1,0,0,1
510757,"2019",1,0,2,3
510757,"2020",1,0,0,1
510760,"2015",51,3,113,167
510760,"2016",43,7,96,146
510760,"2017",44,8,78,130
510760,"2018",53,5,87,145
510760,"2019",49,11,109,169
510760,"2020",32,5,68,105
510760,"2021",75,16,112,203
510760,"2022",88,25,173,286
510760,"2023",62,19,116,197
510770,"2015",0,0,2,2
510770,"2016",1,0,1,2
510770,"2017",1,0,1,2
510770,"2018",1,0,1,2
510770,"2019",1,0,2,3
510770,"2020",0,0,1,1
510770,"2021",2,0,2,4
510770,"2022",1,1,5,7
510770,"2023",2,0,5,7
510774,"2018",0,0,1,1
510775,"2015",0,0,1,1
510775,"2018",0,0,1,1
510775,"2020",1,0,3,4
510775,"2021",0,0,1,1
510775,"2022",0,0,1,1
510776,"2015",0,0,3,3
510776,"2019",0,0,2,2
510776,"2020",1,0,1,2
510776,"2021",1,0,2,3
510776,"2022",1,0,1,2
510776,"2023",3,1,1,5
510777,"2017",0,0,1,1
510777,"2019",0,0,2,2
510777,"2020",1,0,0,1
510777,"2021",1,0,0,1
510777,"2022",1,0,0,1
510777,"2023",0,0,1,1
510779,"2017",1,0,0,1
510779,"2022",1,0,1,2
510779,"2023",1,0,0,1
510780,"2015",2,1,3,6
510780,"2016",3,1,2,6
510780,"2017",1,0,2,3
510780,"2018",2,1,5,8
510780,"2019",6,2,3,11
510780,"2020",1,1,3,5
510780,"2021",4,0,5,9
510780,"2022",2,1,3,6
510780,"2023",1,0,2,3
510785,"2015",1,0,2,3
510785,"2016",2,0,2,4
510785,"2017",2,0,3,5
510785,"2018",0,2,4,6
510785,"2019",1,0,4,5
510785,"2020",0,0,7,7
510785,"2021",0,0,1,1
510785,"2022",1,0,4,5
510785,"2023",0,0,4,4
510787,"2015",1,0,0,1
510787,"2016",0,0,1,1
510787,"2018",1,1,3,5
510787,"2019",3,0,4,7
510787,"2020",4,1,11,16
510787,"2021",3,1,9,13
510787,"2022",4,0,1,5
510787,"2023",1,0,6,7
510788,"2016",0,0,1,1
510788,"2019",1,0,0,1
510788,"2022",0,0,1,1
510788,"2023",1,0,0,1
510790,"2015",13,2,11,26
510790,"2016",6,1,16,23
510790,"2017",3,0,3,6
510790,"2018",18,8,41,67
510790,"2019",27,4,44,75
510790,"2020",15,5,15,35
510790,"2021",14,2,23,39
510790,"2022",2,0,1,3
510790,"2023",1,1,4,6
510792,"2015",20,2,23,45
510792,"2016",8,0,21,29
510792,"2017",8,1,21,30
510792,"2018",12,5,23,40
510792,"2019",20,3,23,46
510792,"2020",11,4,39,54
510792,"2021",36,3,43,82
510792,"2022",27,6,45,78
510792,"2023",21,8,34,63
510794,"2018",0,0,1,1
510794,"2019",0,0,1,1
510794,"2020",0,1,0,1
510794,"2021",2,1,3,6
510794,"2022",2,0,0,2
510795,"2015",14,4,75,93
510795,"2016",23,4,48,75
510795,"2017",38,6,79,123
510795,"2018",35,8,71,114
510795,"2019",41,10,69,120
510795,"2020",42,11,76,129
510795,"2021",31,6,59,96
510795,"2022",29,12,75,116
510795,"2023",5,1,12,18
510800,"2015",0,0,2,2
510800,"2016",0,1,1,2
510800,"2018",2,0,1,3
510800,"2019",6,0,1,7
510800,"2020",3,1,6,10
510800,"2021",5,1,4,10
510800,"2022",1,1,2,4
510800,"2023",2,1,5,8
510805,"2015",2,0,2,4
510805,"2016",0,0,2,2
510805,"2017",2,2,4,8
510805,"2018",3,0,4,7
510805,"2019",0,2,7,9
510805,"2020",1,1,4,6
510805,"2021",2,0,5,7
510805,"2022",0,1,0,1
510805,"2023",0,0,2,2
510810,"2015",0,0,1,1
510810,"2016",0,0,1,1
510810,"2018",0,0,2,2
510810,"2019",1,0,1,2
510810,"2021",1,0,1,2
510810,"2022",1,0,5,6
510820,"2015",0,0,1,1
510820,"2016",0,0,1,1
510820,"2018",1,0,1,2
510820,"2020",1,0,0,1
510830,"2015",0,1,2,3
510830,"2016",0,0,2,2
510830,"2019",0,0,1,1
510830,"2020",0,0,1,1
510830,"2021",1,0,0,1
510830,"2022",0,0,2,2
510835,"2018",0,0,1,1
510835,"2020",1,0,0,1
510840,"2015",31,7,110,148
510840,"2016",33,5,83,121
510840,"2017",32,5,86,123
510840,"2018",60,9,103,172
510840,"2019",56,11,126,193
510840,"2020",46,13,86,145
510840,"2021",86,19,129,234
510840,"2022",79,16,129,224
510840,"2023",30,7,77,114
510850,"2015",2,1,1,4
510850,"2016",0,0,2,2
510850,"2017",0,0,1,1
510850,"2018",2,0,5,7
510850,"2019",0,0,5,5
510850,"2020",2,0,2,4
510850,"2021",2,2,5,9
510850,"2022",2,1,5,8
510850,"2023",1,0,3,4
510860,"2015",1,0,0,1
510860,"2016",0,0,1,1
510860,"2017",0,0,1,1
510860,"2018",0,0,1,1
510860,"2020",1,0,7,8
510860,"2021",5,0,15,20
510860,"2022",5,2,14,21
510860,"2023",1,1,6,8
510880,"2015",2,0,5,7
510880,"2016",1,0,0,1
510880,"2017",1,0,0,1
510880,"2018",1,0,0,1
510880,"2020",0,1,0,1
510880,"2022",0,1,0,1
510880,"2023",0,0,1,1
510885,"2015",0,0,1,1
510885,"2016",0,0,3,3
510885,"2017",0,0,1,1
510885,"2019",2,0,0,2
510885,"2020",1,0,1,2
510885,"2021",1,0,0,1
510885,"2022",1,0,0,1
510885,"2023",0,0,1,1
510890,"2015",0,0,2,2
510890,"2016",0,0,1,1
510890,"2017",1,0,3,4
510890,"2018",1,0,1,2
510890,"2019",1,1,2,4
510890,"2020",0,0,1,1
510890,"2021",0,0,2,2
510890,"2022",0,0,1,1
510895,"2015",2,0,4,6
510895,"2016",2,0,0,2
510895,"2017",0,0,2,2
510895,"2018",1,1,3,5
510895,"2019",0,0,2,2
510895,"2020",0,0,3,3
510895,"2021",4,0,2,6
510895,"2022",1,0,3,4
510895,"2023",4,0,4,8
520005,"2015",1,2,4,7
520005,"2016",1,1,3,5
520005,"2017",1,0,5,6
520005,"2018",3,0,2,5
520005,"2019",3,1,8,12
520005,"2020",0,0,6,6
520005,"2021",3,1,3,7
520005,"2022",5,0,3,8
520005,"2023",5,0,1,6
520010,"2015",2,0,4,6
520010,"2016",1,1,2,4
520010,"2017",5,0,4,9
520010,"2018",2,1,4,7
520010,"2019",3,0,3,6
520010,"2020",2,1,3,6
520010,"2021",0,0,1,1
520010,"2022",1,2,3,6
520010,"2023",0,1,2,3
520013,"2015",0,0,1,1
520013,"2017",2,0,1,3
520013,"2018",0,0,1,1
520013,"2019",1,0,0,1
520013,"2020",0,0,1,1
520013,"2021",1,0,0,1
520013,"2022",0,0,5,5
520013,"2023",1,0,1,2
520015,"2019",1,1,0,2
520017,"2015",0,0,1,1
520017,"2016",1,0,0,1
520017,"2017",1,0,1,2
520017,"2018",1,0,1,2
520017,"2019",2,0,1,3
520017,"2020",2,0,0,2
520017,"2022",1,1,0,2
520017,"2023",0,0,1,1
520020,"2019",0,0,1,1
520025,"2015",26,4,48,78
520025,"2016",19,4,33,56
520025,"2017",24,7,38,69
520025,"2018",17,4,43,64
520025,"2019",27,10,37,74
520025,"2020",17,9,36,62
520025,"2021",20,5,34,59
520025,"2022",27,6,28,61
520025,"2023",13,3,27,43
520030,"2015",2,0,8,10
520030,"2016",1,0,6,7
520030,"2017",5,0,6,11
520030,"2018",2,1,6,9
520030,"2019",1,0,8,9
520030,"2020",4,1,5,10
520030,"2021",5,0,6,11
520030,"2022",2,1,4,7
520030,"2023",1,0,3,4
520055,"2019",0,0,1,1
520055,"2022",1,0,2,3
520055,"2023",0,1,0,1
520060,"2015",2,0,2,4
520060,"2016",1,0,2,3
520060,"2017",1,0,3,4
520060,"2018",0,0,3,3
520060,"2019",0,1,3,4
520060,"2020",0,0,3,3
520060,"2021",1,0,1,2
520060,"2022",1,0,3,4
520060,"2023",2,0,1,3
520080,"2015",1,0,2,3
520080,"2016",2,0,6,8
520080,"2018",9,0,6,15
520080,"2019",1,2,4,7
520080,"2020",4,1,6,11
520080,"2021",0,0,2,2
520080,"2022",0,0,6,6
520080,"2023",4,0,6,10
520082,"2015",1,1,0,2
520082,"2016",1,0,1,2
520082,"2018",0,0,2,2
520082,"2022",0,0,1,1
520085,"2015",1,0,0,1
520085,"2016",0,0,1,1
520085,"2017",0,0,1,1
520085,"2019",0,0,1,1
520085,"2021",0,0,1,1
520085,"2022",2,0,0,2
520090,"2015",0,0,1,1
520090,"2022",1,0,0,1
520110,"2015",81,14,148,243
520110,"2016",56,11,115,182
520110,"2017",96,21,162,279
520110,"2018",64,20,121,205
520110,"2019",48,14,74,136
520110,"2020",56,13,103,172
520110,"2021",65,13,84,162
520110,"2022",80,17,115,212
520110,"2023",46,19,63,128
520120,"2021",1,0,0,1
520130,"2015",0,0,6,6
520130,"2016",1,0,2,3
520130,"2017",1,0,3,4
520130,"2018",1,0,5,6
520130,"2019",0,0,4,4
520130,"2020",2,0,1,3
520130,"2021",2,1,11,14
520130,"2022",0,1,5,6
520130,"2023",0,0,1,1
520140,"2015",88,10,188,286
520140,"2016",75,7,124,206
520140,"2017",87,8,227,322
520140,"2018",100,20,159,279
520140,"2019",75,17,143,235
520140,"2020",74,17,127,218
520140,"2021",77,18,117,212
520140,"2022",66,15,106,187
520140,"2023",44,11,83,138
520145,"2015",1,0,0,1
520150,"2016",0,0,1,1
520150,"2017",3,0,0,3
520150,"2018",1,0,0,1
520150,"2020",1,0,0,1
520160,"2015",1,0,0,1
520160,"2016",1,0,0,1
520160,"2017",0,0,1,1
520160,"2021",0,0,1,1
520160,"2022",1,0,0,1
520160,"2023",1,0,0,1
520170,"2015",1,0,4,5
520170,"2016",1,0,5,6
520170,"2017",4,0,4,8
520170,"2018",1,0,2,3
520170,"2019",1,0,5,6
520170,"2021",0,0,1,1
520170,"2022",3,0,3,6
520170,"2023",1,0,1,2
520180,"2015",2,0,1,3
520180,"2016",2,0,1,3
520180,"2017",0,0,2,2
520180,"2018",2,1,1,4
520180,"2019",0,0,3,3
520180,"2020",2,0,3,5
520180,"2021",0,1,2,3
520180,"2022",1,0,1,2
520215,"2017",0,1,1,2
520215,"2019",0,0,1,1
520215,"2020",0,0,1,1
520215,"2021",1,0,1,2
520215,"2023",0,0,1,1
520235,"2017",0,0,1,1
520235,"2018",1,0,1,2
520235,"2019",0,0,4,4
520250,"2017",0,0,1,1
520250,"2018",1,0,0,1
520250,"2020",0,0,1,1
520250,"2021",1,2,0,3
520260,"2015",0,1,0,1
520260,"2016",1,0,0,1
520260,"2019",1,0,0,1
520260,"2021",1,1,0,2
520280,"2015",1,0,0,1
520280,"2018",0,0,1,1
520280,"2019",1,0,0,1
520310,"2020",1,0,0,1
520320,"2015",0,0,2,2
520320,"2016",0,0,1,1
520320,"2017",6,2,6,14
520320,"2018",4,0,3,7
520320,"2019",2,0,7,9
520320,"2020",0,0,1,1
520320,"2021",1,0,0,1
520320,"2022",0,1,3,4
520320,"2023",1,0,2,3
520330,"2015",6,0,9,15
520330,"2016",0,0,5,5
520330,"2017",4,0,9,13
520330,"2018",6,0,9,15
520330,"2019",2,2,8,12
520330,"2020",2,0,8,10
520330,"2021",1,0,6,7
520330,"2022",0,0,3,3
520330,"2023",1,0,4,5
520340,"2015",0,0,3,3
520340,"2016",1,0,4,5
520340,"2017",0,0,2,2
520340,"2018",1,0,2,3
520340,"2019",2,0,3,5
520340,"2021",0,0,1,1
520340,"2023",1,1,0,2
520350,"2015",3,1,10,14
520350,"2016",4,0,2,6
520350,"2017",0,0,4,4
520350,"2018",0,0,6,6
520350,"2019",0,0,4,4
520350,"2020",3,0,10,13
520350,"2021",2,0,5,7
520350,"2022",3,0,2,5
520350,"2023",4,0,11,15
520355,"2015",2,0,2,4
520355,"2016",0,0,3,3
520355,"2017",0,0,2,2
520355,"2019",1,0,3,4
520355,"2020",3,0,3,6
520355,"2021",0,0,3,3
520355,"2022",2,0,2,4
520355,"2023",0,2,3,5
520357,"2016",2,0,1,3
520357,"2018",1,0,1,2
520357,"2019",0,1,1,2
520357,"2020",2,0,1,3
520357,"2023",0,0,1,1
520360,"2018",1,0,0,1
520360,"2019",1,0,2,3
520360,"2020",1,0,1,2
520360,"2021",0,0,1,1
520360,"2022",0,0,2,2
520360,"2023",1,0,0,1
520380,"2017",0,0,1,1
520380,"2019",1,0,2,3
520380,"2021",0,0,2,2
520380,"2022",0,0,1,1
520390,"2015",0,0,3,3
520390,"2016",2,0,1,3
520390,"2018",0,1,0,1
520390,"2019",0,1,2,3
520390,"2020",0,0,1,1
520390,"2021",0,0,2,2
520390,"2022",1,0,0,1
520390,"2023",1,0,0,1
520393,"2015",1,0,1,2
520393,"2017",0,0,1,1
520393,"2022",1,0,1,2
520396,"2018",2,0,2,4
520396,"2019",0,0,1,1
520396,"2020",1,0,1,2
520400,"2015",1,1,1,3
520400,"2016",1,0,1,2
520400,"2017",0,0,2,2
520400,"2018",1,0,0,1
520400,"2019",0,0,1,1
520400,"2020",0,0,1,1
520400,"2023",0,0,3,3
520410,"2015",0,0,1,1
520410,"2017",1,0,1,2
520410,"2018",1,0,0,1
520410,"2019",0,0,1,1
520410,"2021",0,0,3,3
520410,"2022",0,0,4,4
520410,"2023",0,1,3,4
520420,"2016",0,0,2,2
520420,"2019",0,0,2,2
520420,"2020",0,0,1,1
520425,"2015",0,0,1,1
520425,"2016",1,0,2,3
520425,"2017",1,1,3,5
520425,"2018",3,0,6,9
520425,"2019",1,0,0,1
520425,"2021",0,0,2,2
520425,"2022",0,0,1,1
520430,"2015",6,2,9,17
520430,"2016",2,2,7,11
520430,"2017",3,1,16,20
520430,"2018",5,0,2,7
520430,"2019",1,1,5,7
520430,"2020",5,1,2,8
520430,"2021",1,0,3,4
520430,"2022",0,0,1,1
520440,"2015",3,0,6,9
520440,"2016",1,0,2,3
520440,"2017",0,0,6,6
520440,"2018",0,0,4,4
520440,"2019",2,0,2,4
520440,"2020",0,0,4,4
520440,"2021",1,0,5,6
520440,"2022",0,0,3,3
520440,"2023",1,0,0,1
520450,"2015",24,3,60,87
520450,"2016",32,3,53,88
520450,"2017",28,2,46,76
520450,"2018",23,4,55,82
520450,"2019",19,6,59,84
520450,"2020",15,2,33,50
520450,"2021",16,7,23,46
520450,"2022",27,7,31,65
520450,"2023",15,6,17,38
520455,"2016",0,0,1,1
520455,"2018",0,0,1,1
520460,"2015",0,0,1,1
520460,"2017",1,0,0,1
520460,"2018",0,0,1,1
520460,"2019",0,0,1,1
520460,"2022",0,1,0,1
520460,"2023",0,0,1,1
520465,"2015",0,0,1,1
520465,"2016",0,0,1,1
520465,"2018",0,0,1,1
520465,"2021",1,0,0,1
520465,"2022",0,0,1,1
520465,"2023",1,0,0,1
520470,"2015",1,0,5,6
520470,"2016",3,0,4,7
520470,"2017",1,0,3,4
520470,"2018",1,0,1,2
520470,"2019",1,0,1,2
520470,"2020",0,0,2,2
520470,"2021",0,0,1,1
520470,"2022",1,0,3,4
520480,"2017",0,0,1,1
520480,"2018",1,0,2,3
520480,"2019",0,0,1,1
520480,"2022",0,0,1,1
520485,"2015",0,0,1,1
520485,"2017",2,0,2,4
520485,"2018",1,0,2,3
520485,"2019",3,0,0,3
520485,"2020",2,0,2,4
520485,"2021",0,0,2,2
520485,"2022",0,1,0,1
520485,"2023",0,0,2,2
520490,"2015",4,0,4,8
520490,"2016",0,1,3,4
520490,"2017",1,1,3,5
520490,"2018",3,0,7,10
520490,"2019",6,0,3,9
520490,"2020",2,0,5,7
520490,"2021",0,1,4,5
520490,"2022",0,1,2,3
520495,"2015",1,0,0,1
520495,"2016",1,0,1,2
520495,"2017",0,0,3,3
520495,"2018",2,0,0,2
520495,"2019",1,0,2,3
520495,"2020",1,0,2,3
520495,"2021",0,0,2,2
520495,"2022",0,1,1,2
520495,"2023",0,1,0,1
520500,"2015",0,0,1,1
520500,"2016",0,1,5,6
520500,"2017",1,0,0,1
520500,"2018",1,0,4,5
520500,"2019",0,1,4,5
520500,"2020",3,0,4,7
520500,"2021",0,0,5,5
520500,"2022",3,0,4,7
520500,"2023",2,0,2,4
520505,"2023",1,0,0,1
520510,"2015",0,1,0,1
520510,"2017",4,2,8,14
520510,"2018",18,1,30,49
520510,"2019",6,3,18,27
520510,"2020",2,1,3,6
520510,"2021",1,0,5,6
520510,"2022",1,1,5,7
520510,"2023",1,1,9,11
520520,"2017",1,0,0,1
520520,"2021",0,0,1,1
520520,"2022",0,0,2,2
520520,"2023",0,0,2,2
520530,"2015",0,0,3,3
520530,"2016",0,0,3,3
520530,"2017",0,0,1,1
520530,"2018",2,1,2,5
520530,"2019",1,0,2,3
520530,"2020",0,0,2,2
520530,"2021",1,0,2,3
520530,"2022",0,0,2,2
520530,"2023",0,0,2,2
520540,"2015",2,0,5,7
520540,"2016",5,1,10,16
520540,"2017",1,0,5,6
520540,"2018",6,0,6,12
520540,"2019",6,1,12,19
520540,"2020",2,0,6,8
520540,"2021",6,1,6,13
520540,"2022",6,1,6,13
520540,"2023",5,1,4,10
520545,"2015",1,0,0,1
520545,"2016",0,0,1,1
520545,"2017",1,0,1,2
520545,"2018",2,0,1,3
520545,"2019",1,0,0,1
520545,"2020",0,0,1,1
520545,"2021",1,0,0,1
520545,"2022",1,0,0,1
520545,"2023",1,0,2,3
520547,"2015",1,0,3,4
520547,"2016",0,1,4,5
520547,"2017",0,0,3,3
520547,"2018",2,0,7,9
520547,"2019",1,0,4,5
520547,"2020",2,0,5,7
520547,"2021",1,1,2,4
520547,"2022",0,2,1,3
520547,"2023",0,0,2,2
520549,"2015",26,3,28,57
520549,"2016",13,2,36,51
520549,"2017",11,3,17,31
520549,"2018",15,1,20,36
520549,"2019",14,4,18,36
520549,"2020",9,4,14,27
520549,"2021",13,6,16,35
520549,"2022",10,7,8,25
520549,"2023",4,2,10,16
520551,"2015",3,1,2,6
520551,"2016",0,0,2,2
520551,"2017",8,0,5,13
520551,"2018",3,0,4,7
520551,"2019",3,2,6,11
520551,"2020",5,1,7,13
520551,"2021",3,1,4,8
520551,"2022",6,2,5,13
520551,"2023",4,0,5,9
520552,"2015",1,1,2,4
520552,"2018",0,0,1,1
520552,"2019",1,0,0,1
520552,"2020",0,0,1,1
520552,"2023",0,0,1,1
520570,"2016",0,0,2,2
520570,"2017",0,0,1,1
520570,"2022",1,0,0,1
520570,"2023",0,1,0,1
520580,"2016",1,0,0,1
520580,"2017",1,1,0,2
520580,"2018",2,0,1,3
520580,"2019",1,0,1,2
520580,"2021",1,0,1,2
520580,"2022",0,0,3,3
520590,"2015",1,0,1,2
520590,"2016",0,0,1,1
520590,"2017",0,0,1,1
520590,"2018",1,0,1,2
520590,"2019",1,0,1,2
520590,"2020",2,0,1,3
520590,"2021",0,1,0,1
520590,"2023",1,0,0,1
520620,"2015",5,0,13,18
520620,"2016",7,4,18,29
520620,"2017",18,1,24,43
520620,"2018",14,6,22,42
520620,"2019",14,5,16,35
520620,"2020",14,2,17,33
520620,"2021",16,4,35,55
520620,"2022",14,0,21,35
520620,"2023",5,0,5,10
520630,"2015",1,0,0,1
520630,"2016",0,0,1,1
520630,"2018",1,0,0,1
520630,"2019",1,0,0,1
520630,"2020",1,0,0,1
520640,"2016",0,0,1,1
520640,"2017",0,0,2,2
520640,"2018",2,0,1,3
520640,"2019",1,1,5,7
520640,"2020",0,0,1,1
520640,"2021",2,0,4,6
520640,"2022",0,1,8,9
520640,"2023",0,0,1,1
520650,"2016",0,0,1,1
520650,"2021",0,0,1,1
520650,"2022",0,0,1,1
520670,"2015",0,0,2,2
520670,"2016",1,0,7,8
520670,"2017",1,1,1,3
520670,"2019",2,0,1,3
520670,"2020",2,0,1,3
520670,"2021",2,0,1,3
520670,"2022",0,0,1,1
520670,"2023",0,0,1,1
520680,"2016",0,0,1,1
520680,"2017",1,0,0,1
520680,"2023",0,0,1,1
520710,"2015",0,0,2,2
520710,"2018",0,0,1,1
520725,"2015",1,1,3,5
520725,"2016",1,1,2,4
520725,"2017",0,1,0,1
520725,"2018",0,0,2,2
520725,"2020",0,0,1,1
520725,"2021",1,0,2,3
520725,"2022",0,0,1,1
520740,"2017",1,0,1,2
520740,"2018",0,0,1,1
520740,"2019",1,0,3,4
520740,"2021",1,0,0,1
520740,"2022",0,0,2,2
520740,"2023",0,0,2,2
520750,"2015",1,0,0,1
520750,"2016",1,0,1,2
520750,"2017",0,0,1,1
520750,"2018",0,0,1,1
520750,"2019",1,0,0,1
520750,"2021",0,0,1,1
520750,"2022",1,0,0,1
520750,"2023",0,0,1,1
520753,"2016",0,1,2,3
520753,"2017",0,0,1,1
520753,"2020",0,0,1,1
520753,"2022",0,1,2,3
520753,"2023",1,0,1,2
520760,"2021",2,0,0,2
520760,"2022",0,0,3,3
520780,"2015",1,0,3,4
520780,"2016",0,0,2,2
520780,"2017",0,0,2,2
520780,"2018",1,0,4,5
520780,"2019",1,0,1,2
520780,"2021",1,0,2,3
520780,"2022",0,0,1,1
520790,"2015",1,0,2,3
520790,"2016",0,0,4,4
520790,"2017",0,0,1,1
520790,"2018",1,0,0,1
520790,"2019",0,0,4,4
520790,"2020",2,0,3,5
520790,"2021",0,0,2,2
520790,"2023",1,0,3,4
520800,"2015",11,5,30,46
520800,"2016",5,3,16,24
520800,"2017",19,0,30,49
520800,"2018",24,6,42,72
520800,"2019",12,7,44,63
520800,"2020",16,2,29,47
520800,"2021",12,5,35,52
520800,"2022",17,3,22,42
520800,"2023",13,3,25,41
520810,"2015",0,2,1,3
520810,"2016",1,1,2,4
520810,"2017",0,0,1,1
520810,"2018",0,0,1,1
520810,"2022",0,0,4,4
520815,"2017",0,0,1,1
520815,"2018",0,1,0,1
520815,"2019",1,0,0,1
520815,"2021",1,0,0,1
520815,"2023",0,0,1,1
520830,"2016",1,0,1,2
520830,"2017",0,0,1,1
520830,"2019",0,0,2,2
520830,"2021",0,0,1,1
520830,"2022",0,0,2,2
520840,"2015",1,0,6,7
520840,"2016",1,0,3,4
520840,"2017",3,1,4,8
520840,"2018",1,1,3,5
520840,"2019",1,1,4,6
520840,"2020",1,1,4,6
520840,"2021",4,0,4,8
520840,"2022",0,1,6,7
520840,"2023",1,1,3,5
520850,"2018",0,0,1,1
520850,"2021",0,0,1,1
520850,"2022",0,0,1,1
520860,"2015",11,0,25,36
520860,"2016",8,0,25,33
520860,"2017",17,0,12,29
520860,"2018",10,2,20,32
520860,"2019",11,0,20,31
520860,"2020",9,2,19,30
520860,"2021",7,2,28,37
520860,"2022",8,2,17,27
520860,"2023",6,3,8,17
520870,"2015",215,44,444,703
520870,"2016",162,39,299,500
520870,"2017",157,36,305,498
520870,"2018",159,34,282,475
520870,"2019",153,33,322,508
520870,"2020",163,41,225,429
520870,"2021",127,28,243,398
520870,"2022",138,34,215,387
520870,"2023",87,31,160,278
520880,"2015",8,0,15,23
520880,"2016",3,1,11,15
520880,"2017",7,1,13,21
520880,"2018",11,1,6,18
520880,"2019",5,1,8,14
520880,"2020",7,1,14,22
520880,"2021",5,1,12,18
520880,"2022",4,2,18,24
520880,"2023",5,1,7,13
520890,"2015",1,0,0,1
520890,"2016",2,0,0,2
520890,"2017",4,0,4,8
520890,"2018",1,0,5,6
520890,"2019",2,0,6,8
520890,"2020",1,1,4,6
520890,"2021",7,0,2,9
520890,"2022",1,1,6,8
520910,"2015",0,1,0,1
520910,"2016",0,0,2,2
520910,"2017",0,0,2,2
520910,"2018",0,1,6,7
520910,"2019",1,0,2,3
520910,"2020",3,1,4,8
520910,"2021",1,1,12,14
520910,"2022",0,3,1,4
520910,"2023",0,0,3,3
520915,"2015",0,0,1,1
520915,"2016",1,0,1,2
520915,"2017",0,0,1,1
520915,"2018",0,0,1,1
520915,"2019",0,0,1,1
520915,"2022",1,0,0,1
520920,"2015",2,0,6,8
520920,"2016",1,0,3,4
520920,"2017",1,0,3,4
520920,"2018",4,1,6,11
520920,"2019",2,0,3,5
520920,"2020",0,0,2,2
520920,"2021",2,0,5,7
520920,"2022",2,0,4,6
520920,"2023",2,0,1,3
520929,"2015",0,0,1,1
520929,"2016",0,0,1,1
520929,"2018",0,1,0,1
520929,"2020",0,0,1,1
520929,"2022",0,0,1,1
520940,"2016",0,0,1,1
520940,"2017",1,0,1,2
520940,"2018",1,0,0,1
520940,"2019",0,1,2,3
520940,"2022",1,1,1,3
520945,"2016",0,0,1,1
520945,"2017",0,0,2,2
520945,"2020",0,0,2,2
520945,"2021",1,0,0,1
520945,"2023",0,0,2,2
520960,"2015",0,0,1,1
520960,"2016",0,0,2,2
520960,"2019",0,1,0,1
520960,"2023",0,0,1,1
520970,"2015",1,0,4,5
520970,"2016",2,0,5,7
520970,"2017",3,0,3,6
520970,"2018",1,0,2,3
520970,"2019",0,2,2,4
520970,"2020",5,0,4,9
520970,"2021",0,0,6,6
520970,"2022",2,1,5,8
520970,"2023",2,2,4,8
520980,"2015",0,0,2,2
520980,"2016",0,0,1,1
520980,"2017",1,0,0,1
520980,"2018",1,0,0,1
520980,"2019",1,0,0,1
520980,"2020",0,0,2,2
520990,"2015",0,1,3,4
520990,"2016",1,1,3,5
520990,"2017",1,1,4,6
520990,"2018",3,0,4,7
520990,"2021",3,0,7,10
520990,"2022",2,0,4,6
520990,"2023",3,1,1,5
520993,"2015",0,0,3,3
520993,"2016",0,1,1,2
520993,"2017",0,1,0,1
520993,"2018",0,0,1,1
520993,"2020",0,0,2,2
520993,"2021",0,0,1,1
520993,"2022",0,1,2,3
520995,"2015",0,0,2,2
520995,"2016",1,0,4,5
520995,"2017",2,0,0,2
520995,"2018",1,1,1,3
520995,"2019",1,1,2,4
520995,"2020",2,0,2,4
520995,"2021",1,0,2,3
520995,"2022",1,0,0,1
520995,"2023",1,0,0,1
521000,"2015",16,2,27,45
521000,"2016",5,0,11,16
521000,"2017",4,1,17,22
521000,"2018",4,0,9,13
521000,"2019",2,2,12,16
521000,"2020",7,2,6,15
521000,"2021",2,0,5,7
521000,"2022",2,1,4,7
521000,"2023",2,0,4,6
521010,"2015",4,1,11,16
521010,"2016",4,0,7,11
521010,"2017",0,0,1,1
521010,"2018",0,0,2,2
521010,"2019",0,1,1,2
521010,"2020",2,0,1,3
521010,"2021",0,0,2,2
521010,"2022",0,0,1,1
521010,"2023",0,1,0,1
521015,"2016",1,0,1,2
521015,"2017",0,0,1,1
521015,"2018",0,0,3,3
521015,"2019",1,0,1,2
521015,"2020",1,0,0,1
521015,"2022",1,1,1,3
521015,"2023",0,0,1,1
521020,"2015",3,0,10,13
521020,"2016",2,0,9,11
521020,"2017",0,1,2,3
521020,"2018",0,0,3,3
521020,"2019",2,0,7,9
521020,"2020",1,0,0,1
521020,"2021",5,0,2,7
521020,"2022",3,0,0,3
521020,"2023",0,0,1,1
521030,"2019",0,0,1,1
521040,"2015",8,1,18,27
521040,"2016",5,0,8,13
521040,"2017",3,1,12,16
521040,"2018",1,0,11,12
521040,"2019",4,1,7,12
521040,"2020",6,1,9,16
521040,"2021",6,0,8,14
521040,"2022",4,4,12,20
521040,"2023",0,0,8,8
521056,"2015",0,0,3,3
521056,"2016",0,0,1,1
521056,"2017",1,0,1,2
521056,"2018",1,0,3,4
521056,"2019",0,1,0,1
521056,"2020",0,0,1,1
521056,"2021",0,0,1,1
521056,"2022",0,0,1,1
521060,"2017",0,0,1,1
521060,"2018",0,0,1,1
521060,"2019",1,0,1,2
521060,"2020",0,1,1,2
521060,"2021",1,0,0,1
521060,"2022",1,0,0,1
521060,"2023",0,0,1,1
521080,"2016",2,0,1,3
521080,"2017",0,0,1,1
521080,"2018",0,0,1,1
521080,"2019",0,0,2,2
521080,"2020",1,0,0,1
521080,"2021",2,0,1,3
521080,"2022",0,0,2,2
521090,"2015",2,1,3,6
521090,"2016",0,0,4,4
521090,"2017",3,0,5,8
521090,"2018",3,0,10,13
521090,"2019",2,0,5,7
521090,"2020",2,0,5,7
521090,"2022",6,0,5,11
521090,"2023",3,0,5,8
521100,"2015",0,0,1,1
521100,"2016",0,0,1,1
521100,"2017",1,0,0,1
521100,"2020",0,1,0,1
521100,"2023",0,1,1,2
521120,"2015",2,0,4,6
521120,"2016",1,0,3,4
521120,"2017",2,0,8,10
521120,"2018",4,1,3,8
521120,"2019",1,0,1,2
521120,"2020",1,0,2,3
521120,"2021",1,0,6,7
521120,"2022",2,0,4,6
521120,"2023",0,2,4,6
521130,"2015",0,0,3,3
521130,"2017",0,0,1,1
521130,"2018",2,0,0,2
521130,"2020",0,0,2,2
521130,"2021",0,1,0,1
521130,"2023",0,0,1,1
521140,"2015",0,0,1,1
521140,"2016",1,0,2,3
521140,"2017",1,0,0,1
521140,"2018",2,0,1,3
521140,"2019",4,0,0,4
521140,"2020",1,0,3,4
521140,"2022",0,0,2,2
521150,"2015",11,3,39,53
521150,"2016",19,1,33,53
521150,"2017",16,3,42,61
521150,"2018",12,4,35,51
521150,"2019",9,1,29,39
521150,"2020",9,2,33,44
521150,"2021",21,6,28,55
521150,"2022",17,4,31,52
521150,"2023",7,3,7,17
521160,"2015",0,0,1,1
521160,"2018",1,0,0,1
521170,"2016",0,0,2,2
521170,"2017",1,0,0,1
521170,"2018",1,0,0,1
521170,"2019",0,0,1,1
521170,"2020",0,1,0,1
521170,"2021",2,0,3,5
521170,"2022",2,0,1,3
521180,"2015",1,0,8,9
521180,"2016",2,0,8,10
521180,"2017",5,0,9,14
521180,"2018",0,1,8,9
521180,"2019",6,0,4,10
521180,"2020",5,0,10,15
521180,"2021",1,0,5,6
521180,"2022",3,0,5,8
521180,"2023",5,3,9,17
521190,"2015",14,6,44,64
521190,"2016",25,2,36,63
521190,"2017",22,1,39,62
521190,"2018",8,1,22,31
521190,"2019",15,1,22,38
521190,"2020",10,3,16,29
521190,"2021",9,1,14,24
521190,"2022",9,2,17,28
521190,"2023",3,0,10,13
521200,"2016",0,0,1,1
521200,"2022",0,0,1,1
521205,"2017",0,0,1,1
521205,"2019",1,0,1,2
521205,"2020",0,0,1,1
521205,"2021",1,0,0,1
521210,"2015",0,0,1,1
521210,"2022",0,0,1,1
521220,"2015",1,1,4,6
521220,"2016",1,1,3,5
521220,"2017",1,0,3,4
521220,"2018",2,0,5,7
521220,"2019",0,0,1,1
521220,"2020",0,0,1,1
521220,"2021",0,0,1,1
521220,"2022",1,1,0,2
521220,"2023",1,0,3,4
521225,"2020",0,0,1,1
521225,"2023",0,1,0,1
521230,"2015",0,1,2,3
521230,"2016",1,0,1,2
521230,"2017",1,0,0,1
521230,"2018",0,0,1,1
521230,"2019",1,0,1,2
521230,"2020",0,0,1,1
521230,"2021",0,0,1,1
521230,"2023",3,0,0,3
521250,"2015",50,13,71,134
521250,"2016",27,6,86,119
521250,"2017",40,6,56,102
521250,"2018",28,11,52,91
521250,"2019",22,8,47,77
521250,"2020",23,7,50,80
521250,"2021",34,11,65,110
521250,"2022",23,5,47,75
521250,"2023",23,5,35,63
521260,"2021",1,0,0,1
521260,"2022",2,0,0,2
521270,"2015",0,0,2,2
521270,"2017",0,0,2,2
521270,"2018",0,1,5,6
521270,"2019",1,1,1,3
521270,"2020",0,0,2,2
521270,"2021",1,0,4,5
521270,"2022",0,1,3,4
521270,"2023",3,0,0,3
521280,"2015",1,0,1,2
521280,"2016",2,0,2,4
521280,"2017",2,2,3,7
521280,"2018",0,0,5,5
521280,"2019",3,0,1,4
521280,"2020",2,0,4,6
521280,"2021",1,0,2,3
521280,"2022",1,0,4,5
521280,"2023",1,0,4,5
521290,"2018",0,0,2,2
521290,"2020",1,1,0,2
521290,"2022",0,0,1,1
521290,"2023",0,1,1,2
521295,"2016",0,0,1,1
521295,"2017",0,0,1,1
521295,"2019",1,0,0,1
521295,"2023",0,0,1,1
521300,"2015",1,0,0,1
521300,"2016",0,0,1,1
521300,"2017",0,0,1,1
521300,"2018",2,0,0,2
521300,"2019",2,0,1,3
521300,"2020",0,0,1,1
521300,"2022",0,0,1,1
521305,"2016",0,1,0,1
521305,"2018",1,0,0,1
521305,"2020",1,0,1,2
521305,"2023",0,0,1,1
521308,"2015",7,2,10,19
521308,"2016",5,0,11,16
521308,"2017",8,0,9,17
521308,"2018",5,1,5,11
521308,"2019",4,5,16,25
521308,"2020",9,6,11,26
521308,"2021",6,1,10,17
521308,"2022",3,3,11,17
521308,"2023",1,1,6,8
521310,"2016",0,0,4,4
521310,"2018",0,0,5,5
521310,"2019",5,0,16,21
521310,"2020",11,0,23,34
521310,"2021",1,0,8,9
521310,"2022",11,1,28,40
521310,"2023",4,1,4,9
521340,"2015",0,0,1,1
521340,"2018",0,0,1,1
521350,"2015",0,0,1,1
521350,"2016",0,0,1,1
521350,"2018",4,0,2,6
521350,"2019",0,0,3,3
521350,"2022",0,0,1,1
521350,"2023",0,0,1,1
521370,"2015",0,0,2,2
521370,"2016",2,0,0,2
521370,"2017",0,0,1,1
521370,"2018",1,0,2,3
521370,"2019",4,0,3,7
521370,"2020",0,0,2,2
521370,"2021",0,0,1,1
521370,"2022",0,0,3,3
521375,"2015",0,0,1,1
521375,"2016",0,0,2,2
521375,"2017",1,0,1,2
521375,"2018",1,0,0,1
521375,"2021",1,1,0,2
521375,"2022",1,0,0,1
521377,"2017",2,0,2,4
521377,"2019",0,0,2,2
521377,"2020",0,0,1,1
521377,"2022",0,0,1,1
521377,"2023",0,2,0,2
521380,"2015",4,0,4,8
521380,"2016",9,0,12,21
521380,"2017",3,0,5,8
521380,"2018",7,2,25,34
521380,"2019",10,2,27,39
521380,"2020",12,1,19,32
521380,"2021",6,0,13,19
521380,"2022",1,1,13,15
521380,"2023",1,1,11,13
521385,"2018",0,0,1,1
521385,"2019",1,0,0,1
521385,"2020",0,0,1,1
521385,"2023",0,0,2,2
521390,"2015",1,0,0,1
521390,"2016",2,0,0,2
521390,"2017",0,0,1,1
521390,"2018",0,0,1,1
521390,"2019",1,0,0,1
521390,"2020",0,0,2,2
521390,"2021",0,0,1,1
521390,"2023",0,0,1,1
521400,"2015",1,0,1,2
521400,"2018",0,0,4,4
521400,"2019",5,1,8,14
521400,"2020",4,1,8,13
521400,"2021",3,0,1,4
521400,"2022",2,0,1,3
521400,"2023",2,0,2,4
521405,"2015",0,0,3,3
521405,"2017",1,0,1,2
521405,"2018",3,1,4,8
521405,"2019",0,1,2,3
521405,"2020",0,0,3,3
521405,"2021",0,0,6,6
521405,"2022",2,1,3,6
521410,"2015",1,0,0,1
521410,"2016",0,0,2,2
521410,"2018",0,0,1,1
521440,"2015",1,0,2,3
521440,"2016",2,0,1,3
521440,"2017",1,0,3,4
521440,"2019",1,0,3,4
521440,"2021",2,0,1,3
521440,"2022",0,0,2,2
521440,"2023",0,0,2,2
521450,"2015",2,1,4,7
521450,"2016",3,0,5,8
521450,"2017",1,0,7,8
521450,"2018",4,0,6,10
521450,"2019",0,1,6,7
521450,"2020",2,2,7,11
521450,"2021",7,5,4,16
521450,"2022",5,9,8,22
521450,"2023",2,5,6,13
521460,"2015",5,1,17,23
521460,"2016",0,1,9,10
521460,"2017",7,0,6,13
521460,"2018",7,0,4,11
521460,"2019",6,1,7,14
521460,"2020",3,0,7,10
521460,"2021",3,2,7,12
521460,"2022",3,0,6,9
521460,"2023",3,0,8,11
521470,"2015",1,0,0,1
521470,"2016",0,0,1,1
521470,"2018",1,0,0,1
521470,"2019",1,0,0,1
521470,"2020",1,0,0,1
521470,"2021",1,0,0,1
521480,"2017",0,0,1,1
521483,"2020",1,0,0,1
521483,"2021",0,0,2,2
521483,"2022",0,0,1,1
521486,"2016",2,0,5,7
521486,"2017",1,0,3,4
521486,"2018",0,0,4,4
521486,"2019",4,0,2,6
521486,"2020",1,0,4,5
521486,"2021",0,0,1,1
521486,"2022",2,0,3,5
521486,"2023",0,1,2,3
521487,"2015",0,0,1,1
521490,"2016",0,0,1,1
521490,"2017",1,0,0,1
521490,"2018",0,0,1,1
521490,"2019",0,0,1,1
521490,"2020",2,0,1,3
521490,"2021",0,0,1,1
521500,"2016",1,0,1,2
521500,"2017",0,0,1,1
521500,"2018",2,0,2,4
521500,"2019",2,0,0,2
521500,"2022",0,1,1,2
521500,"2023",0,0,3,3
521520,"2015",0,0,2,2
521520,"2017",0,0,2,2
521520,"2020",0,0,1,1
521523,"2015",28,6,47,81
521523,"2016",20,6,41,67
521523,"2017",18,6,54,78
521523,"2018",20,5,34,59
521523,"2019",15,7,27,49
521523,"2020",7,2,15,24
521523,"2021",11,0,18,29
521523,"2022",10,3,18,31
521523,"2023",7,2,11,20
521525,"2016",0,0,1,1
521525,"2017",0,0,1,1
521525,"2018",1,0,0,1
521525,"2019",1,0,0,1
521525,"2020",0,0,3,3
521525,"2021",1,0,1,2
521525,"2022",2,0,0,2
521525,"2023",0,0,3,3
521530,"2015",1,0,6,7
521530,"2016",1,1,2,4
521530,"2017",2,0,3,5
521530,"2018",1,0,1,2
521530,"2019",1,0,2,3
521530,"2020",2,0,1,3
521530,"2021",3,1,1,5
521530,"2022",1,0,0,1
521530,"2023",3,0,1,4
521540,"2017",1,0,0,1
521540,"2020",0,0,2,2
521540,"2021",0,0,2,2
521540,"2022",0,1,0,1
521550,"2017",0,0,1,1
521550,"2018",2,0,1,3
521550,"2021",0,1,1,2
521550,"2022",0,0,1,1
521550,"2023",0,0,1,1
521560,"2015",11,0,20,31
521560,"2016",6,4,9,19
521560,"2017",4,0,11,15
521560,"2018",5,4,9,18
521560,"2019",8,1,7,16
521560,"2020",7,1,7,15
521560,"2021",6,2,5,13
521560,"2022",7,3,7,17
521560,"2023",3,0,6,9
521565,"2015",1,0,0,1
521565,"2016",0,0,1,1
521565,"2017",0,0,2,2
521565,"2018",3,0,1,4
521565,"2019",1,0,0,1
521565,"2020",1,0,1,2
521565,"2021",0,0,1,1
521565,"2023",0,0,1,1
521570,"2015",1,0,3,4
521570,"2016",1,0,3,4
521570,"2017",1,0,5,6
521570,"2018",2,0,4,6
521570,"2019",2,0,2,4
521570,"2020",5,1,6,12
521570,"2021",0,0,3,3
521570,"2022",3,0,6,9
521570,"2023",1,1,1,3
521580,"2015",1,0,0,1
521580,"2016",0,0,2,2
521580,"2018",1,0,0,1
521580,"2021",1,0,0,1
521580,"2022",1,0,0,1
521590,"2015",0,0,1,1
521590,"2016",0,0,1,1
521590,"2018",0,0,1,1
521590,"2020",0,0,1,1
521590,"2021",1,0,0,1
521590,"2022",1,0,0,1
521590,"2023",1,0,0,1
521600,"2016",0,0,1,1
521600,"2020",0,0,1,1
521600,"2021",1,0,0,1
521600,"2022",0,0,1,1
521630,"2017",1,0,2,3
521630,"2018",1,1,1,3
521630,"2019",1,0,1,2
521630,"2020",0,0,2,2
521630,"2021",3,0,0,3
521630,"2022",2,0,2,4
521630,"2023",0,0,1,1
521640,"2015",2,0,2,4
521640,"2016",3,0,0,3
521640,"2017",2,1,4,7
521640,"2018",3,0,6,9
521640,"2019",2,1,4,7
521640,"2020",2,0,1,3
521640,"2021",1,0,3,4
521640,"2022",0,0,2,2
521645,"2015",0,0,1,1
521645,"2019",1,0,1,2
521680,"2016",0,0,5,5
521680,"2017",0,1,0,1
521680,"2021",0,1,2,3
521680,"2022",0,0,2,2
521680,"2023",1,0,0,1
521690,"2016",1,0,1,2
521690,"2017",2,0,1,3
521690,"2018",1,0,2,3
521690,"2019",1,1,1,3
521690,"2020",1,0,0,1
521690,"2021",1,1,1,3
521710,"2015",0,0,3,3
521710,"2016",1,1,7,9
521710,"2017",2,0,3,5
521710,"2018",1,1,5,7
521710,"2019",2,1,2,5
521710,"2020",0,1,6,7
521710,"2021",1,0,4,5
521710,"2022",5,0,2,7
521710,"2023",1,0,5,6
521720,"2015",3,1,5,9
521720,"2016",1,0,2,3
521720,"2017",0,0,3,3
521720,"2018",0,0,2,2
521720,"2019",0,0,1,1
521720,"2020",0,0,2,2
521720,"2021",1,0,3,4
521720,"2022",0,0,4,4
521730,"2015",0,0,4,4
521730,"2016",6,1,6,13
521730,"2017",5,2,5,12
521730,"2018",3,1,2,6
521730,"2019",2,0,3,5
521730,"2020",4,2,7,13
521730,"2021",5,0,6,11
521730,"2022",6,1,7,14
521730,"2023",1,0,3,4
521740,"2015",2,0,4,6
521740,"2016",6,0,7,13
521740,"2017",2,0,3,5
521740,"2018",1,0,7,8
521740,"2019",2,0,5,7
521740,"2020",0,1,4,5
521740,"2021",2,0,8,10
521740,"2022",5,1,10,16
521740,"2023",4,3,13,20
521760,"2015",34,11,49,94
521760,"2016",24,5,36,65
521760,"2017",28,7,59,94
521760,"2018",18,6,33,57
521760,"2019",14,4,33,51
521760,"2020",10,1,22,33
521760,"2021",10,3,21,34
521760,"2022",21,3,39,63
521760,"2023",15,6,25,46
521770,"2015",0,0,1,1
521770,"2018",0,0,1,1
521770,"2019",0,0,1,1
521770,"2021",1,0,2,3
521770,"2022",2,0,2,4
521800,"2015",9,1,18,28
521800,"2016",7,1,16,24
521800,"2017",10,1,19,30
521800,"2018",8,1,9,18
521800,"2019",1,1,14,16
521800,"2020",7,1,7,15
521800,"2021",5,1,8,14
521800,"2022",6,2,16,24
521800,"2023",4,1,8,13
521805,"2020",0,0,1,1
521805,"2021",0,0,1,1
521810,"2015",0,0,1,1
521810,"2017",0,0,2,2
521810,"2018",0,0,2,2
521810,"2021",0,1,0,1
521810,"2023",0,0,1,1
521830,"2015",6,0,14,20
521830,"2016",7,2,15,24
521830,"2017",8,0,20,28
521830,"2018",14,2,18,34
521830,"2019",2,0,8,10
521830,"2020",7,3,17,27
521830,"2021",8,1,8,17
521830,"2022",5,0,13,18
521830,"2023",4,2,14,20
521839,"2017",0,0,1,1
521839,"2018",0,0,1,1
521839,"2020",1,0,0,1
521850,"2015",6,0,17,23
521850,"2016",10,1,16,27
521850,"2017",8,0,23,31
521850,"2018",7,2,20,29
521850,"2019",5,1,18,24
521850,"2020",5,0,16,21
521850,"2021",6,1,10,17
521850,"2022",7,1,8,16
521850,"2023",4,3,19,26
521860,"2015",3,0,8,11
521860,"2016",2,0,2,4
521860,"2017",2,1,5,8
521860,"2018",1,0,8,9
521860,"2019",2,1,3,6
521860,"2020",2,2,6,10
521860,"2021",3,0,4,7
521860,"2022",2,0,6,8
521860,"2023",5,0,3,8
521870,"2015",1,0,0,1
521870,"2016",2,1,2,5
521870,"2017",1,0,4,5
521870,"2018",1,0,4,5
521870,"2019",2,0,2,4
521870,"2020",0,0,1,1
521870,"2021",0,1,0,1
521870,"2022",2,0,1,3
521870,"2023",2,1,0,3
521878,"2016",0,0,1,1
521878,"2017",0,0,2,2
521878,"2018",0,0,1,1
521878,"2020",1,0,0,1
521878,"2022",0,0,1,1
521878,"2023",0,0,1,1
521880,"2015",1,0,8,9
521880,"2016",2,0,4,6
521880,"2017",2,1,7,10
521880,"2018",4,2,8,14
521880,"2019",1,1,10,12
521880,"2020",2,0,8,10
521880,"2021",1,0,8,9
521880,"2022",2,1,14,17
521880,"2023",2,0,7,9
521890,"2015",3,1,5,9
521890,"2016",4,2,6,12
521890,"2017",1,1,5,7
521890,"2018",1,1,7,9
521890,"2019",2,1,6,9
521890,"2020",3,0,3,6
521890,"2021",2,0,9,11
521890,"2022",8,0,5,13
521890,"2023",3,0,4,7
521900,"2016",1,0,1,2
521900,"2020",0,0,1,1
521910,"2015",0,0,1,1
521910,"2016",0,0,3,3
521910,"2017",1,0,0,1
521910,"2018",1,0,1,2
521910,"2021",0,0,1,1
521910,"2023",1,0,0,1
521920,"2015",1,0,1,2
521920,"2016",0,0,1,1
521920,"2017",0,0,1,1
521920,"2018",0,0,2,2
521920,"2019",1,0,0,1
521920,"2021",1,0,1,2
521925,"2015",0,0,3,3
521925,"2017",0,0,1,1
521925,"2019",0,0,3,3
521925,"2020",1,0,1,2
521925,"2021",0,0,1,1
521925,"2022",0,0,1,1
521925,"2023",0,0,1,1
521930,"2015",1,1,7,9
521930,"2016",3,0,6,9
521930,"2017",2,2,4,8
521930,"2018",5,1,11,17
521930,"2019",4,0,10,14
521930,"2020",2,0,2,4
521930,"2021",7,1,4,12
521930,"2022",5,1,13,19
521930,"2023",2,1,2,5
521935,"2015",0,0,2,2
521935,"2018",0,0,3,3
521935,"2020",2,0,0,2
521935,"2021",0,0,2,2
521935,"2022",2,0,1,3
521940,"2015",0,0,2,2
521940,"2019",0,0,1,1
521940,"2020",1,0,0,1
521940,"2021",1,0,0,1
521940,"2023",1,0,0,1
521945,"2016",1,0,0,1
521945,"2018",1,0,0,1
521945,"2019",1,0,0,1
521945,"2021",0,0,2,2
521945,"2022",0,1,0,1
521950,"2015",0,0,1,1
521950,"2016",0,0,1,1
521950,"2017",0,0,1,1
521950,"2020",0,0,2,2
521950,"2022",0,0,1,1
521960,"2015",1,0,0,1
521960,"2016",0,0,2,2
521960,"2018",1,0,1,2
521960,"2020",0,0,1,1
521960,"2021",0,0,1,1
521970,"2015",0,0,1,1
521970,"2016",0,0,1,1
521970,"2017",0,0,2,2
521970,"2018",2,0,1,3
521970,"2019",0,0,4,4
521970,"2020",1,0,1,2
521970,"2021",1,0,2,3
521970,"2023",1,0,1,2
521971,"2015",0,0,1,1
521971,"2021",2,0,0,2
521973,"2015",0,0,2,2
521973,"2016",1,0,0,1
521973,"2017",0,0,1,1
521973,"2018",1,0,1,2
521973,"2019",0,0,2,2
521973,"2020",0,0,1,1
521973,"2021",3,0,2,5
521973,"2022",0,0,2,2
521975,"2015",10,0,10,20
521975,"2016",8,3,10,21
521975,"2017",6,4,12,22
521975,"2018",8,2,7,17
521975,"2019",10,4,21,35
521975,"2020",5,0,13,18
521975,"2021",5,1,22,28
521975,"2022",4,1,13,18
521975,"2023",4,4,17,25
521980,"2015",1,0,3,4
521980,"2016",0,0,1,1
521980,"2017",0,0,1,1
521980,"2018",1,0,3,4
521980,"2019",1,0,3,4
521980,"2021",0,0,1,1
521980,"2022",1,0,3,4
521980,"2023",2,0,3,5
521990,"2015",2,0,0,2
521990,"2016",0,0,1,1
521990,"2017",0,0,1,1
521990,"2018",1,0,2,3
521990,"2019",0,0,1,1
521990,"2020",1,0,0,1
521990,"2021",0,0,2,2
521990,"2022",3,0,0,3
521990,"2023",0,0,1,1
522000,"2015",1,0,0,1
522000,"2016",0,1,1,2
522000,"2017",1,0,3,4
522000,"2018",3,1,3,7
522000,"2019",0,0,3,3
522000,"2020",2,0,3,5
522000,"2021",2,0,3,5
522000,"2022",3,0,7,10
522000,"2023",1,1,6,8
522010,"2015",3,3,8,14
522010,"2016",4,0,5,9
522010,"2017",3,0,8,11
522010,"2018",5,0,5,10
522010,"2019",1,1,11,13
522010,"2020",1,0,3,4
522010,"2021",5,1,13,19
522010,"2022",2,2,6,10
522010,"2023",1,0,7,8
522015,"2015",1,0,0,1
522015,"2016",3,0,1,4
522015,"2017",2,0,3,5
522015,"2018",1,0,1,2
522015,"2019",2,0,0,2
522015,"2020",3,0,2,5
522015,"2021",0,0,2,2
522015,"2022",1,0,1,2
522015,"2023",2,0,2,4
522020,"2015",3,0,8,11
522020,"2016",5,0,6,11
522020,"2017",1,0,1,2
522020,"2018",5,0,5,10
522020,"2019",2,1,3,6
522020,"2020",2,0,1,3
522020,"2021",5,1,4,10
522020,"2022",0,0,2,2
522020,"2023",0,0,3,3
522026,"2015",0,0,1,1
522026,"2016",0,0,2,2
522026,"2017",0,0,1,1
522026,"2018",0,0,2,2
522026,"2021",0,0,1,1
522026,"2022",0,1,0,1
522026,"2023",0,0,1,1
522028,"2017",1,0,0,1
522028,"2018",1,0,1,2
522028,"2020",0,0,1,1
522028,"2021",1,0,0,1
522028,"2022",0,0,1,1
522040,"2015",3,2,1,6
522040,"2016",0,0,9,9
522040,"2017",3,0,7,10
522040,"2018",4,1,2,7
522040,"2019",0,2,2,4
522040,"2020",3,0,2,5
522040,"2021",0,2,2,4
522040,"2022",3,1,6,10
522040,"2023",1,0,5,6
522045,"2015",37,6,83,126
522045,"2016",24,8,88,120
522045,"2017",34,7,52,93
522045,"2018",36,6,69,111
522045,"2019",28,5,47,80
522045,"2020",23,4,48,75
522045,"2021",18,4,39,61
522045,"2022",11,1,20,32
522045,"2023",11,0,19,30
522050,"2015",1,0,2,3
522050,"2016",0,0,2,2
522050,"2017",0,0,1,1
522050,"2018",0,1,0,1
522050,"2019",1,0,0,1
522050,"2020",0,0,1,1
522050,"2021",0,0,3,3
522050,"2022",0,0,1,1
522050,"2023",1,0,0,1
522060,"2015",0,0,1,1
522060,"2016",0,0,1,1
522060,"2018",1,0,0,1
522060,"2019",1,0,2,3
522060,"2020",1,1,1,3
522060,"2021",0,0,4,4
522060,"2022",1,3,8,12
522060,"2023",1,0,1,2
522068,"2015",0,0,2,2
522068,"2018",1,0,1,2
522068,"2020",2,0,5,7
522068,"2021",4,1,1,6
522068,"2022",0,0,1,1
522068,"2023",0,0,2,2
522070,"2015",1,0,0,1
522070,"2016",2,0,0,2
522070,"2017",0,0,1,1
522070,"2018",1,0,0,1
522070,"2021",0,0,1,1
522070,"2023",0,0,1,1
522100,"2017",0,0,1,1
522100,"2019",0,0,1,1
522100,"2020",0,1,0,1
522100,"2021",0,0,1,1
522100,"2022",0,0,1,1
522108,"2016",0,3,1,4
522108,"2017",0,0,1,1
522108,"2018",1,0,0,1
522119,"2015",0,0,1,1
522119,"2016",0,0,2,2
522119,"2017",0,0,2,2
522119,"2018",2,0,1,3
522119,"2019",0,0,2,2
522119,"2020",1,0,2,3
522119,"2021",1,0,0,1
522119,"2022",0,0,3,3
522119,"2023",0,0,1,1
522130,"2016",0,0,1,1
522130,"2023",1,0,0,1
522140,"2015",12,2,30,44
522140,"2016",16,0,30,46
522140,"2017",12,0,21,33
522140,"2018",20,3,35,58
522140,"2019",14,8,37,59
522140,"2020",15,5,28,48
522140,"2021",12,4,22,38
522140,"2022",12,6,21,39
522140,"2023",15,5,13,33
522145,"2015",0,0,3,3
522145,"2016",0,0,1,1
522145,"2017",0,0,2,2
522145,"2018",0,1,2,3
522145,"2022",0,0,1,1
522145,"2023",0,0,1,1
522150,"2016",0,0,1,1
522150,"2018",1,0,0,1
522150,"2020",0,0,1,1
522155,"2021",0,0,1,1
522155,"2023",1,0,0,1
522157,"2021",0,0,2,2
522157,"2022",0,0,1,1
522160,"2015",1,0,2,3
522160,"2016",0,0,1,1
522160,"2017",0,0,5,5
522160,"2018",2,0,1,3
522160,"2019",3,0,6,9
522160,"2020",0,1,4,5
522160,"2021",0,0,5,5
522160,"2022",6,0,7,13
522160,"2023",6,2,8,16
522170,"2015",0,0,5,5
522170,"2016",1,0,2,3
522170,"2017",1,0,4,5
522170,"2018",1,0,1,2
522170,"2019",1,1,3,5
522170,"2020",3,0,7,10
522170,"2021",1,0,4,5
522170,"2022",1,1,2,4
522170,"2023",1,1,8,10
522185,"2015",37,9,63,109
522185,"2016",32,4,44,80
522185,"2017",37,7,31,75
522185,"2018",36,12,52,100
522185,"2019",41,15,42,98
522185,"2020",27,5,58,90
522185,"2021",33,11,41,85
522185,"2022",25,9,43,77
522185,"2023",14,4,31,49
522190,"2015",1,0,2,3
522190,"2017",1,0,0,1
522190,"2018",0,0,2,2
522190,"2020",1,0,0,1
522190,"2021",0,0,1,1
522200,"2015",0,0,1,1
522200,"2018",0,0,1,1
522200,"2019",0,0,1,1
522200,"2020",0,0,2,2
522200,"2022",0,0,1,1
522200,"2023",2,0,0,2
522205,"2015",0,0,1,1
522205,"2016",0,0,3,3
522205,"2017",1,1,0,2
522205,"2018",2,0,2,4
522205,"2019",2,0,6,8
522205,"2020",1,2,5,8
522205,"2021",3,0,4,7
522205,"2022",2,0,5,7
522205,"2023",2,0,1,3
522220,"2015",0,0,2,2
522220,"2016",0,0,1,1
522220,"2017",2,0,0,2
522220,"2018",0,0,2,2
522220,"2019",0,0,2,2
522220,"2020",0,0,1,1
522220,"2021",0,0,2,2
522220,"2022",1,0,1,2
522220,"2023",0,0,1,1
522230,"2015",2,0,0,2
522230,"2016",1,0,1,2
522230,"2017",0,0,1,1
522230,"2018",1,0,0,1
522230,"2019",0,0,1,1
522230,"2020",1,0,1,2
522230,"2021",2,0,1,3
522230,"2022",3,0,0,3
522230,"2023",1,0,0,1
530010,"2015",33,14,44,91
530010,"2016",47,15,43,105
530010,"2017",80,34,134,248
530010,"2018",514,158,833,1505
530010,"2019",631,168,740,1539
530010,"2020",458,173,588,1219
530010,"2021",412,125,534,1071
530010,"2022",377,165,547,1089
530010,"2023",303,99,481,883
530020,"2015",40,9,61,110
530020,"2016",32,2,36,70
530020,"2017",25,8,32,65
530030,"2015",5,2,2,9
530030,"2016",2,2,6,10
530030,"2017",9,1,8,18
530040,"2015",143,25,189,357
530040,"2016",92,25,139,256
530040,"2017",63,18,98,179
530050,"2015",0,0,3,3
530050,"2016",7,3,7,17
530050,"2017",3,1,4,8
530060,"2015",41,10,84,135
530060,"2016",34,10,65,109
530060,"2017",25,6,39,70
530070,"2015",18,8,27,53
530070,"2016",17,5,30,52
530070,"2017",19,9,49,77
530080,"2015",5,1,5,11
530080,"2016",4,0,5,9
530080,"2017",4,1,4,9
530090,"2015",1,1,3,5
530090,"2016",1,2,2,5
530090,"2017",0,1,0,1
530100,"2015",7,3,8,18
530100,"2016",8,3,15,26
530100,"2017",8,4,8,20
530110,"2015",34,11,49,94
530110,"2016",34,3,47,84
530110,"2017",26,4,31,61
530120,"2015",72,15,157,244
530120,"2016",90,15,138,243
530120,"2017",48,17,98,163
530130,"2015",18,3,38,59
530130,"2016",17,6,31,54
530130,"2017",12,4,28,44
530135,"2015",16,2,33,51
530135,"2016",20,10,36,66
530135,"2017",31,7,28,66
530140,"2015",29,6,27,62
530140,"2016",32,4,68,104
530140,"2017",32,9,42,83
530150,"2015",40,8,65,113
530150,"2016",28,9,56,93
530150,"2017",29,8,47,84
530160,"2015",29,7,51,87
530160,"2016",25,5,41,71
530160,"2017",25,6,24,55
530170,"2015",66,8,81,155
530170,"2016",37,5,63,105
530170,"2017",19,7,40,66
530180,"2015",64,14,63,141
530180,"2016",46,13,53,112
530180,"2017",54,20,50,124
